word,total_count,total_frequency,trump_count,trump_frequency,obama_frequency,obama_count,syllable
president,3592,0.006596539,1325,0.003018478,0.021474921,2267,3
great,3556,0.006530426,3494,0.007959669,0.000587316,62,1
obama,2460,0.004517674,317,0.000722157,0.020300289,2143,3
all,2183,0.004008977,1895,0.004316993,0.002728177,288,1
people,2060,0.003783093,1767,0.004025396,0.002775541,293,2
thank,1464,0.002688567,1406,0.003203003,0.000549425,58,1
news,1353,0.002484721,1295,0.002950135,0.000549425,58,1
country,1347,0.002473702,1162,0.002647148,0.001752475,185,2
big,1280,0.00235066,1208,0.00275194,0.000682044,72,1
get,1273,0.002337804,979,0.002230256,0.002785014,294,1
fake,1172,0.002152323,1172,0.002669929,0,0,1
democrats,1167,0.00214314,1151,0.002622089,0.000151565,16,3
new,1127,0.002069682,934,0.002127742,0.001828257,193,1
would,1122,0.0020605,957,0.002180138,0.001563018,165,1
time,1065,0.001955822,729,0.001660732,0.003182873,336,1
today,1049,0.001926439,704,0.00160378,0.003268129,345,2
america,1046,0.00192093,760,0.001731353,0.002709231,286,4
many,1037,0.001904402,991,0.002257593,0.00043575,46,2
trump,1025,0.001882364,1025,0.002335049,0,0,1
make,977,0.001794214,637,0.001451147,0.003220764,340,1
never,975,0.001790542,915,0.002084458,0.00056837,60,2
vote,964,0.001770341,768,0.001749578,0.001856676,196,1
one,936,0.00171892,670,0.001526325,0.002519775,266,1
want,907,0.001665663,738,0.001681235,0.001600909,169,1
years,891,0.001636279,717,0.001633395,0.001648274,174,1
american,889,0.001632607,662,0.0015081,0.002150334,227,4
states,838,0.001538947,729,0.001660732,0.001032539,109,1
back,837,0.001537111,652,0.001485319,0.001752475,185,1
election,830,0.001524256,719,0.001637951,0.001051485,111,3
good,816,0.001498546,715,0.001628839,0.000956757,101,1
much,806,0.001480181,760,0.001731353,0.00043575,46,1
even,796,0.001461816,748,0.001704016,0.000454696,48,2
jobs,793,0.001456307,511,0.001164107,0.00267134,282,1
going,786,0.001443452,653,0.001487597,0.001259887,133,1
like,777,0.001426924,655,0.001492153,0.001155686,122,1
job,758,0.001392031,637,0.001451147,0.001146213,121,1
done,743,0.001364484,662,0.0015081,0.0007673,81,1
border,716,0.0013149,716,0.001631117,0,0,2
congress,702,0.00128919,349,0.000795056,0.003343911,353,2
state,696,0.001278171,625,0.00142381,0.000672571,71,1
house,684,0.001256134,567,0.001291681,0.001108322,117,1
media,684,0.001256134,684,0.001558218,0,0,2
united,671,0.00123226,609,0.001387361,0.000587316,62,2
must,661,0.001213895,625,0.00142381,0.000341022,36,1
because,655,0.001202877,529,0.001205113,0.001193577,126,2
china,653,0.001199204,639,0.001455704,0.00013262,14,2
day,649,0.001191858,425,0.000968191,0.002121915,224,1
win,643,0.001180839,574,0.001307627,0.000653626,69,1
nothing,634,0.001164311,597,0.001360024,0.000350495,37,2
way,624,0.001145947,550,0.001252953,0.00070099,74,1
first,608,0.001116563,457,0.00104109,0.001430398,151,1
work,592,0.00108718,373,0.00084973,0.002074551,219,1
see,588,0.001079834,496,0.001129936,0.000871501,92,1
go,579,0.001063306,425,0.000968191,0.001458817,154,1
military,560,0.001028414,548,0.001248397,0.000113674,12,4
republican,558,0.001024741,503,0.001145882,0.000521006,55,4
economy,557,0.001022904,344,0.000783665,0.002017714,213,4
biden,555,0.001019231,519,0.001182332,0.000341022,36,2
help,553,0.001015558,335,0.000763162,0.002065078,218,1
last,551,0.001011886,387,0.000881623,0.001553545,164,1
americans,551,0.001011886,203,0.000462454,0.003296547,348,4
got,549,0.001008213,403,0.000918073,0.001383034,146,1
made,545,0.001000867,469,0.001068427,0.000719936,76,1
ever,543,0.000997194,493,0.001123101,0.000473642,50,2
total,543,0.000997194,538,0.001225616,4.74E-05,5,2
bad,541,0.000993521,530,0.001207391,0.000104201,11,1
tax,534,0.000980666,313,0.000713044,0.002093497,221,1
year,532,0.000976993,343,0.000781387,0.001790366,189,1
before,528,0.000969647,433,0.000986416,0.000899919,95,2
said,526,0.000965974,447,0.001018309,0.000748354,79,1
need,525,0.000964138,322,0.000733547,0.001922986,203,1
world,516,0.00094761,433,0.000986416,0.000786245,83,1
history,509,0.000934755,476,0.001084374,0.000312604,33,3
strong,506,0.000929245,462,0.001052481,0.000416805,44,1
working,492,0.000903535,406,0.000924907,0.000814664,86,2
joe,489,0.000898025,477,0.001086652,0.000113674,12,1
hard,487,0.000894353,402,0.000915795,0.000805191,85,1
dems,473,0.000868642,473,0.00107754,0,0,1
crime,472,0.000866806,468,0.001066149,3.79E-05,4,1
fact,471,0.000864969,248,0.000564968,0.002112443,223,1
well,467,0.000857623,404,0.000920351,0.000596789,63,1
support,466,0.000855787,271,0.000617364,0.001847203,195,2
republicans,462,0.000848441,402,0.000915795,0.00056837,60,4
far,449,0.000824567,419,0.000954522,0.000284185,30,1
right,446,0.000819058,303,0.000690263,0.001354616,143,1
health,446,0.000819058,46,0.000104792,0.003789135,400,1
against,445,0.000817222,406,0.000924907,0.000369441,39,2
look,437,0.00080253,361,0.000822393,0.000719936,76,1
watch,437,0.00080253,211,0.000480678,0.002140861,226,1
left,435,0.000798857,381,0.000867955,0.000511533,54,1
deal,432,0.000793348,412,0.000938576,0.000189457,20,1
wall,432,0.000793348,406,0.000924907,0.000246294,26,1
better,431,0.000791511,348,0.000792778,0.000786245,83,2
security,426,0.000782329,383,0.000872511,0.000407332,43,4
two,424,0.000778656,358,0.000815558,0.000625207,66,1
take,423,0.00077682,284,0.000646979,0.001316724,139,1
care,421,0.000773147,130,0.000296153,0.002756595,291,1
law,419,0.000769474,340,0.000774553,0.000748354,79,1
really,413,0.000758455,397,0.000904404,0.000151565,16,2
long,412,0.000756619,350,0.000797334,0.000587316,62,1
democrat,410,0.000752946,405,0.000922629,4.74E-05,5,3
keep,400,0.000734581,255,0.000580915,0.001373561,145,1
campaign,397,0.000729072,316,0.000719878,0.0007673,81,2
trade,396,0.000727235,392,0.000893014,3.79E-05,4,1
every,389,0.00071438,201,0.000457897,0.001780893,188,3
endorsement,389,0.00071438,388,0.000883901,9.47E-06,1,4
party,388,0.000712544,360,0.000820115,0.000265239,28,2
national,385,0.000707034,347,0.000790499,0.000359968,38,3
russia,384,0.000705198,382,0.000870233,1.89E-05,2,2
best,383,0.000703361,311,0.000708488,0.000682044,72,1
act,381,0.000699689,165,0.000375886,0.002046133,216,1
together,381,0.000699689,283,0.000644701,0.000928338,98,3
let,380,0.000697852,276,0.000628755,0.000985175,104,1
come,376,0.000690506,287,0.000653814,0.000843082,89,1
senate,374,0.000686833,295,0.000672038,0.000748354,79,2
women,368,0.000675815,154,0.000350827,0.002027187,214,2
usa,367,0.000673978,349,0.000795056,0.000170511,18,1
complete,363,0.000666632,354,0.000806446,8.53E-05,9,2
white,362,0.000664796,317,0.000722157,0.000426278,45,1
witch,360,0.000661123,360,0.000820115,0,0,1
always,359,0.000659287,324,0.000738103,0.000331549,35,2
change,354,0.000650104,115,0.000261981,0.002264008,239,1
hunt,353,0.000648268,353,0.000804168,0,0,1
forward,353,0.000648268,235,0.000535353,0.001117795,118,2
north,348,0.000639086,340,0.000774553,7.58E-05,8,1
say,347,0.000637249,247,0.00056269,0.000947284,100,1
cant,347,0.000637249,207,0.000471566,0.001326197,140,1
congratulations,347,0.000637249,330,0.000751772,0.000161038,17,5
getting,346,0.000635413,301,0.000685707,0.000426278,45,2
governor,341,0.00062623,318,0.000724435,0.000217875,23,3
honor,340,0.000624394,306,0.000697097,0.000322076,34,2
night,338,0.000620721,286,0.000651536,0.000492588,52,1
could,337,0.000618885,245,0.000558134,0.000871501,92,1
million,329,0.000604193,131,0.000298431,0.001875622,198,2
money,328,0.000602357,296,0.000674317,0.000303131,32,2
happy,326,0.000598684,227,0.000517128,0.000937811,99,2
bill,324,0.000595011,241,0.000549021,0.000786245,83,1
taxes,321,0.000589501,216,0.000492069,0.000994648,105,1
others,321,0.000589501,313,0.000713044,7.58E-05,8,2
pay,320,0.000587665,155,0.000353105,0.001563018,165,1
things,320,0.000587665,293,0.000667482,0.000255767,27,1
end,318,0.000583992,245,0.000558134,0.000691517,73,1
federal,318,0.000583992,269,0.000612808,0.000464169,49,3
coming,317,0.000582156,295,0.000672038,0.000208402,22,2
call,313,0.00057481,251,0.000571802,0.000587316,62,1
love,307,0.000563791,252,0.00057408,0.000521006,55,1
didnt,307,0.000563791,286,0.000651536,0.00019893,21,1
important,307,0.000563791,245,0.000558134,0.000587316,62,3
administration,303,0.000556445,288,0.000656092,0.000142093,15,5
stop,300,0.000550936,237,0.000539909,0.000596789,63,1
another,300,0.000550936,257,0.000585471,0.000407332,43,3
give,298,0.000547263,204,0.000464732,0.000890447,94,1
totally,298,0.000547263,297,0.000676595,9.47E-06,1,3
fight,297,0.000545426,192,0.000437394,0.000994648,105,1
dollars,297,0.000545426,283,0.000644701,0.00013262,14,2
collusion,296,0.00054359,296,0.000674317,0,0,3
record,295,0.000541754,262,0.000596861,0.000312604,33,2
believe,295,0.000541754,184,0.00041917,0.001051485,111,2
families,295,0.000541754,135,0.000307543,0.001515654,160,3
tonight,293,0.000538081,223,0.000508015,0.000663099,70,2
corrupt,292,0.000536244,292,0.000665204,0,0,2
washington,292,0.000536244,248,0.000564968,0.000416805,44,3
put,290,0.000532571,220,0.000501181,0.000663099,70,1
everyone,290,0.000532571,225,0.000512572,0.000615734,65,3
fbi,289,0.000530735,289,0.00065837,0,0,1
making,289,0.000530735,211,0.000480678,0.000738881,78,2
radical,288,0.000528898,288,0.000656092,0,0,3
looking,287,0.000527062,274,0.000624198,0.000123147,13,2
countries,287,0.000527062,278,0.000633311,8.53E-05,9,2
stand,286,0.000525226,155,0.000353105,0.001240942,131,1
since,285,0.000523389,202,0.000460175,0.000786245,83,1
thats,285,0.000523389,170,0.000387276,0.001089376,115,1
soon,284,0.000521553,279,0.000635589,4.74E-05,5,1
court,284,0.000521553,267,0.000608252,0.000161038,17,1
think,284,0.000521553,223,0.000508015,0.000577843,61,1
agree,283,0.000519716,92,0.000209585,0.001809312,191,2
thing,282,0.00051788,202,0.000460175,0.000757827,80,1
numbers,280,0.000514207,275,0.000626476,4.74E-05,5,2
report,279,0.00051237,267,0.000608252,0.000113674,12,2
romney,279,0.00051237,14,3.19E-05,0.002510302,265,2
reform,278,0.000510534,74,0.000168579,0.001932459,204,2
government,278,0.000510534,216,0.000492069,0.000587316,62,3
second,277,0.000508697,254,0.000578636,0.000217875,23,2
amendment,276,0.000506861,270,0.000615086,5.68E-05,6,3
immigration,276,0.000506861,199,0.000453341,0.000729408,77,4
story,275,0.000505025,240,0.000546743,0.000331549,35,2
nation,275,0.000505025,172,0.000391833,0.000975702,103,2
impeachment,274,0.000503188,274,0.000624198,0,0,3
high,272,0.000499515,242,0.000551299,0.000284185,30,1
family,271,0.000497679,170,0.000387276,0.000956757,101,3
im,268,0.000492169,130,0.000296153,0.001307251,138,1
order,266,0.000488496,262,0.000596861,3.79E-05,4,2
including,264,0.000484824,252,0.00057408,0.000113674,12,3
wrong,263,0.000482987,243,0.000553577,0.000189457,20,1
york,260,0.000477478,249,0.000567246,0.000104201,11,1
vets,260,0.000477478,258,0.000587749,1.89E-05,2,1
real,259,0.000475641,198,0.000451063,0.000577843,61,1
hillary,259,0.000475641,259,0.000590027,0,0,3
place,257,0.000471968,214,0.000487513,0.000407332,43,1
illegal,256,0.000470132,251,0.000571802,4.74E-05,5,3
plan,254,0.000466459,74,0.000168579,0.001705111,180,1
mueller,254,0.000466459,254,0.000578636,0,0,2
live,253,0.000464623,104,0.000236922,0.001411453,149,1
wonderful,253,0.000464623,251,0.000571802,1.89E-05,2,3
next,250,0.000459113,165,0.000375886,0.000805191,85,1
true,247,0.000453604,238,0.000542187,8.53E-05,9,1
hoax,246,0.000451767,244,0.000555856,1.89E-05,2,1
justice,246,0.000451767,223,0.000508015,0.000217875,23,2
meeting,245,0.000449931,232,0.000528518,0.000123147,13,2
florida,243,0.000446258,227,0.000517128,0.000151565,16,3
john,241,0.000442585,230,0.000523962,0.000104201,11,1
mexico,240,0.000440749,237,0.000539909,2.84E-05,3,3
show,239,0.000438912,190,0.000432838,0.000464169,49,1
incredible,239,0.000438912,232,0.000528518,6.63E-05,7,4
open,238,0.000437076,209,0.000476122,0.000274712,29,2
votes,235,0.000431566,213,0.000485235,0.000208402,22,1
korea,235,0.000431566,234,0.000533075,9.47E-06,1,2
days,234,0.00042973,132,0.000300709,0.000966229,102,1
political,232,0.000426057,221,0.000503459,0.000104201,11,4
future,231,0.000424221,144,0.000328046,0.000824137,87,2
companies,229,0.000420548,171,0.000389554,0.000549425,58,3
massive,228,0.000418711,224,0.000510294,3.79E-05,4,2
pennsylvania,228,0.000418711,223,0.000508015,4.74E-05,5,4
cuts,226,0.000415038,156,0.000355383,0.000663099,70,1
protect,225,0.000413202,188,0.000428282,0.000350495,37,2
book,224,0.000411365,224,0.000510294,0,0,1
home,223,0.000409529,152,0.000346271,0.000672571,71,1
nancy,222,0.000407693,222,0.000505737,0,0,2
senator,222,0.000407693,209,0.000476122,0.000123147,13,3
billion,222,0.000407693,184,0.00041917,0.000359968,38,2
millions,222,0.000407693,133,0.000302987,0.000843082,89,2
cut,221,0.000405856,131,0.000298431,0.000852555,90,1
times,220,0.00040402,191,0.000435116,0.000274712,29,1
happen,218,0.000400347,197,0.000448785,0.00019893,21,2
pelosi,218,0.000400347,218,0.000496625,0,0,3
fighting,217,0.00039851,134,0.000305265,0.000786245,83,2
tell,216,0.000396674,88,0.000200472,0.001212523,128,1
energy,214,0.000393001,144,0.000328046,0.000663099,70,3
clinton,214,0.000393001,190,0.000432838,0.000227348,24,2
full,213,0.000391164,171,0.000389554,0.000397859,42,1
still,213,0.000391164,112,0.000255147,0.000956757,101,1
life,212,0.000389328,150,0.000341714,0.000587316,62,1
thanks,211,0.000387492,111,0.000252869,0.000947284,100,1
congressman,211,0.000387492,208,0.000473844,2.84E-05,3,3
presidential,211,0.000387492,201,0.000457897,9.47E-05,10,4
youre,210,0.000385655,32,7.29E-05,0.001686165,178,1
already,210,0.000385655,181,0.000412335,0.000274712,29,3
economic,210,0.000385655,146,0.000332602,0.000606262,64,4
ago,209,0.000383819,144,0.000328046,0.000615734,65,1
ready,209,0.000383819,143,0.000325768,0.000625207,66,2
crooked,208,0.000381982,208,0.000473844,0,0,1
sure,207,0.000380146,72,0.000164023,0.001278833,135,1
office,207,0.000380146,158,0.000359939,0.000464169,49,2
read,205,0.000376473,141,0.000321212,0.000606262,64,1
lost,205,0.000376473,180,0.000410057,0.000236821,25,1
borders,205,0.000376473,205,0.00046701,0,0,2
sleepy,204,0.000374636,204,0.000464732,0,0,2
tremendous,204,0.000374636,203,0.000462454,9.47E-06,1,3
wont,199,0.000365454,147,0.00033488,0.000492588,52,1
tomorrow,199,0.000365454,146,0.000332602,0.00050206,53,3
case,198,0.000363618,176,0.000400945,0.000208402,22,1
crazy,198,0.000363618,198,0.000451063,0,0,2
remember,198,0.000363618,181,0.000412335,0.000161038,17,3
wants,197,0.000361781,173,0.000394111,0.000227348,24,1
tariffs,197,0.000361781,197,0.000448785,0,0,2
away,196,0.000359945,142,0.00032349,0.000511533,54,2
middle,196,0.000359945,63,0.00014352,0.001259887,133,2
without,196,0.000359945,149,0.000339436,0.000445223,47,2
trying,195,0.000358108,181,0.000412335,0.00013262,14,1
texas,194,0.000356272,185,0.000421448,8.53E-05,9,2
taking,194,0.000356272,150,0.000341714,0.000416805,44,2
yesterday,194,0.000356272,151,0.000343993,0.000407332,43,3
business,193,0.000354435,151,0.000343993,0.000397859,42,3
won,192,0.000352599,184,0.00041917,7.58E-05,8,1
workers,192,0.000352599,133,0.000302987,0.000558897,59,2
everything,192,0.000352599,164,0.000373608,0.000265239,28,4
run,191,0.000350762,182,0.000414614,8.53E-05,9,1
general,191,0.000350762,183,0.000416892,7.58E-05,8,3
man,190,0.000348926,165,0.000375886,0.000236821,25,1
number,190,0.000348926,172,0.000391833,0.000170511,18,2
insurance,190,0.000348926,39,8.88E-05,0.001430398,151,3
yet,189,0.00034709,163,0.00037133,0.000246294,26,1
rate,189,0.00034709,120,0.000273372,0.000653626,69,1
market,189,0.00034709,184,0.00041917,4.74E-05,5,2
may,188,0.000345253,159,0.000362217,0.000274712,29,1
proud,188,0.000345253,150,0.000341714,0.000359968,38,1
fast,186,0.00034158,180,0.000410057,5.68E-05,6,1
voting,186,0.00034158,145,0.000330324,0.000388386,41,2
anything,183,0.000336071,165,0.000375886,0.000170511,18,3
fair,182,0.000334234,110,0.000250591,0.000682044,72,1
carolina,182,0.000334234,175,0.000398667,6.63E-05,7,4
low,181,0.000332398,169,0.000384998,0.000113674,12,1
wow,181,0.000332398,180,0.000410057,9.47E-06,1,1
join,181,0.000332398,109,0.000248313,0.000682044,72,1
supreme,181,0.000332398,164,0.000373608,0.000161038,17,2
iran,180,0.000330562,174,0.000396389,5.68E-05,6,2
friends,180,0.000330562,98,0.000223253,0.000776773,82,1
system,178,0.000326889,118,0.000268815,0.00056837,60,2
continue,178,0.000326889,154,0.000350827,0.000227348,24,3
despite,178,0.000326889,167,0.000380442,0.000104201,11,2
lets,177,0.000325052,59,0.000134408,0.001117795,118,1
greatest,177,0.000325052,166,0.000378164,0.000104201,11,2
took,176,0.000323216,130,0.000296153,0.00043575,46,1
close,176,0.000323216,144,0.000328046,0.000303131,32,1
tough,176,0.000323216,156,0.000355383,0.000189457,20,1
small,176,0.000323216,119,0.000271093,0.000539952,57,1
paid,175,0.000321379,142,0.00032349,0.000312604,33,1
running,175,0.000321379,157,0.000357661,0.000170511,18,2
enforcement,174,0.000319543,171,0.000389554,2.84E-05,3,4
almost,173,0.000317706,157,0.000357661,0.000151565,16,2
farmers,173,0.000317706,173,0.000394111,0,0,2
terrible,173,0.000317706,172,0.000391833,9.47E-06,1,3
find,171,0.000314033,117,0.000266537,0.000511533,54,1
something,171,0.000314033,128,0.000291596,0.000407332,43,3
fraud,170,0.000312197,168,0.00038272,1.89E-05,2,1
beautiful,170,0.000312197,163,0.00037133,6.63E-05,7,4
mike,169,0.000310361,169,0.000384998,0,0,1
badly,169,0.000310361,168,0.00038272,9.47E-06,1,2
men,168,0.000308524,119,0.000271093,0.000464169,49,1
lives,168,0.000308524,132,0.000300709,0.000341022,36,1
loves,167,0.000306688,167,0.000380442,0,0,1
action,167,0.000306688,87,0.000198194,0.000757827,80,2
chance,166,0.000304851,81,0.000184526,0.000805191,85,1
biggest,166,0.000304851,152,0.000346271,0.00013262,14,2
weve,165,0.000303015,34,7.75E-05,0.001240942,131,1
week,165,0.000303015,109,0.000248313,0.000530479,56,1
war,164,0.000301178,108,0.000246034,0.000530479,56,1
hes,164,0.000301178,114,0.000259703,0.000473642,50,1
pass,164,0.000301178,77,0.000175413,0.000824137,87,1
phony,164,0.000301178,163,0.00037133,9.47E-06,1,2
georgia,164,0.000301178,164,0.000373608,0,0,2
safe,162,0.000297505,143,0.000325768,0.000179984,19,1
presidents,162,0.000297505,56,0.000127573,0.001004121,106,3
healthcare,162,0.000297505,160,0.000364495,1.89E-05,2,2
problem,161,0.000295669,147,0.00033488,0.00013262,14,2
poll,161,0.000295669,159,0.000362217,1.89E-05,2,1
start,160,0.000293832,135,0.000307543,0.000236821,25,1
comey,160,0.000293832,160,0.000364495,0,0,2
november,160,0.000293832,137,0.000312099,0.000217875,23,3
little,160,0.000293832,143,0.000325768,0.000161038,17,2
rigged,159,0.000291996,159,0.000362217,0,0,1
between,159,0.000291996,126,0.00028704,0.000312604,33,2
allowed,159,0.000291996,155,0.000353105,3.79E-05,4,2
power,158,0.00029016,114,0.000259703,0.000416805,44,2
class,158,0.00029016,36,8.20E-05,0.001155686,122,1
donald,157,0.000288323,157,0.000357661,0,0,2
schiff,157,0.000288323,157,0.000357661,0,0,1
special,156,0.000286487,134,0.000305265,0.000208402,22,2
called,156,0.000286487,143,0.000325768,0.000123147,13,1
early,155,0.00028465,131,0.000298431,0.000227348,24,2
stock,155,0.00028465,152,0.000346271,2.84E-05,3,1
around,155,0.00028465,121,0.00027565,0.000322076,34,2
morning,155,0.00028465,133,0.000302987,0.000208402,22,2
seen,154,0.000282814,134,0.000305265,0.000189457,20,1
michigan,154,0.000282814,149,0.000339436,4.74E-05,5,3
cannot,154,0.000282814,117,0.000266537,0.000350495,37,2
rally,154,0.000282814,140,0.000318933,0.00013262,14,2
mitt,153,0.000280977,16,3.64E-05,0.001297779,137,1
free,152,0.000279141,86,0.000195916,0.000625207,66,1
major,152,0.000279141,143,0.000325768,8.53E-05,9,2
months,152,0.000279141,94,0.000214141,0.000549425,58,1
hope,151,0.000277304,124,0.000282484,0.000255767,27,1
bring,151,0.000277304,122,0.000277928,0.000274712,29,1
leaders,151,0.000277304,128,0.000291596,0.000217875,23,2
person,150,0.000275468,123,0.000280206,0.000255767,27,2
ratings,150,0.000275468,150,0.000341714,0,0,2
fantastic,150,0.000275468,149,0.000339436,9.47E-06,1,3
southern,150,0.000275468,150,0.000341714,0,0,2
polls,150,0.000275468,139,0.000316655,0.000104201,11,1
use,149,0.000273631,126,0.00028704,0.000217875,23,1
sign,149,0.000273631,82,0.000186804,0.00063468,67,1
ohio,149,0.000273631,122,0.000277928,0.000255767,27,2
young,148,0.000271795,56,0.000127573,0.000871501,92,1
along,148,0.000271795,137,0.000312099,0.000104201,11,2
police,148,0.000271795,140,0.000318933,7.58E-05,8,2
nations,147,0.000269959,131,0.000298431,0.000151565,16,2
unemployment,147,0.000269959,112,0.000255147,0.000331549,35,4
highly,146,0.000268122,145,0.000330324,9.47E-06,1,2
possible,146,0.000268122,131,0.000298431,0.000142093,15,3
obamacare,146,0.000268122,87,0.000198194,0.000558897,59,4
statement,146,0.000268122,119,0.000271093,0.000255767,27,3
lot,145,0.000266286,116,0.000264259,0.000274712,29,1
via,145,0.000266286,126,0.00028704,0.000179984,19,1
talk,145,0.000266286,123,0.000280206,0.000208402,22,1
approval,145,0.000266286,145,0.000330324,0,0,3
thousands,145,0.000266286,129,0.000293874,0.000151565,16,2
secretary,145,0.000266286,128,0.000291596,0.000161038,17,4
part,144,0.000264449,105,0.0002392,0.000369441,39,1
team,143,0.000262613,109,0.000248313,0.000322076,34,1
given,143,0.000262613,136,0.000309821,6.63E-05,7,2
actually,143,0.000262613,130,0.000296153,0.000123147,13,3
fired,142,0.000260776,96,0.000218697,0.00043575,46,1
longer,142,0.000260776,112,0.000255147,0.000284185,30,2
victory,141,0.00025894,124,0.000282484,0.000161038,17,3
service,141,0.00025894,114,0.000259703,0.000255767,27,2
ballots,141,0.00025894,140,0.000318933,9.47E-06,1,2
name,140,0.000257103,47,0.000107071,0.000880974,93,1
scam,140,0.000257103,140,0.000318933,0,0,1
reason,140,0.000257103,113,0.000257425,0.000255767,27,2
heading,140,0.000257103,132,0.000300709,7.58E-05,8,2
progress,140,0.000257103,81,0.000184526,0.000558897,59,2
hit,140,0.000257103,130,0.000296153,9.47E-05,10,1
less,139,0.000255267,85,0.000193638,0.000511533,54,1
anyone,139,0.000255267,120,0.000273372,0.000179984,19,2
ask,137,0.000251594,86,0.000195916,0.000483115,51,1
raise,137,0.000251594,61,0.000138964,0.000719936,76,1
enjoy,137,0.000251594,134,0.000305265,2.84E-05,3,2
minister,137,0.000251594,135,0.000307543,1.89E-05,2,3
disaster,137,0.000251594,135,0.000307543,1.89E-05,2,3
god,136,0.000249758,130,0.000296153,5.68E-05,6,1
affordable,136,0.000249758,8,1.82E-05,0.001212523,128,4
california,136,0.000249758,129,0.000293874,6.63E-05,7,4
failed,135,0.000247921,117,0.000266537,0.000170511,18,1
quickly,135,0.000247921,132,0.000300709,2.84E-05,3,2
information,135,0.000247921,131,0.000298431,3.79E-05,4,4
matter,135,0.000247921,92,0.000209585,0.000407332,43,2
truly,134,0.000246085,128,0.000291596,5.68E-05,6,2
retweet,134,0.000246085,0,0,0.00126936,134,2
wisconsin,134,0.000246085,121,0.00027565,0.000123147,13,3
conference,134,0.000246085,125,0.000284762,8.53E-05,9,3
able,133,0.000244248,94,0.000214141,0.000369441,39,2
told,133,0.000244248,118,0.000268815,0.000142093,15,1
lower,133,0.000244248,94,0.000214141,0.000369441,39,2
large,133,0.000244248,131,0.000298431,1.89E-05,2,1
obamas,133,0.000244248,15,3.42E-05,0.001117795,118,3
zero,132,0.000242412,128,0.000291596,3.79E-05,4,2
higher,132,0.000242412,80,0.000182248,0.000492588,52,2
happening,132,0.000242412,104,0.000236922,0.000265239,28,3
move,131,0.000240575,75,0.000170857,0.000530479,56,1
used,131,0.000240575,118,0.000268815,0.000123147,13,1
worse,131,0.000240575,128,0.000291596,2.84E-05,3,1
prime,131,0.000240575,129,0.000293874,1.89E-05,2,1
asked,131,0.000240575,112,0.000255147,0.000179984,19,1
gone,130,0.000238739,124,0.000282484,5.68E-05,6,1
south,130,0.000238739,127,0.000289318,2.84E-05,3,1
signed,130,0.000238739,91,0.000207307,0.000369441,39,1
education,130,0.000238739,16,3.64E-05,0.001079903,114,4
immediately,130,0.000238739,127,0.000289318,2.84E-05,3,5
become,129,0.000236902,114,0.000259703,0.000142093,15,2
russian,129,0.000236902,129,0.000293874,0,0,2
decision,129,0.000236902,111,0.000252869,0.000170511,18,3
finally,129,0.000236902,113,0.000257425,0.000151565,16,3
drug,128,0.000235066,122,0.000277928,5.68E-05,6,1
gave,128,0.000235066,110,0.000250591,0.000170511,18,1
voted,128,0.000235066,93,0.000211863,0.000331549,35,1
press,128,0.000235066,118,0.000268815,9.47E-05,10,1
isnt,127,0.00023323,78,0.000177692,0.000464169,49,1
weak,127,0.00023323,126,0.00028704,9.47E-06,1,1
knows,127,0.00023323,109,0.000248313,0.000170511,18,1
climate,127,0.00023323,6,1.37E-05,0.001146213,121,2
businesses,127,0.00023323,62,0.000141242,0.000615734,65,3
guy,125,0.000229557,123,0.000280206,1.89E-05,2,1
else,125,0.000229557,116,0.000264259,8.53E-05,9,1
nice,125,0.000229557,125,0.000284762,0,0,1
moving,125,0.000229557,84,0.00019136,0.000388386,41,2
welcome,125,0.000229557,101,0.000230088,0.000227348,24,2
perhaps,125,0.000229557,125,0.000284762,0,0,2
top,124,0.00022772,85,0.000193638,0.000369441,39,1
level,124,0.00022772,111,0.000252869,0.000123147,13,2
words,124,0.00022772,109,0.000248313,0.000142093,15,1
growth,124,0.00022772,68,0.000154911,0.000530479,56,1
please,124,0.00022772,108,0.000246034,0.000151565,16,1
thought,124,0.00022772,118,0.000268815,5.68E-05,6,1
gun,123,0.000225884,25,5.70E-05,0.000928338,98,1
went,123,0.000225884,119,0.000271093,3.79E-05,4,1
build,123,0.000225884,99,0.000225532,0.000227348,24,1
james,123,0.000225884,122,0.000277928,9.47E-06,1,1
safety,123,0.000225884,116,0.000264259,6.63E-05,7,3
highest,123,0.000225884,113,0.000257425,9.47E-05,10,2
americas,123,0.000225884,71,0.000161745,0.000492588,52,4
allow,123,0.000225884,111,0.000252869,0.000113674,12,2
save,122,0.000224047,88,0.000200472,0.000322076,34,1
built,122,0.000224047,106,0.000241478,0.000151565,16,1
meet,121,0.000222211,73,0.000166301,0.000454696,48,1
taken,121,0.000222211,109,0.000248313,0.000113674,12,2
friend,121,0.000222211,104,0.000236922,0.000161038,17,1
stronger,121,0.000222211,100,0.00022781,0.00019893,21,2
voters,120,0.000220374,87,0.000198194,0.000312604,33,2
failing,120,0.000220374,119,0.000271093,9.47E-06,1,2
watching,120,0.000220374,111,0.000252869,8.53E-05,9,2
ridiculous,120,0.000220374,119,0.000271093,9.47E-06,1,4
politics,120,0.000220374,84,0.00019136,0.000341022,36,3
stay,119,0.000218538,91,0.000207307,0.000265239,28,1
smart,119,0.000218538,109,0.000248313,9.47E-05,10,1
agenda,119,0.000218538,109,0.000248313,9.47E-05,10,3
virginia,119,0.000218538,108,0.000246034,0.000104201,11,3
sad,118,0.000216701,117,0.000266537,9.47E-06,1,1
college,118,0.000216701,22,5.01E-05,0.000909392,96,2
ive,117,0.000214865,76,0.000173135,0.000388386,41,1
laws,117,0.000214865,110,0.000250591,6.63E-05,7,1
control,117,0.000214865,100,0.00022781,0.000161038,17,2
race,116,0.000213029,103,0.000234644,0.000123147,13,1
past,116,0.000213029,85,0.000193638,0.000293658,31,1
veterans,116,0.000213029,74,0.000168579,0.000397859,42,3
interest,116,0.000213029,85,0.000193638,0.000293658,31,3
billions,116,0.000213029,108,0.000246034,7.58E-05,8,2
winning,116,0.000213029,112,0.000255147,3.79E-05,4,2
four,115,0.000211192,57,0.000129851,0.000549425,58,1
angry,115,0.000211192,115,0.000261981,0,0,2
public,115,0.000211192,98,0.000223253,0.000161038,17,2
lowest,115,0.000211192,100,0.00022781,0.000142093,15,2
needed,115,0.000211192,109,0.000248313,5.68E-05,6,1
address,115,0.000211192,41,9.34E-05,0.00070099,74,2
cnn,115,0.000211192,115,0.000261981,0,0,1
worst,114,0.000209356,109,0.000248313,4.74E-05,5,1
based,114,0.000209356,111,0.000252869,2.84E-05,3,1
spoke,114,0.000209356,109,0.000248313,4.74E-05,5,1
prices,114,0.000209356,112,0.000255147,1.89E-05,2,1
debate,114,0.000209356,68,0.000154911,0.00043575,46,2
bernie,114,0.000209356,114,0.000259703,0,0,2
stories,114,0.000209356,104,0.000236922,9.47E-05,10,2
leaving,114,0.000209356,110,0.000250591,3.79E-05,4,2
facts,113,0.000207519,76,0.000173135,0.000350495,37,1
talking,113,0.000207519,103,0.000234644,9.47E-05,10,2
ukraine,113,0.000207519,111,0.000252869,1.89E-05,2,2
process,112,0.000205683,111,0.000252869,9.47E-06,1,2
historic,112,0.000205683,87,0.000198194,0.000236821,25,3
happened,112,0.000205683,105,0.0002392,6.63E-05,7,2
leadership,112,0.000205683,92,0.000209585,0.000189457,20,3
three,111,0.000203846,83,0.000189082,0.000265239,28,1
worked,111,0.000203846,93,0.000211863,0.000170511,18,1
choice,111,0.000203846,81,0.000184526,0.000284185,30,1
foreign,111,0.000203846,92,0.000209585,0.000179984,19,2
birthday,111,0.000203846,56,0.000127573,0.000521006,55,2
dangerous,111,0.000203846,102,0.000232366,8.53E-05,9,3
send,110,0.00020201,74,0.000168579,0.000341022,36,1
caught,110,0.00020201,109,0.000248313,9.47E-06,1,1
members,110,0.00020201,80,0.000182248,0.000284185,30,2
everybody,110,0.00020201,68,0.000154911,0.000397859,42,5
investigation,110,0.00020201,110,0.000250591,0,0,5
came,109,0.000200173,96,0.000218697,0.000123147,13,1
wage,109,0.000200173,6,1.37E-05,0.000975702,103,1
former,109,0.000200173,101,0.000230088,7.58E-05,8,2
saying,109,0.000200173,102,0.000232366,6.63E-05,7,2
success,109,0.000200173,89,0.000202751,0.000189457,20,2
amazing,109,0.000200173,102,0.000232366,6.63E-05,7,3
strongly,109,0.000200173,106,0.000241478,2.84E-05,3,2
obstruction,109,0.000200173,109,0.000248313,0,0,3
especially,109,0.000200173,108,0.000246034,9.47E-06,1,4
try,108,0.000198337,76,0.000173135,0.000303131,32,1
force,108,0.000198337,100,0.00022781,7.58E-05,8,1
fully,108,0.000198337,106,0.000241478,1.89E-05,2,2
check,107,0.0001965,57,0.000129851,0.000473642,50,1
started,107,0.0001965,92,0.000209585,0.000142093,15,1
violence,107,0.0001965,35,7.97E-05,0.000682044,72,2
add,106,0.000194664,30,6.83E-05,0.000719936,76,1
oil,106,0.000194664,62,0.000141242,0.000416805,44,1
mark,106,0.000194664,97,0.000220975,8.53E-05,9,1
enough,106,0.000194664,78,0.000177692,0.000265239,28,2
entire,106,0.000194664,96,0.000218697,9.47E-05,10,2
respect,106,0.000194664,101,0.000230088,4.74E-05,5,2
respected,106,0.000194664,104,0.000236922,1.89E-05,2,2
fix,105,0.000192828,79,0.00017997,0.000246294,26,1
set,105,0.000192828,72,0.000164023,0.000312604,33,1
game,105,0.000192828,90,0.000205029,0.000142093,15,1
create,105,0.000192828,46,0.000104792,0.000558897,59,1
candidate,105,0.000192828,89,0.000202751,0.000151565,16,3
successful,105,0.000192828,101,0.000230088,3.79E-05,4,3
city,105,0.000192828,100,0.00022781,4.74E-05,5,2
cities,105,0.000192828,100,0.00022781,4.74E-05,5,2
across,104,0.000190991,62,0.000141242,0.000397859,42,2
wanted,104,0.000190991,97,0.000220975,6.63E-05,7,1
unfair,104,0.000190991,103,0.000234644,9.47E-06,1,2
coronavirus,104,0.000190991,104,0.000236922,0,0,5
post,103,0.000189155,97,0.000220975,5.68E-05,6,1
schumer,103,0.000189155,103,0.000234644,0,0,2
reporting,103,0.000189155,103,0.000234644,0,0,3
means,102,0.000187318,64,0.000145798,0.000359968,38,1
false,102,0.000187318,98,0.000223253,3.79E-05,4,1
mayor,102,0.000187318,101,0.000230088,9.47E-06,1,2
coverage,102,0.000187318,41,9.34E-05,0.000577843,61,3
helping,101,0.000185482,69,0.000157189,0.000303131,32,2
minimum,101,0.000185482,5,1.14E-05,0.000909392,96,3
beginning,101,0.000185482,93,0.000211863,7.58E-05,8,3
step,100,0.000183645,50,0.000113905,0.000473642,50,1
says,100,0.000183645,73,0.000166301,0.000255767,27,1
point,99,0.000181809,91,0.000207307,7.58E-05,8,1
clean,99,0.000181809,40,9.11E-05,0.000558897,59,1
chuck,99,0.000181809,99,0.000225532,0,0,1
asking,99,0.000181809,72,0.000164023,0.000255767,27,2
speech,99,0.000181809,72,0.000164023,0.000255767,27,1
stated,99,0.000181809,99,0.000225532,0,0,1
attack,99,0.000181809,94,0.000214141,4.74E-05,5,2
easy,98,0.000179972,87,0.000198194,0.000104201,11,2
crowd,98,0.000179972,87,0.000198194,0.000104201,11,1
illegally,98,0.000179972,98,0.000223253,0,0,4
whistleblower,98,0.000179972,98,0.000223253,0,0,4
share,97,0.000178136,15,3.42E-05,0.000776773,82,1
leader,97,0.000178136,92,0.000209585,4.74E-05,5,2
arizona,97,0.000178136,88,0.000200472,8.53E-05,9,4
kim,96,0.000176299,96,0.000218697,0,0,1
turn,96,0.000176299,62,0.000141242,0.000322076,34,1
brave,96,0.000176299,90,0.000205029,5.68E-05,6,1
rating,96,0.000176299,96,0.000218697,0,0,2
student,96,0.000176299,11,2.51E-05,0.000805191,85,2
michael,96,0.000176299,93,0.000211863,2.84E-05,3,2
interviewed,96,0.000176299,96,0.000218697,0,0,3
knew,95,0.000174463,90,0.000205029,4.74E-05,5,1
leave,95,0.000174463,61,0.000138964,0.000322076,34,1
rates,95,0.000174463,56,0.000127573,0.000369441,39,1
peace,95,0.000174463,81,0.000184526,0.00013262,14,1
japan,95,0.000174463,90,0.000205029,4.74E-05,5,2
drugs,95,0.000174463,89,0.000202751,5.68E-05,6,1
giving,95,0.000174463,70,0.000159467,0.000236821,25,2
senators,95,0.000174463,77,0.000175413,0.000170511,18,3
starting,95,0.000174463,72,0.000164023,0.000217875,23,2
lamestream,95,0.000174463,95,0.000216419,0,0,3
opportunity,95,0.000174463,38,8.66E-05,0.000539952,57,5
play,94,0.000172627,73,0.000166301,0.00019893,21,1
isis,94,0.000172627,94,0.000214141,0,0,2
needs,94,0.000172627,53,0.000120739,0.000388386,41,1
deals,94,0.000172627,94,0.000214141,0,0,1
dishonest,94,0.000172627,94,0.000214141,0,0,3
cost,93,0.00017079,69,0.000157189,0.000227348,24,1
shows,93,0.00017079,72,0.000164023,0.00019893,21,1
equal,93,0.00017079,7,1.59E-05,0.000814664,86,2
nobody,93,0.00017079,81,0.000184526,0.000113674,12,3
sources,93,0.00017079,87,0.000198194,5.68E-05,6,1
policies,93,0.00017079,55,0.000125295,0.000359968,38,3
plus,92,0.000168954,89,0.000202751,2.84E-05,3,1
west,92,0.000168954,83,0.000189082,8.53E-05,9,1
iowa,92,0.000168954,68,0.000154911,0.000227348,24,2
enemy,92,0.000168954,90,0.000205029,1.89E-05,2,3
potus,92,0.000168954,2,4.56E-06,0.000852555,90,2
nearly,92,0.000168954,28,6.38E-05,0.000606262,64,2
children,92,0.000168954,49,0.000111627,0.000407332,43,2
building,92,0.000168954,77,0.000175413,0.000142093,15,2
local,91,0.000167117,77,0.000175413,0.00013262,14,2
whole,91,0.000167117,76,0.000173135,0.000142093,15,2
spending,91,0.000167117,71,0.000161745,0.000189457,20,2
department,91,0.000167117,87,0.000198194,3.79E-05,4,3
announced,91,0.000167117,78,0.000177692,0.000123147,13,2
twitter,91,0.000167117,57,0.000129851,0.000322076,34,2
adam,90,0.000165281,90,0.000205029,0,0,2
weeks,90,0.000165281,61,0.000138964,0.000274712,29,1
makes,90,0.000165281,58,0.00013213,0.000303131,32,1
looks,90,0.000165281,72,0.000164023,0.000170511,18,1
paying,90,0.000165281,75,0.000170857,0.000142093,15,2
forced,90,0.000165281,85,0.000193638,4.74E-05,5,1
freedom,90,0.000165281,75,0.000170857,0.000142093,15,2
playing,90,0.000165281,80,0.000182248,9.47E-05,10,2
romneys,90,0.000165281,3,6.83E-06,0.000824137,87,2
students,90,0.000165281,23,5.24E-05,0.00063468,67,2
minnesota,90,0.000165281,89,0.000202751,9.47E-06,1,4
community,90,0.000165281,55,0.000125295,0.000331549,35,4
lose,88,0.000161608,75,0.000170857,0.000123147,13,1
cases,88,0.000161608,80,0.000182248,7.58E-05,8,1
released,88,0.000161608,81,0.000184526,6.63E-05,7,2
corruption,88,0.000161608,88,0.000200472,0,0,3
daca,87,0.000159771,86,0.000195916,9.47E-06,1,2
brought,87,0.000159771,80,0.000182248,6.63E-05,7,1
testing,87,0.000159771,86,0.000195916,9.47E-06,1,2
melania,87,0.000159771,87,0.000198194,0,0,3
criminal,87,0.000159771,81,0.000184526,5.68E-05,6,3
evidence,87,0.000159771,84,0.00019136,2.84E-05,3,3
horrible,87,0.000159771,87,0.000198194,0,0,3
interview,87,0.000159771,81,0.000184526,5.68E-05,6,3
theyre,87,0.000159771,54,0.000123017,0.000312604,33,1
word,86,0.000157935,52,0.000118461,0.000322076,34,1
lead,86,0.000157935,66,0.000150354,0.000189457,20,1
side,86,0.000157935,74,0.000168579,0.000113674,12,1
truth,86,0.000157935,71,0.000161745,0.000142093,15,1
passed,86,0.000157935,55,0.000125295,0.000293658,31,1
evening,86,0.000157935,83,0.000189082,2.84E-05,3,3
shutdown,86,0.000157935,57,0.000129851,0.000274712,29,2
fed,85,0.000156098,84,0.00019136,9.47E-06,1,1
sick,85,0.000156098,61,0.000138964,0.000227348,24,1
hear,85,0.000156098,66,0.000150354,0.000179984,19,1
wins,85,0.000156098,84,0.00019136,9.47E-06,1,1
decades,85,0.000156098,78,0.000177692,6.63E-05,7,2
intelligence,85,0.000156098,85,0.000193638,0,0,4
jim,84,0.000154262,80,0.000182248,3.79E-05,4,1
paul,84,0.000154262,50,0.000113905,0.000322076,34,1
lies,84,0.000154262,82,0.000186804,1.89E-05,2,1
judge,84,0.000154262,82,0.000186804,1.89E-05,2,1
bigger,84,0.000154262,77,0.000175413,6.63E-05,7,2
reported,84,0.000154262,82,0.000186804,1.89E-05,2,2
rather,84,0.000154262,78,0.000177692,5.68E-05,6,2
citizens,84,0.000154262,65,0.000148076,0.000179984,19,3
late,83,0.000152426,71,0.000161745,0.000113674,12,1
gets,83,0.000152426,62,0.000141242,0.00019893,21,1
least,83,0.000152426,66,0.000150354,0.000161038,17,1
works,83,0.000152426,49,0.000111627,0.000322076,34,1
wasnt,83,0.000152426,74,0.000168579,8.53E-05,9,1
alabama,83,0.000152426,83,0.000189082,0,0,4
different,83,0.000152426,66,0.000150354,0.000161038,17,3
bob,82,0.000150589,81,0.000184526,9.47E-06,1,1
hurt,82,0.000150589,75,0.000170857,6.63E-05,7,1
bless,82,0.000150589,78,0.000177692,3.79E-05,4,1
steve,82,0.000150589,77,0.000175413,4.74E-05,5,1
heroes,82,0.000150589,77,0.000175413,4.74E-05,5,2
easily,82,0.000150589,82,0.000186804,0,0,3
treated,82,0.000150589,73,0.000166301,8.53E-05,9,1
deserve,82,0.000150589,33,7.52E-05,0.000464169,49,2
dnc,81,0.000148753,78,0.000177692,2.84E-05,3,1
legal,81,0.000148753,72,0.000164023,8.53E-05,9,2
crisis,81,0.000148753,60,0.000136686,0.00019893,21,2
israel,81,0.000148753,79,0.00017997,1.89E-05,2,2
supports,81,0.000148753,62,0.000141242,0.000179984,19,2
final,80,0.000146916,47,0.000107071,0.000312604,33,2
heard,80,0.000146916,52,0.000118461,0.000265239,28,1
phone,80,0.000146916,64,0.000145798,0.000151565,16,1
defend,80,0.000146916,76,0.000173135,3.79E-05,4,2
agreement,80,0.000146916,63,0.00014352,0.000161038,17,3
hopefully,80,0.000146916,80,0.000182248,0,0,4
iraq,79,0.00014508,33,7.52E-05,0.00043575,46,2
dead,79,0.00014508,76,0.000173135,2.84E-05,3,1
saved,79,0.00014508,64,0.000145798,0.000142093,15,1
prayers,79,0.00014508,64,0.000145798,0.000142093,15,2
primary,79,0.00014508,74,0.000168579,4.74E-05,5,3
dossier,79,0.00014508,79,0.00017997,0,0,2
increase,79,0.00014508,62,0.000141242,0.000161038,17,2
meetings,79,0.00014508,79,0.00017997,0,0,2
potential,79,0.00014508,73,0.000166301,5.68E-05,6,3
ballot,79,0.00014508,71,0.000161745,7.58E-05,8,2
jeff,78,0.000143243,78,0.000177692,0,0,1
ahead,78,0.000143243,57,0.000129851,0.00019893,21,2
month,78,0.000143243,41,9.34E-05,0.000350495,37,1
david,78,0.000143243,73,0.000166301,4.74E-05,5,2
voter,78,0.000143243,69,0.000157189,8.53E-05,9,2
syria,78,0.000143243,76,0.000173135,1.89E-05,2,2
funding,78,0.000143243,67,0.000152632,0.000104201,11,2
tuesday,78,0.000143243,72,0.000164023,5.68E-05,6,2
powerful,78,0.000143243,63,0.00014352,0.000142093,15,3
opponent,78,0.000143243,74,0.000168579,3.79E-05,4,3
relationship,78,0.000143243,78,0.000177692,0,0,4
old,77,0.000141407,67,0.000152632,9.47E-05,10,1
lady,77,0.000141407,43,9.80E-05,0.000322076,34,2
comes,77,0.000141407,47,0.000107071,0.000284185,30,1
single,77,0.000141407,32,7.29E-05,0.000426278,45,2
andrew,77,0.000141407,77,0.000175413,0,0,2
lawyer,77,0.000141407,77,0.000175413,0,0,2
couldnt,77,0.000141407,68,0.000154911,8.53E-05,9,1
shouldnt,77,0.000141407,33,7.52E-05,0.000416805,44,1
attorney,77,0.000141407,75,0.000170857,1.89E-05,2,3
mess,76,0.00013957,68,0.000154911,7.58E-05,8,1
union,76,0.00013957,55,0.000125295,0.00019893,21,2
school,76,0.00013957,54,0.000123017,0.000208402,22,1
policy,76,0.00013957,62,0.000141242,0.00013262,14,3
hurricane,76,0.00013957,68,0.000154911,7.58E-05,8,3
calls,76,0.00013957,44,0.000100236,0.000303131,32,1
dollar,76,0.00013957,68,0.000154911,7.58E-05,8,2
todays,75,0.000137734,37,8.43E-05,0.000359968,38,2
seeing,75,0.000137734,69,0.000157189,5.68E-05,6,2
robert,75,0.000137734,73,0.000166301,1.89E-05,2,2
results,75,0.000137734,72,0.000164023,2.84E-05,3,2
standing,75,0.000137734,45,0.000102514,0.000284185,30,2
favorite,75,0.000137734,42,9.57E-05,0.000312604,33,3
price,74,0.000135898,66,0.000150354,7.58E-05,8,1
using,74,0.000135898,61,0.000138964,0.000123147,13,2
guard,74,0.000135898,74,0.000168579,0,0,1
virus,74,0.000135898,74,0.000168579,0,0,2
covered,74,0.000135898,27,6.15E-05,0.000445223,47,2
nuclear,74,0.000135898,68,0.000154911,5.68E-05,6,2
destroy,74,0.000135898,74,0.000168579,0,0,2
director,74,0.000135898,71,0.000161745,2.84E-05,3,3
conversation,74,0.000135898,65,0.000148076,8.53E-05,9,4
putting,74,0.000135898,64,0.000145798,9.47E-05,10,2
air,73,0.000134061,58,0.00013213,0.000142093,15,1
youve,73,0.000134061,21,4.78E-05,0.000492588,52,1
death,73,0.000134061,70,0.000159467,2.84E-05,3,1
speak,73,0.000134061,56,0.000127573,0.000161038,17,1
helped,73,0.000134061,47,0.000107071,0.000246294,26,1
agreed,73,0.000134061,69,0.000157189,3.79E-05,4,2
except,73,0.000134061,72,0.000164023,9.47E-06,1,2
continues,73,0.000134061,67,0.000152632,5.68E-05,6,3
infrastructure,73,0.000134061,66,0.000150354,6.63E-05,7,4
lie,72,0.000132225,69,0.000157189,2.84E-05,3,1
idea,72,0.000132225,55,0.000125295,0.000161038,17,2
face,72,0.000132225,44,0.000100236,0.000265239,28,1
though,72,0.000132225,69,0.000157189,2.84E-05,3,1
france,72,0.000132225,72,0.000164023,0,0,1
elected,72,0.000132225,64,0.000145798,7.58E-05,8,2
someone,72,0.000132225,52,0.000118461,0.000189457,20,2
closely,72,0.000132225,72,0.000164023,0,0,3
speaking,72,0.000132225,45,0.000102514,0.000255767,27,2
disgrace,72,0.000132225,72,0.000164023,0,0,2
absolutely,72,0.000132225,68,0.000154911,3.79E-05,4,5
committee,72,0.000132225,72,0.000164023,0,0,3
kind,71,0.000130388,61,0.000138964,9.47E-05,10,1
issue,71,0.000130388,46,0.000104792,0.000236821,25,2
steel,71,0.000130388,67,0.000152632,3.79E-05,4,1
forget,71,0.000130388,61,0.000138964,9.47E-05,10,2
turkey,71,0.000130388,67,0.000152632,3.79E-05,4,2
canada,71,0.000130388,71,0.000161745,0,0,3
supporters,71,0.000130388,43,9.80E-05,0.000265239,28,3
killed,71,0.000130388,67,0.000152632,3.79E-05,4,1
whats,70,0.000128552,49,0.000111627,0.00019893,21,1
street,70,0.000128552,47,0.000107071,0.000217875,23,1
correct,70,0.000128552,70,0.000159467,0,0,2
bringing,70,0.000128552,58,0.00013213,0.000113674,12,2
congressional,70,0.000128552,57,0.000129851,0.000123147,13,4
hate,69,0.000126715,65,0.000148076,3.79E-05,4,1
mini,69,0.000126715,69,0.000157189,0,0,2
found,69,0.000126715,65,0.000148076,3.79E-05,4,1
dream,69,0.000126715,40,9.11E-05,0.000274712,29,1
maybe,69,0.000126715,68,0.000154911,9.47E-06,1,1
crimes,69,0.000126715,68,0.000154911,9.47E-06,1,1
afford,69,0.000126715,2,4.56E-06,0.00063468,67,2
points,69,0.000126715,67,0.000152632,1.89E-05,2,1
instead,69,0.000126715,51,0.000116183,0.000170511,18,2
defense,69,0.000126715,64,0.000145798,4.74E-05,5,2
involved,69,0.000126715,54,0.000123017,0.000142093,15,2
teachers,69,0.000126715,17,3.87E-05,0.000492588,52,2
louisiana,69,0.000126715,67,0.000152632,1.89E-05,2,4
majority,69,0.000126715,50,0.000113905,0.000179984,19,4
etc,68,0.000124879,68,0.000154911,0,0,1
page,68,0.000124879,63,0.00014352,4.74E-05,5,1
fought,68,0.000124879,48,0.000109349,0.000189457,20,1
reduce,68,0.000124879,22,5.01E-05,0.00043575,46,2
troops,68,0.000124879,49,0.000111627,0.000179984,19,1
question,68,0.000124879,53,0.000120739,0.000142093,15,2
politician,68,0.000124879,65,0.000148076,2.84E-05,3,4
tom,67,0.000123042,61,0.000138964,5.68E-05,6,1
wish,67,0.000123042,40,9.11E-05,0.000255767,27,1
rights,67,0.000123042,35,7.97E-05,0.000303131,32,1
created,67,0.000123042,41,9.34E-05,0.000246294,26,1
wouldnt,67,0.000123042,60,0.000136686,6.63E-05,7,1
representatives,67,0.000123042,53,0.000120739,0.00013262,14,5
met,66,0.000121206,59,0.000134408,6.63E-05,7,1
dan,66,0.000121206,66,0.000150354,0,0,1
rest,66,0.000121206,60,0.000136686,5.68E-05,6,1
term,66,0.000121206,51,0.000116183,0.000142093,15,1
added,66,0.000121206,20,4.56E-05,0.00043575,46,1
spent,66,0.000121206,61,0.000138964,4.74E-05,5,1
hundreds,66,0.000121206,58,0.00013213,7.58E-05,8,2
willing,66,0.000121206,41,9.34E-05,0.000236821,25,2
deficit,66,0.000121206,16,3.64E-05,0.000473642,50,3
situation,66,0.000121206,62,0.000141242,3.79E-05,4,3
mean,65,0.000119369,38,8.66E-05,0.000255767,27,1
nato,65,0.000119369,65,0.000148076,0,0,2
budget,65,0.000119369,28,6.38E-05,0.000350495,37,2
broken,65,0.000119369,40,9.11E-05,0.000236821,25,2
social,65,0.000119369,58,0.00013213,6.63E-05,7,2
january,65,0.000119369,39,8.88E-05,0.000246294,26,3
probably,65,0.000119369,64,0.000145798,9.47E-06,1,3
officials,65,0.000119369,59,0.000134408,5.68E-05,6,3
responders,65,0.000119369,61,0.000138964,3.79E-05,4,3
fraudulent,65,0.000119369,65,0.000148076,0,0,3
written,65,0.000119369,57,0.000129851,7.58E-05,8,2
fox,64,0.000117533,61,0.000138964,2.84E-05,3,1
east,64,0.000117533,62,0.000141242,1.89E-05,2,1
later,64,0.000117533,56,0.000127573,7.58E-05,8,2
clear,64,0.000117533,38,8.66E-05,0.000246294,26,1
focus,64,0.000117533,54,0.000123017,9.47E-05,10,2
serve,64,0.000117533,45,0.000102514,0.000179984,19,1
charge,64,0.000117533,56,0.000127573,7.58E-05,8,1
negative,64,0.000117533,62,0.000141242,1.89E-05,2,3
industry,64,0.000117533,42,9.57E-05,0.000208402,22,3
follow,64,0.000117533,46,0.000104792,0.000170511,18,2
credit,64,0.000117533,48,0.000109349,0.000151565,16,2
ban,63,0.000115697,52,0.000118461,0.000104201,11,1
debt,63,0.000115697,18,4.10E-05,0.000426278,45,1
ryan,63,0.000115697,25,5.70E-05,0.000359968,38,1
costs,63,0.000115697,31,7.06E-05,0.000303131,32,1
losing,63,0.000115697,59,0.000134408,3.79E-05,4,2
trumps,63,0.000115697,62,0.000141242,9.47E-06,1,1
puerto,63,0.000115697,63,0.00014352,0,0,2
courage,63,0.000115697,47,0.000107071,0.000151565,16,2
weekend,63,0.000115697,40,9.11E-05,0.000217875,23,2
certain,63,0.000115697,59,0.000134408,3.79E-05,4,2
approved,63,0.000115697,63,0.00014352,0,0,2
necessary,63,0.000115697,60,0.000136686,2.84E-05,3,4
announce,63,0.000115697,59,0.000134408,3.79E-05,4,2
within,63,0.000115697,53,0.000120739,9.47E-05,10,2
either,63,0.000115697,53,0.000120739,9.47E-05,10,2
immigrants,63,0.000115697,33,7.52E-05,0.000284185,30,3
buy,62,0.00011386,52,0.000118461,9.47E-05,10,1
kids,62,0.00011386,9,2.05E-05,0.00050206,53,1
grow,62,0.00011386,20,4.56E-05,0.000397859,42,1
fire,62,0.00011386,59,0.000134408,2.84E-05,3,1
arent,62,0.00011386,44,0.000100236,0.000170511,18,2
staff,62,0.00011386,54,0.000123017,7.58E-05,8,1
release,62,0.00011386,55,0.000125295,6.63E-05,7,2
thoughts,62,0.00011386,50,0.000113905,0.000113674,12,1
line,61,0.000112024,37,8.43E-05,0.000227348,24,1
rico,61,0.000112024,61,0.000138964,0,0,2
talks,61,0.000112024,50,0.000113905,0.000104201,11,1
tried,61,0.000112024,49,0.000111627,0.000113674,12,1
repeal,61,0.000112024,42,9.57E-05,0.000179984,19,2
judges,61,0.000112024,60,0.000136686,9.47E-06,1,1
growing,61,0.000112024,18,4.10E-05,0.000407332,43,2
promise,61,0.000112024,27,6.15E-05,0.000322076,34,2
changed,61,0.000112024,48,0.000109349,0.000123147,13,1
happens,61,0.000112024,46,0.000104792,0.000142093,15,2
reserve,61,0.000112024,60,0.000136686,9.47E-06,1,2
victims,61,0.000112024,44,0.000100236,0.000161038,17,2
difference,61,0.000112024,31,7.06E-05,0.000284185,30,3
cutting,61,0.000112024,41,9.34E-05,0.000189457,20,2
calling,61,0.000112024,44,0.000100236,0.000161038,17,2
five,60,0.000110187,21,4.78E-05,0.000369441,39,1
hand,60,0.000110187,50,0.000113905,9.47E-05,10,1
event,60,0.000110187,46,0.000104792,0.00013262,14,2
chris,60,0.000110187,60,0.000136686,0,0,1
germany,60,0.000110187,59,0.000134408,9.47E-06,1,3
chairman,60,0.000110187,60,0.000136686,0,0,2
scott,60,0.000110187,57,0.000129851,2.84E-05,3,1
whether,60,0.000110187,46,0.000104792,0.00013262,14,2
sent,59,0.000108351,51,0.000116183,7.58E-05,8,1
woman,59,0.000108351,26,5.92E-05,0.000312604,33,2
recent,59,0.000108351,53,0.000120739,5.68E-05,6,2
patriots,59,0.000108351,56,0.000127573,2.84E-05,3,2
trillion,59,0.000108351,44,0.000100236,0.000142093,15,2
committed,59,0.000108351,54,0.000123017,4.74E-05,5,2
list,58,0.000106514,42,9.57E-05,0.000151565,16,1
beat,58,0.000106514,54,0.000123017,3.79E-05,4,1
flag,58,0.000106514,55,0.000125295,2.84E-05,3,1
voice,58,0.000106514,22,5.01E-05,0.000341022,36,1
group,58,0.000106514,48,0.000109349,9.47E-05,10,1
hours,58,0.000106514,43,9.80E-05,0.000142093,15,1
whose,58,0.000106514,48,0.000109349,9.47E-05,10,1
chief,58,0.000106514,50,0.000113905,7.58E-05,8,1
peter,58,0.000106514,58,0.00013213,0,0,2
missed,58,0.000106514,29,6.61E-05,0.000274712,29,1
europe,58,0.000106514,58,0.00013213,0,0,2
passing,58,0.000106514,26,5.92E-05,0.000303131,32,2
liberal,58,0.000106514,57,0.000129851,9.47E-06,1,3
countrys,58,0.000106514,49,0.000111627,8.53E-05,9,2
likewise,58,0.000106514,58,0.00013213,0,0,3
celebrate,58,0.000106514,41,9.34E-05,0.000161038,17,3
bipartisan,58,0.000106514,36,8.20E-05,0.000208402,22,4
wait,58,0.000106514,29,6.61E-05,0.000274712,29,1
communities,58,0.000106514,43,9.80E-05,0.000142093,15,4
shot,57,0.000104678,34,7.75E-05,0.000217875,23,1
jong,57,0.000104678,57,0.000129851,0,0,1
answer,57,0.000104678,47,0.000107071,9.47E-05,10,2
course,57,0.000104678,51,0.000116183,5.68E-05,6,1
nevada,57,0.000104678,52,0.000118461,4.74E-05,5,3
leading,57,0.000104678,52,0.000118461,4.74E-05,5,2
raising,57,0.000104678,14,3.19E-05,0.000407332,43,2
hearing,57,0.000104678,55,0.000125295,1.89E-05,2,2
medicare,57,0.000104678,22,5.01E-05,0.000331549,35,3
deserves,57,0.000104678,19,4.33E-05,0.000359968,38,2
questions,57,0.000104678,50,0.000113905,6.63E-05,7,2
confidence,57,0.000104678,53,0.000120739,3.79E-05,4,3
anarchists,57,0.000104678,57,0.000129851,0,0,3
anniversary,57,0.000104678,24,5.47E-05,0.000312604,33,5
fall,57,0.000104678,31,7.06E-05,0.000246294,26,1
manufacturing,57,0.000104678,43,9.80E-05,0.00013262,14,5
clue,56,0.000102841,56,0.000127573,0,0,1
human,56,0.000102841,50,0.000113905,5.68E-05,6,2
sorry,56,0.000102841,55,0.000125295,9.47E-06,1,2
greater,56,0.000102841,49,0.000111627,6.63E-05,7,2
deliver,56,0.000102841,48,0.000109349,7.58E-05,8,3
pleased,56,0.000102841,53,0.000120739,2.84E-05,3,1
eastern,56,0.000102841,54,0.000123017,1.89E-05,2,2
request,56,0.000102841,56,0.000127573,0,0,2
greatly,56,0.000102841,56,0.000127573,0,0,2
recovery,56,0.000102841,45,0.000102514,0.000104201,11,4
financial,56,0.000102841,38,8.66E-05,0.000170511,18,3
legislation,56,0.000102841,44,0.000100236,0.000113674,12,4
ill,56,0.000102841,33,7.52E-05,0.000217875,23,1
visit,56,0.000102841,44,0.000100236,0.000113674,12,2
car,55,0.000101005,39,8.88E-05,0.000151565,16,1
moment,55,0.000101005,18,4.10E-05,0.000350495,37,2
turned,55,0.000101005,47,0.000107071,7.58E-05,8,1
havent,55,0.000101005,42,9.57E-05,0.000123147,13,2
bidens,55,0.000101005,55,0.000125295,0,0,2
perfect,55,0.000101005,40,9.11E-05,0.000142093,15,2
impeach,55,0.000101005,55,0.000125295,0,0,2
problems,55,0.000101005,48,0.000109349,6.63E-05,7,2
kentucky,55,0.000101005,54,0.000123017,9.47E-06,1,3
pressure,55,0.000101005,54,0.000123017,9.47E-06,1,2
disgraceful,55,0.000101005,55,0.000125295,0,0,4
michelle,55,0.000101005,15,3.42E-05,0.000378913,40,2
yes,54,9.92E-05,41,9.34E-05,0.000123147,13,1
rep,54,9.92E-05,46,0.000104792,7.58E-05,8,1
hold,54,9.92E-05,43,9.80E-05,0.000104201,11,1
shut,54,9.92E-05,38,8.66E-05,0.000151565,16,1
simple,54,9.92E-05,40,9.11E-05,0.00013262,14,2
keeping,54,9.92E-05,41,9.34E-05,0.000123147,13,2
watched,54,9.92E-05,52,0.000118461,1.89E-05,2,1
lawyers,54,9.92E-05,54,0.000123017,0,0,2
received,54,9.92E-05,47,0.000107071,6.63E-05,7,2
governors,54,9.92E-05,54,0.000123017,0,0,3
outstanding,54,9.92E-05,50,0.000113905,3.79E-05,4,3
interesting,54,9.92E-05,53,0.000120739,9.47E-06,1,4
setting,54,9.92E-05,50,0.000113905,3.79E-05,4,2
gop,53,9.73E-05,24,5.47E-05,0.000274712,29,1
video,53,9.73E-05,14,3.19E-05,0.000369441,39,2
black,53,9.73E-05,50,0.000113905,2.84E-05,3,1
kevin,53,9.73E-05,52,0.000118461,9.47E-06,1,2
swamp,53,9.73E-05,53,0.000120739,0,0,1
womens,53,9.73E-05,17,3.87E-05,0.000341022,36,2
patrol,53,9.73E-05,53,0.000120739,0,0,2
minutes,53,9.73E-05,34,7.75E-05,0.000179984,19,2
district,53,9.73E-05,50,0.000113905,2.84E-05,3,2
loopholes,53,9.73E-05,34,7.75E-05,0.000179984,19,3
ukrainian,53,9.73E-05,53,0.000120739,0,0,3
responsible,53,9.73E-05,36,8.20E-05,0.000161038,17,4
importantly,53,9.73E-05,52,0.000118461,9.47E-06,1,4
dinner,53,9.73E-05,26,5.92E-05,0.000255767,27,2
credibility,53,9.73E-05,51,0.000116183,1.89E-05,2,5
dem,52,9.55E-05,52,0.000118461,0,0,1
spend,52,9.55E-05,37,8.43E-05,0.000142093,15,1
rules,52,9.55E-05,36,8.20E-05,0.000151565,16,2
takes,52,9.55E-05,31,7.06E-05,0.00019893,21,1
demand,52,9.55E-05,39,8.88E-05,0.000123147,13,2
schools,52,9.55E-05,37,8.43E-05,0.000142093,15,1
company,52,9.55E-05,36,8.20E-05,0.000151565,16,3
reasons,52,9.55E-05,38,8.66E-05,0.00013262,14,2
shortly,52,9.55E-05,52,0.000118461,0,0,2
anywhere,52,9.55E-05,50,0.000113905,1.89E-05,2,3
expensive,52,9.55E-05,47,0.000107071,4.74E-05,5,3
enthusiasm,52,9.55E-05,52,0.000118461,0,0,3
conditions,52,9.55E-05,37,8.43E-05,0.000142093,15,3
led,51,9.37E-05,44,0.000100236,6.63E-05,7,1
aid,51,9.37E-05,38,8.66E-05,0.000123147,13,1
wife,51,9.37E-05,48,0.000109349,2.84E-05,3,1
exist,51,9.37E-05,46,0.000104792,4.74E-05,5,2
trial,51,9.37E-05,51,0.000116183,0,0,1
behind,51,9.37E-05,30,6.83E-05,0.00019893,21,2
acting,51,9.37E-05,49,0.000111627,1.89E-05,2,2
stands,51,9.37E-05,42,9.57E-05,8.53E-05,9,1
behalf,51,9.37E-05,43,9.80E-05,7.58E-05,8,2
center,51,9.37E-05,47,0.000107071,3.79E-05,4,2
anyway,51,9.37E-05,51,0.000116183,0,0,3
message,51,9.37E-05,25,5.70E-05,0.000246294,26,2
sanders,51,9.37E-05,51,0.000116183,0,0,2
whatever,51,9.37E-05,41,9.34E-05,9.47E-05,10,3
criminals,51,9.37E-05,48,0.000109349,2.84E-05,3,3
emergency,51,9.37E-05,44,0.000100236,6.63E-05,7,4
sanctuary,51,9.37E-05,51,0.000116183,0,0,3
transcript,51,9.37E-05,51,0.000116183,0,0,2
killing,51,9.37E-05,50,0.000113905,9.47E-06,1,2
loan,50,9.18E-05,5,1.14E-05,0.000426278,45,1
cold,50,9.18E-05,46,0.000104792,3.79E-05,4,1
died,50,9.18E-05,43,9.80E-05,6.63E-05,7,1
earth,50,9.18E-05,30,6.83E-05,0.000189457,20,1
third,50,9.18E-05,44,0.000100236,5.68E-05,6,1
cuomo,50,9.18E-05,50,0.000113905,0,0,2
usmca,50,9.18E-05,50,0.000113905,0,0,2
became,50,9.18E-05,38,8.66E-05,0.000113674,12,2
spread,50,9.18E-05,18,4.10E-05,0.000303131,32,1
access,50,9.18E-05,25,5.70E-05,0.000236821,25,2
ending,50,9.18E-05,31,7.06E-05,0.000179984,19,2
monday,50,9.18E-05,45,0.000102514,4.74E-05,5,2
proven,50,9.18E-05,50,0.000113905,0,0,2
emails,50,9.18E-05,50,0.000113905,0,0,2
honored,50,9.18E-05,47,0.000107071,2.84E-05,3,2
fighter,50,9.18E-05,50,0.000113905,0,0,2
scandal,50,9.18E-05,50,0.000113905,0,0,2
saturday,50,9.18E-05,46,0.000104792,3.79E-05,4,3
advantage,50,9.18E-05,47,0.000107071,2.84E-05,3,3
incompetent,50,9.18E-05,50,0.000113905,0,0,4
gotten,50,9.18E-05,49,0.000111627,9.47E-06,1,2
polling,50,9.18E-05,42,9.57E-05,7.58E-05,8,2
additional,50,9.18E-05,45,0.000102514,4.74E-05,5,4
commitment,50,9.18E-05,25,5.70E-05,0.000236821,25,3
nbc,49,9.00E-05,49,0.000111627,0,0,1
auto,49,9.00E-05,29,6.61E-05,0.000189457,20,2
half,49,9.00E-05,25,5.70E-05,0.000227348,24,1
head,49,9.00E-05,39,8.88E-05,9.47E-05,10,1
gives,49,9.00E-05,37,8.43E-05,0.000113674,12,1
known,49,9.00E-05,47,0.000107071,1.89E-05,2,1
dirty,49,9.00E-05,48,0.000109349,9.47E-06,1,2
secure,49,9.00E-05,39,8.88E-05,9.47E-05,10,2
weekly,49,9.00E-05,12,2.73E-05,0.000350495,37,2
served,49,9.00E-05,37,8.43E-05,0.000113674,12,1
finish,49,9.00E-05,24,5.47E-05,0.000236821,25,2
poorly,49,9.00E-05,49,0.000111627,0,0,2
shifty,49,9.00E-05,49,0.000111627,0,0,2
sending,49,9.00E-05,41,9.34E-05,7.58E-05,8,2
chinese,49,9.00E-05,47,0.000107071,1.89E-05,2,2
replace,49,9.00E-05,49,0.000111627,0,0,2
champion,49,9.00E-05,42,9.57E-05,6.63E-05,7,2
decisions,49,9.00E-05,24,5.47E-05,0.000236821,25,3
desperately,49,9.00E-05,49,0.000111627,0,0,5
tennessee,49,9.00E-05,47,0.000107071,1.89E-05,2,3
extraordinary,49,9.00E-05,40,9.11E-05,8.53E-05,9,5
gas,48,8.81E-05,34,7.75E-05,0.00013262,14,1
due,48,8.81E-05,41,9.34E-05,6.63E-05,7,1
ice,48,8.81E-05,46,0.000104792,1.89E-05,2,1
huge,48,8.81E-05,30,6.83E-05,0.000170511,18,1
goes,48,8.81E-05,41,9.34E-05,6.63E-05,7,1
oval,48,8.81E-05,38,8.66E-05,9.47E-05,10,2
covid,48,8.81E-05,48,0.000109349,0,0,2
sadly,48,8.81E-05,48,0.000109349,0,0,2
impact,48,8.81E-05,36,8.20E-05,0.000113674,12,2
private,48,8.81E-05,22,5.01E-05,0.000246294,26,2
mistake,48,8.81E-05,45,0.000102514,2.84E-05,3,2
records,48,8.81E-05,46,0.000104792,1.89E-05,2,2
straight,48,8.81E-05,20,4.56E-05,0.000265239,28,1
executive,48,8.81E-05,43,9.80E-05,4.74E-05,5,4
supporter,48,8.81E-05,46,0.000104792,1.89E-05,2,3
elections,48,8.81E-05,40,9.11E-05,7.58E-05,8,3
completely,48,8.81E-05,44,0.000100236,3.79E-05,4,4
convention,48,8.81E-05,39,8.88E-05,8.53E-05,9,3
mainstream,48,8.81E-05,48,0.000109349,0,0,2
kelly,48,8.81E-05,47,0.000107071,9.47E-06,1,2
gov,47,8.63E-05,13,2.96E-05,0.000322076,34,1
poor,47,8.63E-05,43,9.80E-05,3.79E-05,4,1
king,47,8.63E-05,37,8.43E-05,9.47E-05,10,1
star,47,8.63E-05,41,9.34E-05,5.68E-05,6,1
fine,47,8.63E-05,47,0.000107071,0,0,1
fisa,47,8.63E-05,47,0.000107071,0,0,2
beyond,47,8.63E-05,43,9.80E-05,3.79E-05,4,2
puppet,47,8.63E-05,47,0.000107071,0,0,2
serious,47,8.63E-05,35,7.97E-05,0.000113674,12,3
forever,47,8.63E-05,43,9.80E-05,3.79E-05,4,3
players,47,8.63E-05,46,0.000104792,9.47E-06,1,2
vietnam,47,8.63E-05,46,0.000104792,9.47E-06,1,2
strength,47,8.63E-05,40,9.11E-05,6.63E-05,7,1
officers,47,8.63E-05,42,9.57E-05,4.74E-05,5,3
consumer,47,8.63E-05,39,8.88E-05,7.58E-05,8,3
documents,47,8.63E-05,47,0.000107071,0,0,3
statements,47,8.63E-05,45,0.000102514,1.89E-05,2,3
innocent,47,8.63E-05,44,0.000100236,2.84E-05,3,3
matt,47,8.63E-05,46,0.000104792,9.47E-06,1,1
pathetic,47,8.63E-05,47,0.000107071,0,0,3
write,47,8.63E-05,33,7.52E-05,0.00013262,14,1
mitch,47,8.63E-05,46,0.000104792,9.47E-06,1,1
spirit,47,8.63E-05,39,8.88E-05,7.58E-05,8,2
exciting,47,8.63E-05,44,0.000100236,2.84E-05,3,3
politicians,47,8.63E-05,38,8.66E-05,8.53E-05,9,4
ways,46,8.45E-05,27,6.15E-05,0.000179984,19,1
held,46,8.45E-05,40,9.11E-05,5.68E-05,6,1
cars,46,8.45E-05,34,7.75E-05,0.000113674,12,1
hero,46,8.45E-05,41,9.34E-05,4.74E-05,5,2
wars,46,8.45E-05,41,9.34E-05,4.74E-05,5,1
enter,46,8.45E-05,23,5.24E-05,0.000217875,23,2
often,46,8.45E-05,39,8.88E-05,6.63E-05,7,2
abuse,46,8.45E-05,45,0.000102514,9.47E-06,1,2
lying,46,8.45E-05,46,0.000104792,0,0,1
effort,46,8.45E-05,35,7.97E-05,0.000104201,11,2
double,46,8.45E-05,23,5.24E-05,0.000217875,23,2
income,46,8.45E-05,20,4.56E-05,0.000246294,26,2
closed,46,8.45E-05,44,0.000100236,1.89E-05,2,1
prevent,46,8.45E-05,10,2.28E-05,0.000341022,36,2
remarks,46,8.45E-05,39,8.88E-05,6.63E-05,7,2
arrived,46,8.45E-05,44,0.000100236,1.89E-05,2,2
christmas,46,8.45E-05,26,5.92E-05,0.000189457,20,2
presidency,46,8.45E-05,43,9.80E-05,2.84E-05,3,4
background,46,8.45E-05,10,2.28E-05,0.000341022,36,2
concerning,46,8.45E-05,46,0.000104792,0,0,3
therefore,46,8.45E-05,46,0.000104792,0,0,3
rid,45,8.26E-05,39,8.88E-05,5.68E-05,6,1
begin,45,8.26E-05,35,7.97E-05,9.47E-05,10,2
relief,45,8.26E-05,36,8.20E-05,8.53E-05,9,2
wonder,45,8.26E-05,44,0.000100236,9.47E-06,1,2
african,45,8.26E-05,40,9.11E-05,4.74E-05,5,3
program,45,8.26E-05,32,7.29E-05,0.000123147,13,2
movement,45,8.26E-05,22,5.01E-05,0.000217875,23,3
justices,45,8.26E-05,42,9.57E-05,2.84E-05,3,2
recently,45,8.26E-05,43,9.80E-05,1.89E-05,2,3
products,45,8.26E-05,42,9.57E-05,2.84E-05,3,2
portland,45,8.26E-05,45,0.000102514,0,0,2
protection,45,8.26E-05,42,9.57E-05,2.84E-05,3,3
rebuilding,45,8.26E-05,37,8.43E-05,7.58E-05,8,3
letter,45,8.26E-05,33,7.52E-05,0.000113674,12,2
red,44,8.08E-05,36,8.20E-05,7.58E-05,8,1
miss,44,8.08E-05,16,3.64E-05,0.000265239,28,1
rule,44,8.08E-05,36,8.20E-05,7.58E-05,8,2
lisa,44,8.08E-05,44,0.000100236,0,0,2
worth,44,8.08E-05,25,5.70E-05,0.000179984,19,1
child,44,8.08E-05,13,2.96E-05,0.000293658,31,1
loved,44,8.08E-05,32,7.29E-05,0.000113674,12,1
march,44,8.08E-05,31,7.06E-05,0.000123147,13,1
loser,44,8.08E-05,43,9.80E-05,9.47E-06,1,2
harder,44,8.08E-05,34,7.75E-05,9.47E-05,10,2
warren,44,8.08E-05,34,7.75E-05,9.47E-05,10,2
landed,44,8.08E-05,43,9.80E-05,9.47E-06,1,1
amazon,44,8.08E-05,44,0.000100236,0,0,3
pushing,44,8.08E-05,37,8.43E-05,6.63E-05,7,2
stopped,44,8.08E-05,38,8.66E-05,5.68E-05,6,1
holding,44,8.08E-05,31,7.06E-05,0.000123147,13,2
pouring,44,8.08E-05,43,9.80E-05,9.47E-06,1,2
outside,44,8.08E-05,42,9.57E-05,1.89E-05,2,2
deadline,44,8.08E-05,6,1.37E-05,0.000359968,38,2
partisan,44,8.08E-05,35,7.97E-05,8.53E-05,9,3
promised,44,8.08E-05,26,5.92E-05,0.000170511,18,2
memorial,44,8.08E-05,30,6.83E-05,0.00013262,14,3
european,44,8.08E-05,44,0.000100236,0,0,3
testimony,44,8.08E-05,44,0.000100236,0,0,4
protecting,44,8.08E-05,35,7.97E-05,8.53E-05,9,3
candidates,44,8.08E-05,35,7.97E-05,8.53E-05,9,3
condolences,44,8.08E-05,39,8.88E-05,4.74E-05,5,3
hell,44,8.08E-05,41,9.34E-05,2.84E-05,3,1
positive,44,8.08E-05,44,0.000100236,0,0,3
witnesses,44,8.08E-05,44,0.000100236,0,0,2
nyc,43,7.90E-05,40,9.11E-05,2.84E-05,3,1
navy,43,7.90E-05,41,9.34E-05,1.89E-05,2,2
kept,43,7.90E-05,27,6.15E-05,0.000151565,16,1
water,43,7.90E-05,37,8.43E-05,5.68E-05,6,2
loans,43,7.90E-05,3,6.83E-06,0.000378913,40,1
prior,43,7.90E-05,43,9.80E-05,0,0,1
fights,43,7.90E-05,34,7.75E-05,8.53E-05,9,1
threat,43,7.90E-05,21,4.78E-05,0.000208402,22,1
claims,43,7.90E-05,29,6.61E-05,0.00013262,14,1
period,43,7.90E-05,37,8.43E-05,5.68E-05,6,2
dropped,43,7.90E-05,39,8.88E-05,3.79E-05,4,1
anymore,43,7.90E-05,39,8.88E-05,3.79E-05,4,3
reports,43,7.90E-05,42,9.57E-05,9.47E-06,1,2
product,43,7.90E-05,43,9.80E-05,0,0,2
testify,43,7.90E-05,43,9.80E-05,0,0,3
sanctions,43,7.90E-05,40,9.11E-05,2.84E-05,3,2
kavanaugh,43,7.90E-05,43,9.80E-05,0,0,3
television,43,7.90E-05,41,9.34E-05,1.89E-05,2,4
afghanistan,43,7.90E-05,24,5.47E-05,0.000179984,19,4
theyve,43,7.90E-05,36,8.20E-05,6.63E-05,7,1
millionaires,43,7.90E-05,0,0,0.000407332,43,3
summit,43,7.90E-05,40,9.11E-05,2.84E-05,3,2
son,42,7.71E-05,35,7.97E-05,6.63E-05,7,1
gdp,42,7.71E-05,42,9.57E-05,0,0,1
trip,42,7.71E-05,30,6.83E-05,0.000113674,12,1
joke,42,7.71E-05,38,8.66E-05,3.79E-05,4,1
feel,42,7.71E-05,32,7.29E-05,9.47E-05,10,1
form,42,7.71E-05,36,8.20E-05,5.68E-05,6,1
lied,42,7.71E-05,42,9.57E-05,0,0,1
plans,42,7.71E-05,19,4.33E-05,0.000217875,23,1
solve,42,7.71E-05,31,7.06E-05,0.000104201,11,1
wrote,42,7.71E-05,37,8.43E-05,4.74E-05,5,1
photo,42,7.71E-05,7,1.59E-05,0.000331549,35,2
travel,42,7.71E-05,38,8.66E-05,3.79E-05,4,2
member,42,7.71E-05,31,7.06E-05,0.000104201,11,2
friday,42,7.71E-05,28,6.38E-05,0.00013262,14,2
barack,42,7.71E-05,17,3.87E-05,0.000236821,25,2
anybody,42,7.71E-05,35,7.97E-05,6.63E-05,7,4
average,42,7.71E-05,15,3.42E-05,0.000255767,27,3
refuses,42,7.71E-05,37,8.43E-05,4.74E-05,5,2
subject,42,7.71E-05,40,9.11E-05,1.89E-05,2,2
section,42,7.71E-05,42,9.57E-05,0,0,2
promises,42,7.71E-05,36,8.20E-05,5.68E-05,6,2
terrific,42,7.71E-05,42,9.57E-05,0,0,3
regulations,42,7.71E-05,42,9.57E-05,0,0,4
ventilators,42,7.71E-05,42,9.57E-05,0,0,4
waiting,42,7.71E-05,39,8.88E-05,2.84E-05,3,2
equality,42,7.71E-05,5,1.14E-05,0.000350495,37,4
saw,41,7.53E-05,34,7.75E-05,6.63E-05,7,1
slow,41,7.53E-05,38,8.66E-05,2.84E-05,3,1
ones,41,7.53E-05,30,6.83E-05,0.000104201,11,1
ended,41,7.53E-05,35,7.97E-05,5.68E-05,6,1
brian,41,7.53E-05,41,9.34E-05,0,0,1
raised,41,7.53E-05,22,5.01E-05,0.000179984,19,1
county,41,7.53E-05,41,9.34E-05,0,0,2
played,41,7.53E-05,41,9.34E-05,0,0,1
turning,41,7.53E-05,31,7.06E-05,9.47E-05,10,2
efforts,41,7.53E-05,25,5.70E-05,0.000151565,16,2
mention,41,7.53E-05,40,9.11E-05,9.47E-06,1,2
amounts,41,7.53E-05,41,9.34E-05,0,0,2
thinking,41,7.53E-05,37,8.43E-05,3.79E-05,4,2
standard,41,7.53E-05,39,8.88E-05,1.89E-05,2,2
russians,41,7.53E-05,41,9.34E-05,0,0,2
harassment,41,7.53E-05,41,9.34E-05,0,0,3
transcripts,41,7.53E-05,41,9.34E-05,0,0,2
anthem,41,7.53E-05,40,9.11E-05,9.47E-06,1,2
negotiations,41,7.53E-05,41,9.34E-05,0,0,4
path,40,7.35E-05,30,6.83E-05,9.47E-05,10,1
area,40,7.35E-05,38,8.66E-05,1.89E-05,2,2
fema,40,7.35E-05,37,8.43E-05,2.84E-05,3,2
miles,40,7.35E-05,39,8.88E-05,9.47E-06,1,2
spied,40,7.35E-05,40,9.11E-05,0,0,1
cryin,40,7.35E-05,40,9.11E-05,0,0,1
short,40,7.35E-05,40,9.11E-05,0,0,1
putin,40,7.35E-05,40,9.11E-05,0,0,2
speaks,40,7.35E-05,10,2.28E-05,0.000284185,30,1
source,40,7.35E-05,34,7.75E-05,5.68E-05,6,1
result,40,7.35E-05,39,8.88E-05,9.47E-06,1,2
strzok,40,7.35E-05,40,9.11E-05,0,0,1
medical,40,7.35E-05,34,7.75E-05,5.68E-05,6,3
provide,40,7.35E-05,28,6.38E-05,0.000113674,12,2
payments,40,7.35E-05,36,8.20E-05,3.79E-05,4,2
barriers,40,7.35E-05,38,8.66E-05,1.89E-05,2,2
discussed,40,7.35E-05,39,8.88E-05,9.47E-06,1,2
afternoon,40,7.35E-05,35,7.97E-05,4.74E-05,5,3
throughout,40,7.35E-05,38,8.66E-05,1.89E-05,2,2
classified,40,7.35E-05,40,9.11E-05,0,0,3
minneapolis,40,7.35E-05,40,9.11E-05,0,0,4
matters,40,7.35E-05,17,3.87E-05,0.000217875,23,2
land,39,7.16E-05,35,7.97E-05,3.79E-05,4,1
june,39,7.16E-05,33,7.52E-05,5.68E-05,6,1
gang,39,7.16E-05,39,8.88E-05,0,0,1
golf,39,7.16E-05,39,8.88E-05,0,0,1
learn,39,7.16E-05,24,5.47E-05,0.000142093,15,1
roger,39,7.16E-05,38,8.66E-05,9.47E-06,1,2
pence,39,7.16E-05,39,8.88E-05,0,0,1
drain,39,7.16E-05,39,8.88E-05,0,0,1
toward,39,7.16E-05,25,5.70E-05,0.00013262,14,2
return,39,7.16E-05,33,7.52E-05,5.68E-05,6,2
unable,39,7.16E-05,38,8.66E-05,9.47E-06,1,3
speaker,39,7.16E-05,36,8.20E-05,2.84E-05,3,2
opening,39,7.16E-05,34,7.75E-05,4.74E-05,5,3
showing,39,7.16E-05,36,8.20E-05,2.84E-05,3,2
missing,39,7.16E-05,37,8.43E-05,1.89E-05,2,2
vaccine,39,7.16E-05,39,8.88E-05,0,0,2
vicious,39,7.16E-05,39,8.88E-05,0,0,3
services,39,7.16E-05,20,4.56E-05,0.000179984,19,2
soldiers,39,7.16E-05,38,8.66E-05,9.47E-06,1,2
talented,39,7.16E-05,37,8.43E-05,1.89E-05,2,2
informed,39,7.16E-05,38,8.66E-05,9.47E-06,1,2
numerous,39,7.16E-05,39,8.88E-05,0,0,3
sessions,39,7.16E-05,39,8.88E-05,0,0,2
september,39,7.16E-05,30,6.83E-05,8.53E-05,9,3
apologize,39,7.16E-05,38,8.66E-05,9.47E-06,1,4
hampshire,39,7.16E-05,35,7.97E-05,3.79E-05,4,2
elizabeth,39,7.16E-05,35,7.97E-05,3.79E-05,4,4
terrorist,39,7.16E-05,38,8.66E-05,9.47E-06,1,3
supporting,39,7.16E-05,20,4.56E-05,0.000179984,19,3
disgusting,39,7.16E-05,39,8.88E-05,0,0,3
ambassador,39,7.16E-05,39,8.88E-05,0,0,4
celebrating,39,7.16E-05,18,4.10E-05,0.00019893,21,4
prescription,39,7.16E-05,29,6.61E-05,9.47E-05,10,3
conservative,39,7.16E-05,33,7.52E-05,5.68E-05,6,4
allowing,39,7.16E-05,37,8.43E-05,1.89E-05,2,3
six,38,6.98E-05,22,5.01E-05,0.000151565,16,1
doj,38,6.98E-05,38,8.66E-05,0,0,1
con,38,6.98E-05,38,8.66E-05,0,0,1
near,38,6.98E-05,26,5.92E-05,0.000113674,12,1
rick,38,6.98E-05,37,8.43E-05,9.47E-06,1,1
bush,38,6.98E-05,34,7.75E-05,3.79E-05,4,1
hasnt,38,6.98E-05,29,6.61E-05,8.53E-05,9,1
favor,38,6.98E-05,31,7.06E-05,6.63E-05,7,2
reach,38,6.98E-05,15,3.42E-05,0.000217875,23,1
doubt,38,6.98E-05,34,7.75E-05,3.79E-05,4,1
break,38,6.98E-05,29,6.61E-05,8.53E-05,9,1
tweet,38,6.98E-05,11,2.51E-05,0.000255767,27,1
usual,38,6.98E-05,37,8.43E-05,9.47E-06,1,2
scale,38,6.98E-05,38,8.66E-05,0,0,2
remain,38,6.98E-05,33,7.52E-05,4.74E-05,5,2
refuse,38,6.98E-05,30,6.83E-05,7.58E-05,8,2
listen,38,6.98E-05,26,5.92E-05,0.000113674,12,2
fairly,38,6.98E-05,34,7.75E-05,3.79E-05,4,2
courts,38,6.98E-05,34,7.75E-05,3.79E-05,4,1
current,38,6.98E-05,31,7.06E-05,6.63E-05,7,2
signing,38,6.98E-05,31,7.06E-05,6.63E-05,7,2
inflation,38,6.98E-05,37,8.43E-05,9.47E-06,1,3
destroyed,38,6.98E-05,37,8.43E-05,9.47E-06,1,2
protesters,38,6.98E-05,38,8.66E-05,0,0,3
luther,38,6.98E-05,33,7.52E-05,4.74E-05,5,2
hits,38,6.98E-05,38,8.66E-05,0,0,1
prosperity,38,6.98E-05,33,7.52E-05,4.74E-05,5,4
spy,37,6.79E-05,35,7.97E-05,1.89E-05,2,1
jay,37,6.79E-05,32,7.29E-05,4.74E-05,5,1
nfl,37,6.79E-05,36,8.20E-05,9.47E-06,1,1
don,37,6.79E-05,37,8.43E-05,0,0,1
july,37,6.79E-05,25,5.70E-05,0.000113674,12,2
room,37,6.79E-05,32,7.29E-05,4.74E-05,5,1
hands,37,6.79E-05,28,6.38E-05,8.53E-05,9,1
ideas,37,6.79E-05,18,4.10E-05,0.000179984,19,2
broke,37,6.79E-05,32,7.29E-05,4.74E-05,5,1
likes,37,6.79E-05,36,8.20E-05,9.47E-06,1,1
blame,37,6.79E-05,36,8.20E-05,9.47E-06,1,1
named,37,6.79E-05,36,8.20E-05,9.47E-06,1,1
worker,37,6.79E-05,28,6.38E-05,8.53E-05,9,2
george,37,6.79E-05,30,6.83E-05,6.63E-05,7,1
checks,37,6.79E-05,11,2.51E-05,0.000246294,26,1
largest,37,6.79E-05,30,6.83E-05,6.63E-05,7,2
popular,37,6.79E-05,35,7.97E-05,1.89E-05,2,3
counsel,37,6.79E-05,37,8.43E-05,0,0,2
expected,37,6.79E-05,35,7.97E-05,1.89E-05,2,2
difficult,37,6.79E-05,35,7.97E-05,1.89E-05,2,3
regulation,37,6.79E-05,35,7.97E-05,1.89E-05,2,4
mississippi,37,6.79E-05,36,8.20E-05,9.47E-06,1,4
abe,36,6.61E-05,36,8.20E-05,0,0,1
luck,36,6.61E-05,30,6.83E-05,5.68E-05,6,1
vice,36,6.61E-05,27,6.15E-05,8.53E-05,9,1
among,36,6.61E-05,31,7.06E-05,4.74E-05,5,2
field,36,6.61E-05,26,5.92E-05,9.47E-05,10,1
count,36,6.61E-05,28,6.38E-05,7.58E-05,8,1
heart,36,6.61E-05,28,6.38E-05,7.58E-05,8,1
green,36,6.61E-05,27,6.15E-05,8.53E-05,9,1
saudi,36,6.61E-05,36,8.20E-05,0,0,2
funds,36,6.61E-05,36,8.20E-05,0,0,1
living,36,6.61E-05,18,4.10E-05,0.000170511,18,2
prison,36,6.61E-05,32,7.29E-05,3.79E-05,4,2
faster,36,6.61E-05,29,6.61E-05,6.63E-05,7,2
values,36,6.61E-05,25,5.70E-05,0.000104201,11,2
simply,36,6.61E-05,27,6.15E-05,8.53E-05,9,2
crowds,36,6.61E-05,35,7.97E-05,9.47E-06,1,1
headed,36,6.61E-05,31,7.06E-05,4.74E-05,5,1
century,36,6.61E-05,18,4.10E-05,0.000170511,18,3
restore,36,6.61E-05,21,4.78E-05,0.000142093,15,2
imagine,36,6.61E-05,29,6.61E-05,6.63E-05,7,3
weapons,36,6.61E-05,30,6.83E-05,5.68E-05,6,2
breaking,36,6.61E-05,32,7.29E-05,3.79E-05,4,2
shooting,36,6.61E-05,32,7.29E-05,3.79E-05,4,2
response,36,6.61E-05,31,7.06E-05,4.74E-05,5,2
strongest,36,6.61E-05,30,6.83E-05,5.68E-05,6,2
inaccurate,36,6.61E-05,36,8.20E-05,0,0,4
forgotten,36,6.61E-05,29,6.61E-05,6.63E-05,7,3
winner,36,6.61E-05,34,7.75E-05,1.89E-05,2,2
accomplished,36,6.61E-05,32,7.29E-05,3.79E-05,4,3
payroll,36,6.61E-05,15,3.42E-05,0.00019893,21,2
football,36,6.61E-05,33,7.52E-05,2.84E-05,3,2
constitution,36,6.61E-05,33,7.52E-05,2.84E-05,3,4
comprehensive,36,6.61E-05,11,2.51E-05,0.000236821,25,4
lou,35,6.43E-05,35,7.97E-05,0,0,1
pro,35,6.43E-05,35,7.97E-05,0,0,1
lgbt,35,6.43E-05,3,6.83E-06,0.000303131,32,#ERROR!
tech,35,6.43E-05,34,7.75E-05,9.47E-06,1,1
deep,35,6.43E-05,32,7.29E-05,2.84E-05,3,1
sense,35,6.43E-05,21,4.78E-05,0.00013262,14,1
board,35,6.43E-05,31,7.06E-05,3.79E-05,4,1
coast,35,6.43E-05,29,6.61E-05,5.68E-05,6,1
swing,35,6.43E-05,35,7.97E-05,0,0,1
seems,35,6.43E-05,35,7.97E-05,0,0,1
nafta,35,6.43E-05,35,7.97E-05,0,0,2
jerry,35,6.43E-05,35,7.97E-05,0,0,2
voices,35,6.43E-05,13,2.96E-05,0.000208402,22,1
haters,35,6.43E-05,35,7.97E-05,0,0,2
wanting,35,6.43E-05,32,7.29E-05,2.84E-05,3,2
actions,35,6.43E-05,28,6.38E-05,6.63E-05,7,2
markets,35,6.43E-05,31,7.06E-05,3.79E-05,4,2
veteran,35,6.43E-05,24,5.47E-05,0.000104201,11,3
explain,35,6.43E-05,30,6.83E-05,4.74E-05,5,2
chicago,35,6.43E-05,23,5.24E-05,0.000113674,12,3
receive,35,6.43E-05,25,5.70E-05,9.47E-05,10,2
partner,35,6.43E-05,32,7.29E-05,2.84E-05,3,2
richard,35,6.43E-05,29,6.61E-05,5.68E-05,6,2
exactly,35,6.43E-05,30,6.83E-05,4.74E-05,5,3
approve,35,6.43E-05,34,7.75E-05,9.47E-06,1,2
rapidly,35,6.43E-05,35,7.97E-05,0,0,3
counting,35,6.43E-05,19,4.33E-05,0.000151565,16,2
creating,35,6.43E-05,19,4.33E-05,0.000151565,16,2
tonights,35,6.43E-05,8,1.82E-05,0.000255767,27,2
returned,35,6.43E-05,33,7.52E-05,1.89E-05,2,2
properly,35,6.43E-05,35,7.97E-05,0,0,3
currently,35,6.43E-05,30,6.83E-05,4.74E-05,5,3
bloomberg,35,6.43E-05,34,7.75E-05,9.47E-06,1,2
according,35,6.43E-05,35,7.97E-05,0,0,3
impossible,35,6.43E-05,33,7.52E-05,1.89E-05,2,4
transparency,35,6.43E-05,32,7.29E-05,2.84E-05,3,4
youll,35,6.43E-05,10,2.28E-05,0.000236821,25,1
fellow,35,6.43E-05,18,4.10E-05,0.000161038,17,2
powell,35,6.43E-05,32,7.29E-05,2.84E-05,3,2
substantially,35,6.43E-05,35,7.97E-05,0,0,4
benefits,35,6.43E-05,17,3.87E-05,0.000170511,18,3
opposite,35,6.43E-05,33,7.52E-05,1.89E-05,2,3
unprecedented,35,6.43E-05,32,7.29E-05,2.84E-05,3,4
pick,34,6.24E-05,15,3.42E-05,0.000179984,19,1
guns,34,6.24E-05,25,5.70E-05,8.53E-05,9,1
loss,34,6.24E-05,30,6.83E-05,3.79E-05,4,1
host,34,6.24E-05,31,7.06E-05,2.84E-05,3,1
sean,34,6.24E-05,34,7.75E-05,0,0,1
sales,34,6.24E-05,10,2.28E-05,0.000227348,24,2
yours,34,6.24E-05,7,1.59E-05,0.000255767,27,1
front,34,6.24E-05,26,5.92E-05,7.58E-05,8,1
safer,34,6.24E-05,21,4.78E-05,0.000123147,13,2
alone,34,6.24E-05,25,5.70E-05,8.53E-05,9,2
joint,34,6.24E-05,32,7.29E-05,1.89E-05,2,1
areas,34,6.24E-05,31,7.06E-05,2.84E-05,3,2
super,34,6.24E-05,31,7.06E-05,2.84E-05,3,2
delay,34,6.24E-05,30,6.83E-05,3.79E-05,4,2
stuff,34,6.24E-05,32,7.29E-05,1.89E-05,2,1
cover,34,6.24E-05,27,6.15E-05,6.63E-05,7,2
giant,34,6.24E-05,32,7.29E-05,1.89E-05,2,1
carbon,34,6.24E-05,5,1.14E-05,0.000274712,29,2
choose,34,6.24E-05,12,2.73E-05,0.000208402,22,1
places,34,6.24E-05,33,7.52E-05,9.47E-06,1,1
jersey,34,6.24E-05,31,7.06E-05,2.84E-05,3,2
unless,34,6.24E-05,28,6.38E-05,5.68E-05,6,2
tougher,34,6.24E-05,31,7.06E-05,2.84E-05,3,2
journal,34,6.24E-05,34,7.75E-05,0,0,2
fairness,34,6.24E-05,22,5.01E-05,0.000113674,12,2
somebody,34,6.24E-05,29,6.61E-05,4.74E-05,5,4
missouri,34,6.24E-05,29,6.61E-05,4.74E-05,5,3
hearings,34,6.24E-05,34,7.75E-05,0,0,2
meantime,34,6.24E-05,34,7.75E-05,0,0,2
pollution,34,6.24E-05,2,4.56E-06,0.000303131,32,3
position,34,6.24E-05,32,7.29E-05,1.89E-05,2,3
discredited,34,6.24E-05,34,7.75E-05,0,0,3
ads,33,6.06E-05,31,7.06E-05,1.89E-05,2,1
dow,33,6.06E-05,33,7.52E-05,0,0,1
dumb,33,6.06E-05,32,7.29E-05,9.47E-06,1,1
firm,33,6.06E-05,14,3.19E-05,0.000179984,19,1
sooo,33,6.06E-05,33,7.52E-05,0,0,2
might,33,6.06E-05,14,3.19E-05,0.000179984,19,1
steps,33,6.06E-05,8,1.82E-05,0.000236821,25,1
folks,33,6.06E-05,6,1.37E-05,0.000255767,27,1
games,33,6.06E-05,23,5.24E-05,9.47E-05,10,1
global,33,6.06E-05,13,2.96E-05,0.000189457,20,2
extend,33,6.06E-05,6,1.37E-05,0.000255767,27,2
easier,33,6.06E-05,26,5.92E-05,6.63E-05,7,2
starts,33,6.06E-05,19,4.33E-05,0.00013262,14,1
ensure,33,6.06E-05,22,5.01E-05,0.000104201,11,2
caused,33,6.06E-05,30,6.83E-05,2.84E-05,3,1
wealth,33,6.06E-05,31,7.06E-05,1.89E-05,2,1
august,33,6.06E-05,29,6.61E-05,3.79E-05,4,2
honest,33,6.06E-05,31,7.06E-05,1.89E-05,2,2
excuse,33,6.06E-05,29,6.61E-05,3.79E-05,4,2
hatred,33,6.06E-05,33,7.52E-05,0,0,1
discuss,33,6.06E-05,28,6.38E-05,4.74E-05,5,2
parents,33,6.06E-05,10,2.28E-05,0.000217875,23,2
changes,33,6.06E-05,28,6.38E-05,4.74E-05,5,1
refused,33,6.06E-05,27,6.15E-05,5.68E-05,6,2
council,33,6.06E-05,30,6.83E-05,2.84E-05,3,2
patriot,33,6.06E-05,32,7.29E-05,9.47E-06,1,2
charges,33,6.06E-05,33,7.52E-05,0,0,1
official,33,6.06E-05,25,5.70E-05,7.58E-05,8,3
homeland,33,6.06E-05,29,6.61E-05,3.79E-05,4,3
premiums,33,6.06E-05,21,4.78E-05,0.000113674,12,2
colorado,33,6.06E-05,27,6.15E-05,5.68E-05,6,4
fracking,33,6.06E-05,33,7.52E-05,0,0,2
terrorism,33,6.06E-05,29,6.61E-05,3.79E-05,4,3
democracy,33,6.06E-05,22,5.01E-05,0.000104201,11,4
democratic,33,6.06E-05,27,6.15E-05,5.68E-05,6,4
nomination,33,6.06E-05,31,7.06E-05,1.89E-05,2,4
conflicted,33,6.06E-05,33,7.52E-05,0,0,2
hardworking,33,6.06E-05,31,7.06E-05,1.89E-05,2,3
attacks,33,6.06E-05,25,5.70E-05,7.58E-05,8,2
thanksgiving,33,6.06E-05,23,5.24E-05,9.47E-05,10,3
international,33,6.06E-05,27,6.15E-05,5.68E-05,6,5
none,32,5.88E-05,28,6.38E-05,3.79E-05,4,1
rose,32,5.88E-05,28,6.38E-05,3.79E-05,4,1
jail,32,5.88E-05,32,7.29E-05,0,0,1
study,32,5.88E-05,27,6.15E-05,4.74E-05,5,2
pride,32,5.88E-05,19,4.33E-05,0.000123147,13,1
henry,32,5.88E-05,31,7.06E-05,9.47E-06,1,2
steal,32,5.88E-05,32,7.29E-05,0,0,1
parts,32,5.88E-05,32,7.29E-05,0,0,1
wishes,32,5.88E-05,18,4.10E-05,0.00013262,14,1
talent,32,5.88E-05,27,6.15E-05,4.74E-05,5,2
unlike,32,5.88E-05,29,6.61E-05,2.84E-05,3,2
looked,32,5.88E-05,30,6.83E-05,1.89E-05,2,1
biased,32,5.88E-05,31,7.06E-05,9.47E-06,1,1
damage,32,5.88E-05,31,7.06E-05,9.47E-06,1,2
hunter,32,5.88E-05,32,7.29E-05,0,0,2
aliens,32,5.88E-05,32,7.29E-05,0,0,2
tariff,32,5.88E-05,32,7.29E-05,0,0,2
agents,32,5.88E-05,32,7.29E-05,0,0,2
percent,32,5.88E-05,14,3.19E-05,0.000170511,18,2
account,32,5.88E-05,25,5.70E-05,6.63E-05,7,2
reading,32,5.88E-05,28,6.38E-05,3.79E-05,4,2
rebuild,32,5.88E-05,25,5.70E-05,6.63E-05,7,2
trouble,32,5.88E-05,31,7.06E-05,9.47E-06,1,2
seniors,32,5.88E-05,15,3.42E-05,0.000161038,17,2
careful,32,5.88E-05,32,7.29E-05,0,0,3
becoming,32,5.88E-05,29,6.61E-05,2.84E-05,3,3
prepared,32,5.88E-05,26,5.92E-05,5.68E-05,6,2
changing,32,5.88E-05,22,5.01E-05,9.47E-05,10,2
previous,32,5.88E-05,30,6.83E-05,1.89E-05,2,3
available,32,5.88E-05,25,5.70E-05,6.63E-05,7,4
privilege,32,5.88E-05,21,4.78E-05,0.000104201,11,3
increased,32,5.88E-05,19,4.33E-05,0.000123147,13,2
venezuela,32,5.88E-05,32,7.29E-05,0,0,4
generation,32,5.88E-05,5,1.14E-05,0.000255767,27,4
continuing,32,5.88E-05,29,6.61E-05,2.84E-05,3,3
investigate,32,5.88E-05,32,7.29E-05,0,0,4
construction,32,5.88E-05,30,6.83E-05,1.89E-05,2,3
thrilled,32,5.88E-05,32,7.29E-05,0,0,1
brilliant,32,5.88E-05,30,6.83E-05,1.89E-05,2,2
bus,31,5.69E-05,26,5.92E-05,4.74E-05,5,1
san,31,5.69E-05,28,6.38E-05,2.84E-05,3,1
ran,31,5.69E-05,30,6.83E-05,9.47E-06,1,1
road,31,5.69E-05,7,1.59E-05,0.000227348,24,1
card,31,5.69E-05,7,1.59E-05,0.000227348,24,1
hour,31,5.69E-05,18,4.10E-05,0.000123147,13,1
bank,31,5.69E-05,22,5.01E-05,8.53E-05,9,1
eyes,31,5.69E-05,25,5.70E-05,5.68E-05,6,2
date,31,5.69E-05,27,6.15E-05,3.79E-05,4,1
cast,31,5.69E-05,23,5.24E-05,7.58E-05,8,1
maga,31,5.69E-05,31,7.06E-05,0,0,2
cause,31,5.69E-05,21,4.78E-05,9.47E-05,10,1
waste,31,5.69E-05,24,5.47E-05,6.63E-05,7,1
paris,31,5.69E-05,31,7.06E-05,0,0,2
kurds,31,5.69E-05,31,7.06E-05,0,0,1
issues,31,5.69E-05,13,2.96E-05,0.000170511,18,2
defeat,31,5.69E-05,29,6.61E-05,1.89E-05,2,2
antifa,31,5.69E-05,31,7.06E-05,0,0,3
improve,31,5.69E-05,18,4.10E-05,0.000123147,13,2
remains,31,5.69E-05,25,5.70E-05,5.68E-05,6,2
fortune,31,5.69E-05,29,6.61E-05,1.89E-05,2,2
earlier,31,5.69E-05,26,5.92E-05,4.74E-05,5,2
present,31,5.69E-05,30,6.83E-05,9.47E-06,1,2
montana,31,5.69E-05,31,7.06E-05,0,0,3
kingdom,31,5.69E-05,31,7.06E-05,0,0,2
grateful,31,5.69E-05,22,5.01E-05,8.53E-05,9,3
schedule,31,5.69E-05,29,6.61E-05,1.89E-05,2,3
handling,31,5.69E-05,31,7.06E-05,0,0,2
absentee,31,5.69E-05,31,7.06E-05,0,0,3
sacrifice,31,5.69E-05,18,4.10E-05,0.000123147,13,3
delivered,31,5.69E-05,24,5.47E-05,6.63E-05,7,3
delivering,31,5.69E-05,20,4.56E-05,0.000104201,11,4
appreciate,31,5.69E-05,30,6.83E-05,9.47E-06,1,3
individual,31,5.69E-05,28,6.38E-05,2.84E-05,3,4
father,31,5.69E-05,21,4.78E-05,9.47E-05,10,2
kill,31,5.69E-05,28,6.38E-05,2.84E-05,3,1
site,31,5.69E-05,27,6.15E-05,3.79E-05,4,1
faith,31,5.69E-05,25,5.70E-05,5.68E-05,6,1
benefit,31,5.69E-05,20,4.56E-05,0.000104201,11,3
opposition,31,5.69E-05,30,6.83E-05,9.47E-06,1,4
politically,31,5.69E-05,29,6.61E-05,1.89E-05,2,5
common,31,5.69E-05,16,3.64E-05,0.000142093,15,2
administrations,31,5.69E-05,29,6.61E-05,1.89E-05,2,5
guys,30,5.51E-05,20,4.56E-05,9.47E-05,10,1
rise,30,5.51E-05,18,4.10E-05,0.000113674,12,1
seat,30,5.51E-05,23,5.24E-05,6.63E-05,7,1
lots,30,5.51E-05,28,6.38E-05,1.89E-05,2,1
tired,30,5.51E-05,21,4.78E-05,8.53E-05,9,1
tuned,30,5.51E-05,28,6.38E-05,1.89E-05,2,1
stone,30,5.51E-05,28,6.38E-05,1.89E-05,2,1
banks,30,5.51E-05,22,5.01E-05,7.58E-05,8,1
plant,30,5.51E-05,28,6.38E-05,1.89E-05,2,1
saving,30,5.51E-05,18,4.10E-05,0.000113674,12,2
deaths,30,5.51E-05,28,6.38E-05,1.89E-05,2,1
sector,30,5.51E-05,9,2.05E-05,0.00019893,21,2
season,30,5.51E-05,20,4.56E-05,9.47E-05,10,2
sunday,30,5.51E-05,26,5.92E-05,3.79E-05,4,2
talked,30,5.51E-05,27,6.15E-05,2.84E-05,3,1
google,30,5.51E-05,26,5.92E-05,3.79E-05,4,2
showed,30,5.51E-05,28,6.38E-05,1.89E-05,2,1
terror,30,5.51E-05,30,6.83E-05,0,0,2
stupid,30,5.51E-05,30,6.83E-05,0,0,2
indeed,30,5.51E-05,30,6.83E-05,0,0,2
arabia,30,5.51E-05,30,6.83E-05,0,0,3
closing,30,5.51E-05,17,3.87E-05,0.000123147,13,2
succeed,30,5.51E-05,8,1.82E-05,0.000208402,22,2
booming,30,5.51E-05,29,6.61E-05,9.47E-06,1,2
poverty,30,5.51E-05,13,2.96E-05,0.000161038,17,3
joining,30,5.51E-05,23,5.24E-05,6.63E-05,7,2
debates,30,5.51E-05,29,6.61E-05,9.47E-06,1,2
reached,30,5.51E-05,26,5.92E-05,3.79E-05,4,1
serving,30,5.51E-05,24,5.47E-05,5.68E-05,6,2
endless,30,5.51E-05,29,6.61E-05,9.47E-06,1,2
proudly,30,5.51E-05,29,6.61E-05,9.47E-06,1,2
exposed,30,5.51E-05,30,6.83E-05,0,0,2
strange,30,5.51E-05,30,6.83E-05,0,0,1
finished,30,5.51E-05,23,5.24E-05,6.63E-05,7,2
vaccines,30,5.51E-05,29,6.61E-05,9.47E-06,1,2
oklahoma,30,5.51E-05,27,6.15E-05,2.84E-05,3,4
greatness,30,5.51E-05,27,6.15E-05,2.84E-05,3,2
obviously,30,5.51E-05,29,6.61E-05,9.47E-06,1,4
effective,30,5.51E-05,25,5.70E-05,4.74E-05,5,3
reporters,30,5.51E-05,29,6.61E-05,9.47E-06,1,3
baltimore,30,5.51E-05,30,6.83E-05,0,0,3
production,30,5.51E-05,20,4.56E-05,9.47E-05,10,3
christopher,30,5.51E-05,30,6.83E-05,0,0,3
funny,30,5.51E-05,29,6.61E-05,9.47E-06,1,2
flynn,30,5.51E-05,30,6.83E-05,0,0,1
planned,30,5.51E-05,22,5.01E-05,7.58E-05,8,1
brennan,30,5.51E-05,30,6.83E-05,0,0,2
strengthen,30,5.51E-05,14,3.19E-05,0.000151565,16,2
telling,30,5.51E-05,24,5.47E-05,5.68E-05,6,2
rallies,30,5.51E-05,28,6.38E-05,1.89E-05,2,2
vital,30,5.51E-05,18,4.10E-05,0.000113674,12,2
summer,30,5.51E-05,7,1.59E-05,0.000217875,23,2
quo,29,5.33E-05,26,5.92E-05,2.84E-05,3,1
per,29,5.33E-05,20,4.56E-05,8.53E-05,9,1
pays,29,5.33E-05,11,2.51E-05,0.000170511,18,1
tens,29,5.33E-05,27,6.15E-05,1.89E-05,2,1
test,29,5.33E-05,25,5.70E-05,3.79E-05,4,1
cops,29,5.33E-05,25,5.70E-05,3.79E-05,4,1
reps,29,5.33E-05,5,1.14E-05,0.000227348,24,1
sound,29,5.33E-05,28,6.38E-05,9.47E-06,1,1
worry,29,5.33E-05,23,5.24E-05,5.68E-05,6,2
fault,29,5.33E-05,27,6.15E-05,1.89E-05,2,1
india,29,5.33E-05,27,6.15E-05,1.89E-05,2,2
fools,29,5.33E-05,29,6.61E-05,0,0,1
levin,29,5.33E-05,29,6.61E-05,0,0,2
alaska,29,5.33E-05,22,5.01E-05,6.63E-05,7,3
worlds,29,5.33E-05,19,4.33E-05,9.47E-05,10,1
events,29,5.33E-05,24,5.47E-05,4.74E-05,5,2
plants,29,5.33E-05,22,5.01E-05,6.63E-05,7,1
career,29,5.33E-05,27,6.15E-05,1.89E-05,2,2
plenty,29,5.33E-05,28,6.38E-05,9.47E-06,1,2
inform,29,5.33E-05,29,6.61E-05,0,0,2
bolton,29,5.33E-05,29,6.61E-05,0,0,2
server,29,5.33E-05,29,6.61E-05,0,0,2
opposed,29,5.33E-05,25,5.70E-05,3.79E-05,4,2
typical,29,5.33E-05,7,1.59E-05,0.000208402,22,3
indiana,29,5.33E-05,27,6.15E-05,1.89E-05,2,3
however,29,5.33E-05,27,6.15E-05,1.89E-05,2,3
various,29,5.33E-05,29,6.61E-05,0,0,3
deleted,29,5.33E-05,29,6.61E-05,0,0,2
overtime,29,5.33E-05,25,5.70E-05,3.79E-05,4,3
supposed,29,5.33E-05,26,5.92E-05,2.84E-05,3,2
personal,29,5.33E-05,21,4.78E-05,7.58E-05,8,3
facebook,29,5.33E-05,23,5.24E-05,5.68E-05,6,3
influence,29,5.33E-05,22,5.01E-05,6.63E-05,7,2
listening,29,5.33E-05,25,5.70E-05,3.79E-05,4,3
productive,29,5.33E-05,28,6.38E-05,9.47E-06,1,3
registered,29,5.33E-05,10,2.28E-05,0.000179984,19,3
announcing,29,5.33E-05,19,4.33E-05,9.47E-05,10,3
bills,29,5.33E-05,20,4.56E-05,8.53E-05,9,1
philadelphia,29,5.33E-05,28,6.38E-05,9.47E-06,1,4
detroit,29,5.33E-05,15,3.42E-05,0.00013262,14,2
ok,28,5.14E-05,28,6.38E-05,0,0,1
age,28,5.14E-05,17,3.87E-05,0.000104201,11,1
flu,28,5.14E-05,26,5.92E-05,1.89E-05,2,1
fool,28,5.14E-05,26,5.92E-05,1.89E-05,2,1
asap,28,5.14E-05,28,6.38E-05,0,0,2
light,28,5.14E-05,22,5.01E-05,5.68E-05,6,1
treat,28,5.14E-05,23,5.24E-05,4.74E-05,5,1
begun,28,5.14E-05,24,5.47E-05,3.79E-05,4,2
space,28,5.14E-05,25,5.70E-05,2.84E-05,3,1
shown,28,5.14E-05,27,6.15E-05,9.47E-06,1,1
lover,28,5.14E-05,28,6.38E-05,0,0,2
agent,28,5.14E-05,28,6.38E-05,0,0,2
decide,28,5.14E-05,11,2.51E-05,0.000161038,17,2
modern,28,5.14E-05,25,5.70E-05,2.84E-05,3,2
boring,28,5.14E-05,28,6.38E-05,0,0,2
october,28,5.14E-05,23,5.24E-05,4.74E-05,5,3
assault,28,5.14E-05,17,3.87E-05,0.000104201,11,2
hurting,28,5.14E-05,24,5.47E-05,3.79E-05,4,2
dealing,28,5.14E-05,27,6.15E-05,9.47E-06,1,2
landing,28,5.14E-05,26,5.92E-05,1.89E-05,2,2
treason,28,5.14E-05,28,6.38E-05,0,0,2
register,28,5.14E-05,13,2.96E-05,0.000142093,15,3
currency,28,5.14E-05,28,6.38E-05,0,0,3
negotiate,28,5.14E-05,26,5.92E-05,1.89E-05,2,3
anonymous,28,5.14E-05,28,6.38E-05,0,0,4
purposely,28,5.14E-05,28,6.38E-05,0,0,4
investment,28,5.14E-05,19,4.33E-05,8.53E-05,9,3
foundation,28,5.14E-05,25,5.70E-05,2.84E-05,3,3
massachusetts,28,5.14E-05,9,2.05E-05,0.000179984,19,4
petition,28,5.14E-05,1,2.28E-06,0.000255767,27,3
hospital,28,5.14E-05,24,5.47E-05,3.79E-05,4,3
citizenship,28,5.14E-05,14,3.19E-05,0.00013262,14,4
admitted,28,5.14E-05,27,6.15E-05,9.47E-06,1,2
humanitarian,28,5.14E-05,28,6.38E-05,0,0,5
key,27,4.96E-05,12,2.73E-05,0.000142093,15,1
fun,27,4.96E-05,19,4.33E-05,7.58E-05,8,1
push,27,4.96E-05,21,4.78E-05,5.68E-05,6,1
food,27,4.96E-05,25,5.70E-05,1.89E-05,2,1
duty,27,4.96E-05,25,5.70E-05,1.89E-05,2,2
camp,27,4.96E-05,25,5.70E-05,1.89E-05,2,1
mail,27,4.96E-05,24,5.47E-05,2.84E-05,3,1
army,27,4.96E-05,26,5.92E-05,9.47E-06,1,2
greg,27,4.96E-05,26,5.92E-05,9.47E-06,1,1
rush,27,4.96E-05,27,6.15E-05,0,0,1
proof,27,4.96E-05,25,5.70E-05,1.89E-05,2,1
storm,27,4.96E-05,22,5.01E-05,4.74E-05,5,1
medal,27,4.96E-05,24,5.47E-05,2.84E-05,3,2
goods,27,4.96E-05,26,5.92E-05,9.47E-06,1,1
crash,27,4.96E-05,26,5.92E-05,9.47E-06,1,1
levels,27,4.96E-05,23,5.24E-05,3.79E-05,4,2
secret,27,4.96E-05,23,5.24E-05,3.79E-05,4,2
forces,27,4.96E-05,20,4.56E-05,6.63E-05,7,1
firing,27,4.96E-05,24,5.47E-05,2.84E-05,3,2
losers,27,4.96E-05,27,6.15E-05,0,0,2
finest,27,4.96E-05,27,6.15E-05,0,0,2
spying,27,4.96E-05,27,6.15E-05,0,0,1
racist,27,4.96E-05,27,6.15E-05,0,0,2
decided,27,4.96E-05,25,5.70E-05,1.89E-05,2,2
project,27,4.96E-05,24,5.47E-05,2.84E-05,3,2
reviews,27,4.96E-05,25,5.70E-05,1.89E-05,2,2
opinion,27,4.96E-05,27,6.15E-05,0,0,3
violent,27,4.96E-05,27,6.15E-05,0,0,2
airport,27,4.96E-05,27,6.15E-05,0,0,2
nervous,27,4.96E-05,27,6.15E-05,0,0,2
solution,27,4.96E-05,17,3.87E-05,9.47E-05,10,3
thursday,27,4.96E-05,25,5.70E-05,1.89E-05,2,2
appointed,27,4.96E-05,25,5.70E-05,1.89E-05,2,2
pocahontas,27,4.96E-05,27,6.15E-05,0,0,4
suppression,27,4.96E-05,26,5.92E-05,9.47E-06,1,3
brett,27,4.96E-05,27,6.15E-05,0,0,1
excellent,27,4.96E-05,23,5.24E-05,3.79E-05,4,3
sit,27,4.96E-05,18,4.10E-05,8.53E-05,9,1
representative,27,4.96E-05,20,4.56E-05,6.63E-05,7,5
ron,26,4.77E-05,26,5.92E-05,0,0,1
task,26,4.77E-05,21,4.78E-05,4.74E-05,5,1
mind,26,4.77E-05,18,4.10E-05,7.58E-05,8,1
barr,26,4.77E-05,26,5.92E-05,0,0,1
troy,26,4.77E-05,26,5.92E-05,0,0,1
bias,26,4.77E-05,26,5.92E-05,0,0,1
quid,26,4.77E-05,26,5.92E-05,0,0,1
wages,26,4.77E-05,14,3.19E-05,0.000113674,12,1
guess,26,4.77E-05,20,4.56E-05,5.68E-05,6,1
train,26,4.77E-05,17,3.87E-05,8.53E-05,9,1
apart,26,4.77E-05,20,4.56E-05,5.68E-05,6,2
civil,26,4.77E-05,20,4.56E-05,5.68E-05,6,2
trust,26,4.77E-05,15,3.42E-05,0.000104201,11,1
rated,26,4.77E-05,24,5.47E-05,1.89E-05,2,1
birth,26,4.77E-05,8,1.82E-05,0.000170511,18,1
shape,26,4.77E-05,23,5.24E-05,2.84E-05,3,1
bruce,26,4.77E-05,24,5.47E-05,1.89E-05,2,1
stage,26,4.77E-05,19,4.33E-05,6.63E-05,7,1
nasty,26,4.77E-05,26,5.92E-05,0,0,2
fixed,26,4.77E-05,26,5.92E-05,0,0,1
loyal,26,4.77E-05,26,5.92E-05,0,0,2
hearts,26,4.77E-05,23,5.24E-05,2.84E-05,3,1
figure,26,4.77E-05,23,5.24E-05,2.84E-05,3,2
quarter,26,4.77E-05,14,3.19E-05,0.000113674,12,2
answers,26,4.77E-05,23,5.24E-05,2.84E-05,3,2
rebuilt,26,4.77E-05,25,5.70E-05,9.47E-06,1,2
heavily,26,4.77E-05,26,5.92E-05,0,0,3
iranian,26,4.77E-05,26,5.92E-05,0,0,3
clapper,26,4.77E-05,26,5.92E-05,0,0,2
affected,26,4.77E-05,20,4.56E-05,5.68E-05,6,2
reducing,26,4.77E-05,16,3.64E-05,9.47E-05,10,3
congrats,26,4.77E-05,19,4.33E-05,6.63E-05,7,2
advocate,26,4.77E-05,24,5.47E-05,1.89E-05,2,3
obstruct,26,4.77E-05,26,5.92E-05,0,0,2
direction,26,4.77E-05,17,3.87E-05,8.53E-05,9,3
represent,26,4.77E-05,25,5.70E-05,9.47E-06,1,3
considered,26,4.77E-05,25,5.70E-05,9.47E-06,1,3
businessman,26,4.77E-05,25,5.70E-05,9.47E-06,1,4
anticipated,26,4.77E-05,26,5.92E-05,0,0,4
considering,26,4.77E-05,26,5.92E-05,0,0,4
represented,26,4.77E-05,26,5.92E-05,0,0,3
brother,26,4.77E-05,25,5.70E-05,9.47E-06,1,2
fallen,26,4.77E-05,16,3.64E-05,9.47E-05,10,2
organization,26,4.77E-05,21,4.78E-05,4.74E-05,5,5
representing,26,4.77E-05,25,5.70E-05,9.47E-06,1,4
quality,26,4.77E-05,9,2.05E-05,0.000161038,17,3
critical,26,4.77E-05,18,4.10E-05,7.58E-05,8,3
manufacturers,26,4.77E-05,24,5.47E-05,1.89E-05,2,5
die,25,4.59E-05,21,4.78E-05,3.79E-05,4,1
ten,25,4.59E-05,20,4.56E-05,4.74E-05,5,1
cia,25,4.59E-05,25,5.70E-05,0,0,1
ohr,25,4.59E-05,25,5.70E-05,0,0,1
ends,25,4.59E-05,18,4.10E-05,6.63E-05,7,1
hire,25,4.59E-05,11,2.51E-05,0.00013262,14,1
wave,25,4.59E-05,24,5.47E-05,9.47E-06,1,1
shes,25,4.59E-05,18,4.10E-05,6.63E-05,7,#ERROR!
ship,25,4.59E-05,19,4.33E-05,5.68E-05,6,1
drop,25,4.59E-05,22,5.01E-05,2.84E-05,3,1
basic,25,4.59E-05,4,9.11E-06,0.00019893,21,2
claim,25,4.59E-05,18,4.10E-05,6.63E-05,7,1
hates,25,4.59E-05,25,5.70E-05,0,0,1
moore,25,4.59E-05,25,5.70E-05,0,0,1
accept,25,4.59E-05,16,3.64E-05,8.53E-05,9,2
launch,25,4.59E-05,19,4.33E-05,5.68E-05,6,1
defund,25,4.59E-05,21,4.78E-05,3.79E-05,4,2
chinas,25,4.59E-05,24,5.47E-05,9.47E-06,1,2
reagan,25,4.59E-05,20,4.56E-05,4.74E-05,5,2
pushed,25,4.59E-05,25,5.70E-05,0,0,1
example,25,4.59E-05,17,3.87E-05,7.58E-05,8,3
holiday,25,4.59E-05,12,2.73E-05,0.000123147,13,3
extreme,25,4.59E-05,18,4.10E-05,6.63E-05,7,2
include,25,4.59E-05,24,5.47E-05,9.47E-06,1,2
learned,25,4.59E-05,22,5.01E-05,2.84E-05,3,1
looters,25,4.59E-05,25,5.70E-05,0,0,2
removed,25,4.59E-05,25,5.70E-05,0,0,2
picture,25,4.59E-05,25,5.70E-05,0,0,2
paycheck,25,4.59E-05,10,2.28E-05,0.000142093,15,2
lifetime,25,4.59E-05,14,3.19E-05,0.000104201,11,3
stimulus,25,4.59E-05,24,5.47E-05,9.47E-06,1,3
unfairly,25,4.59E-05,25,5.70E-05,0,0,3
encourage,25,4.59E-05,19,4.33E-05,5.68E-05,6,3
confirmed,25,4.59E-05,21,4.78E-05,3.79E-05,4,2
obligation,25,4.59E-05,11,2.51E-05,0.00013262,14,4
terminated,25,4.59E-05,25,5.70E-05,0,0,3
constantly,25,4.59E-05,25,5.70E-05,0,0,3
generations,25,4.59E-05,7,1.59E-05,0.000170511,18,4
appropriate,25,4.59E-05,25,5.70E-05,0,0,3
otherwise,25,4.59E-05,21,4.78E-05,3.79E-05,4,3
virtually,25,4.59E-05,25,5.70E-05,0,0,3
independence,25,4.59E-05,20,4.56E-05,4.74E-05,5,4
bit,25,4.59E-05,16,3.64E-05,8.53E-05,9,1
addition,25,4.59E-05,25,5.70E-05,0,0,3
agitators,25,4.59E-05,25,5.70E-05,0,0,4
pittsburgh,25,4.59E-05,23,5.24E-05,1.89E-05,2,2
responsibility,25,4.59E-05,6,1.37E-05,0.000179984,19,6
investigating,25,4.59E-05,23,5.24E-05,1.89E-05,2,5
ken,24,4.41E-05,23,5.24E-05,9.47E-06,1,1
risk,24,4.41E-05,23,5.24E-05,9.47E-06,1,1
andy,24,4.41E-05,23,5.24E-05,9.47E-06,1,2
eric,24,4.41E-05,24,5.47E-05,0,0,2
labor,24,4.41E-05,19,4.33E-05,4.74E-05,5,2
match,24,4.41E-05,22,5.01E-05,1.89E-05,2,1
cares,24,4.41E-05,23,5.24E-05,9.47E-06,1,1
dying,24,4.41E-05,23,5.24E-05,9.47E-06,1,1
jason,24,4.41E-05,24,5.47E-05,0,0,2
arena,24,4.41E-05,24,5.47E-05,0,0,3
denied,24,4.41E-05,7,1.59E-05,0.000161038,17,2
thinks,24,4.41E-05,13,2.96E-05,0.000104201,11,1
dreams,24,4.41E-05,15,3.42E-05,8.53E-05,9,1
combat,24,4.41E-05,16,3.64E-05,7.58E-05,8,2
stolen,24,4.41E-05,23,5.24E-05,9.47E-06,1,2
closer,24,4.41E-05,16,3.64E-05,7.58E-05,8,2
bumper,24,4.41E-05,0,0,0.000227348,24,2
dakota,24,4.41E-05,23,5.24E-05,9.47E-06,1,3
safely,24,4.41E-05,24,5.47E-05,0,0,3
leaked,24,4.41E-05,24,5.47E-05,0,0,1
teacher,24,4.41E-05,4,9.11E-06,0.000189457,20,2
science,24,4.41E-05,2,4.56E-06,0.000208402,22,1
uniform,24,4.41E-05,10,2.28E-05,0.00013262,14,3
liberty,24,4.41E-05,20,4.56E-05,3.79E-05,4,3
knowing,24,4.41E-05,18,4.10E-05,5.68E-05,6,2
lincoln,24,4.41E-05,20,4.56E-05,3.79E-05,4,2
focused,24,4.41E-05,22,5.01E-05,1.89E-05,2,2
nominee,24,4.41E-05,19,4.33E-05,4.74E-05,5,3
sticker,24,4.41E-05,0,0,0.000227348,24,2
abolish,24,4.41E-05,24,5.47E-05,0,0,3
endorse,24,4.41E-05,24,5.47E-05,0,0,2
network,24,4.41E-05,24,5.47E-05,0,0,2
fiction,24,4.41E-05,24,5.47E-05,0,0,2
inspired,24,4.41E-05,13,2.96E-05,0.000104201,11,2
internet,24,4.41E-05,13,2.96E-05,0.000104201,11,3
hispanic,24,4.41E-05,21,4.78E-05,2.84E-05,3,3
protects,24,4.41E-05,17,3.87E-05,6.63E-05,7,2
agencies,24,4.41E-05,21,4.78E-05,2.84E-05,3,3
absolute,24,4.41E-05,23,5.24E-05,9.47E-06,1,3
briefing,24,4.41E-05,23,5.24E-05,9.47E-06,1,2
watchers,24,4.41E-05,24,5.47E-05,0,0,2
investing,24,4.41E-05,10,2.28E-05,0.00013262,14,3
signature,24,4.41E-05,23,5.24E-05,9.47E-06,1,3
sometimes,24,4.41E-05,21,4.78E-05,2.84E-05,3,3
knowledge,24,4.41E-05,21,4.78E-05,2.84E-05,3,2
disgraced,24,4.41E-05,24,5.47E-05,0,0,2
narrative,24,4.41E-05,24,5.47E-05,0,0,3
employment,24,4.41E-05,19,4.33E-05,4.74E-05,5,3
terrorists,24,4.41E-05,24,5.47E-05,0,0,3
destruction,24,4.41E-05,24,5.47E-05,0,0,3
trafficking,24,4.41E-05,24,5.47E-05,0,0,3
wallace,24,4.41E-05,24,5.47E-05,0,0,2
challenge,24,4.41E-05,10,2.28E-05,0.00013262,14,2
following,24,4.41E-05,23,5.24E-05,9.47E-06,1,3
transit,24,4.41E-05,24,5.47E-05,0,0,2
heritage,24,4.41E-05,19,4.33E-05,4.74E-05,5,3
firefighters,24,4.41E-05,14,3.19E-05,9.47E-05,10,4
competition,24,4.41E-05,22,5.01E-05,1.89E-05,2,4
era,23,4.22E-05,18,4.10E-05,4.74E-05,5,1
ceo,23,4.22E-05,21,4.78E-05,1.89E-05,2,1
ted,23,4.22E-05,21,4.78E-05,1.89E-05,2,1
tim,23,4.22E-05,23,5.24E-05,0,0,1
town,23,4.22E-05,16,3.64E-05,6.63E-05,7,1
vast,23,4.22E-05,19,4.33E-05,3.79E-05,4,1
acts,23,4.22E-05,19,4.33E-05,3.79E-05,4,1
puts,23,4.22E-05,18,4.10E-05,4.74E-05,5,1
ford,23,4.22E-05,21,4.78E-05,1.89E-05,2,1
whos,23,4.22E-05,8,1.82E-05,0.000142093,15,1
fail,23,4.22E-05,21,4.78E-05,1.89E-05,2,1
doug,23,4.22E-05,23,5.24E-05,0,0,1
mine,23,4.22E-05,23,5.24E-05,0,0,1
speed,23,4.22E-05,20,4.56E-05,2.84E-05,3,1
lines,23,4.22E-05,21,4.78E-05,1.89E-05,2,1
piece,23,4.22E-05,13,2.96E-05,9.47E-05,10,1
shame,23,4.22E-05,19,4.33E-05,3.79E-05,4,1
swine,23,4.22E-05,23,5.24E-05,0,0,1
maine,23,4.22E-05,23,5.24E-05,0,0,1
thugs,23,4.22E-05,23,5.24E-05,0,0,1
effect,23,4.22E-05,17,3.87E-05,5.68E-05,6,2
advice,23,4.22E-05,19,4.33E-05,3.79E-05,4,2
legacy,23,4.22E-05,13,2.96E-05,9.47E-05,10,3
barely,23,4.22E-05,19,4.33E-05,3.79E-05,4,3
werent,23,4.22E-05,21,4.78E-05,1.89E-05,2,2
thrown,23,4.22E-05,22,5.01E-05,9.47E-06,1,1
kansas,23,4.22E-05,22,5.01E-05,9.47E-06,1,2
author,23,4.22E-05,23,5.24E-05,0,0,2
pastor,23,4.22E-05,23,5.24E-05,0,0,2
london,23,4.22E-05,23,5.24E-05,0,0,2
steele,23,4.22E-05,23,5.24E-05,0,0,2
experts,23,4.22E-05,19,4.33E-05,3.79E-05,4,2
failure,23,4.22E-05,18,4.10E-05,4.74E-05,5,2
wounded,23,4.22E-05,23,5.24E-05,0,0,1
recorded,23,4.22E-05,20,4.56E-05,2.84E-05,3,2
research,23,4.22E-05,19,4.33E-05,3.79E-05,4,2
marriage,23,4.22E-05,1,2.28E-06,0.000208402,22,2
overseas,23,4.22E-05,11,2.51E-05,0.000113674,12,3
peaceful,23,4.22E-05,22,5.01E-05,9.47E-06,1,3
includes,23,4.22E-05,18,4.10E-05,4.74E-05,5,2
patients,23,4.22E-05,21,4.78E-05,1.89E-05,2,2
reporter,23,4.22E-05,23,5.24E-05,0,0,3
meddling,23,4.22E-05,23,5.24E-05,0,0,2
optimism,23,4.22E-05,23,5.24E-05,0,0,3
uninsured,23,4.22E-05,1,2.28E-06,0.000208402,22,3
employees,23,4.22E-05,19,4.33E-05,3.79E-05,4,3
daughters,23,4.22E-05,1,2.28E-06,0.000208402,22,2
rasmussen,23,4.22E-05,23,5.24E-05,0,0,3
concerned,23,4.22E-05,23,5.24E-05,0,0,2
discussing,23,4.22E-05,21,4.78E-05,1.89E-05,2,3
bottom,23,4.22E-05,9,2.05E-05,0.00013262,14,2
mattis,23,4.22E-05,23,5.24E-05,0,0,2
development,23,4.22E-05,21,4.78E-05,1.89E-05,2,4
allies,23,4.22E-05,18,4.10E-05,4.74E-05,5,2
witness,23,4.22E-05,23,5.24E-05,0,0,2
sitting,23,4.22E-05,18,4.10E-05,4.74E-05,5,2
commit,23,4.22E-05,10,2.28E-05,0.000123147,13,2
verification,23,4.22E-05,23,5.24E-05,0,0,5
agricultural,23,4.22E-05,23,5.24E-05,0,0,5
tune,22,4.04E-05,5,1.14E-05,0.000161038,17,1
mass,22,4.04E-05,20,4.56E-05,1.89E-05,2,1
goal,22,4.04E-05,7,1.59E-05,0.000142093,15,1
pete,22,4.04E-05,20,4.56E-05,1.89E-05,2,1
tour,22,4.04E-05,16,3.64E-05,5.68E-05,6,1
hike,22,4.04E-05,11,2.51E-05,0.000104201,11,1
tool,22,4.04E-05,16,3.64E-05,5.68E-05,6,1
info,22,4.04E-05,21,4.78E-05,9.47E-06,1,2
rino,22,4.04E-05,22,5.01E-05,0,0,2
brad,22,4.04E-05,22,5.01E-05,0,0,1
utah,22,4.04E-05,22,5.01E-05,0,0,2
upon,22,4.04E-05,22,5.01E-05,0,0,2
merry,22,4.04E-05,11,2.51E-05,0.000104201,11,2
keeps,22,4.04E-05,19,4.33E-05,2.84E-05,3,1
helps,22,4.04E-05,8,1.82E-05,0.00013262,14,1
anger,22,4.04E-05,21,4.78E-05,9.47E-06,1,2
catch,22,4.04E-05,18,4.10E-05,3.79E-05,4,1
lucky,22,4.04E-05,17,3.87E-05,4.74E-05,5,2
homes,22,4.04E-05,16,3.64E-05,5.68E-05,6,1
paper,22,4.04E-05,18,4.10E-05,3.79E-05,4,2
books,22,4.04E-05,20,4.56E-05,1.89E-05,2,1
chaos,22,4.04E-05,22,5.01E-05,0,0,1
chain,22,4.04E-05,22,5.01E-05,0,0,1
cohen,22,4.04E-05,22,5.01E-05,0,0,2
photos,22,4.04E-05,3,6.83E-06,0.000179984,19,2
pledge,22,4.04E-05,17,3.87E-05,4.74E-05,5,1
joined,22,4.04E-05,17,3.87E-05,4.74E-05,5,1
inside,22,4.04E-05,19,4.33E-05,2.84E-05,3,2
memory,22,4.04E-05,17,3.87E-05,4.74E-05,5,3
prayer,22,4.04E-05,20,4.56E-05,1.89E-05,2,2
nights,22,4.04E-05,11,2.51E-05,0.000104201,11,1
motors,22,4.04E-05,18,4.10E-05,3.79E-05,4,2
afraid,22,4.04E-05,20,4.56E-05,1.89E-05,2,2
orders,22,4.04E-05,21,4.78E-05,9.47E-06,1,2
silent,22,4.04E-05,22,5.01E-05,0,0,2
graham,22,4.04E-05,22,5.01E-05,0,0,2
stocks,22,4.04E-05,22,5.01E-05,0,0,1
tragedy,22,4.04E-05,14,3.19E-05,7.58E-05,8,3
realize,22,4.04E-05,21,4.78E-05,9.47E-06,1,2
charged,22,4.04E-05,20,4.56E-05,1.89E-05,2,1
johnson,22,4.04E-05,20,4.56E-05,1.89E-05,2,2
edwards,22,4.04E-05,21,4.78E-05,9.47E-06,1,2
protest,22,4.04E-05,22,5.01E-05,0,0,2
daughter,22,4.04E-05,16,3.64E-05,5.68E-05,6,2
partners,22,4.04E-05,20,4.56E-05,1.89E-05,2,2
comeback,22,4.04E-05,18,4.10E-05,3.79E-05,4,3
fighters,22,4.04E-05,22,5.01E-05,0,0,2
republic,22,4.04E-05,22,5.01E-05,0,0,3
caravans,22,4.04E-05,22,5.01E-05,0,0,3
universal,22,4.04E-05,6,1.37E-05,0.000151565,16,4
economics,22,4.04E-05,4,9.11E-06,0.000170511,18,4
increases,22,4.04E-05,22,5.01E-05,0,0,2
primaries,22,4.04E-05,22,5.01E-05,0,0,3
completed,22,4.04E-05,22,5.01E-05,0,0,2
impeached,22,4.04E-05,22,5.01E-05,0,0,2
grassroots,22,4.04E-05,1,2.28E-06,0.00019893,21,2
importance,22,4.04E-05,13,2.96E-05,8.53E-05,9,3
courageous,22,4.04E-05,21,4.78E-05,9.47E-06,1,4
winners,22,4.04E-05,18,4.10E-05,3.79E-05,4,2
devastating,22,4.04E-05,20,4.56E-05,1.89E-05,2,4
performance,22,4.04E-05,17,3.87E-05,4.74E-05,5,3
planning,22,4.04E-05,20,4.56E-05,1.89E-05,2,2
sell,22,4.04E-05,20,4.56E-05,1.89E-05,2,1
illinois,22,4.04E-05,19,4.33E-05,2.84E-05,3,3
officially,22,4.04E-05,18,4.10E-05,3.79E-05,4,4
pitch,22,4.04E-05,3,6.83E-06,0.000179984,19,1
hospitals,22,4.04E-05,22,5.01E-05,0,0,3
unconstitutional,22,4.04E-05,22,5.01E-05,0,0,6
establishment,22,4.04E-05,22,5.01E-05,0,0,4
unfortunately,22,4.04E-05,22,5.01E-05,0,0,6
investigations,22,4.04E-05,22,5.01E-05,0,0,5
fan,21,3.86E-05,19,4.33E-05,1.89E-05,2,1
hed,21,3.86E-05,3,6.83E-06,0.000170511,18,1
gift,21,3.86E-05,18,4.10E-05,2.84E-05,3,1
deny,21,3.86E-05,5,1.14E-05,0.000151565,16,2
pace,21,3.86E-05,16,3.64E-05,4.74E-05,5,1
loud,21,3.86E-05,17,3.87E-05,3.79E-05,4,1
sold,21,3.86E-05,17,3.87E-05,3.79E-05,4,1
code,21,3.86E-05,9,2.05E-05,0.000113674,12,1
gain,21,3.86E-05,18,4.10E-05,2.84E-05,3,1
base,21,3.86E-05,20,4.56E-05,9.47E-06,1,1
tape,21,3.86E-05,20,4.56E-05,9.47E-06,1,1
coup,21,3.86E-05,21,4.78E-05,0,0,1
omar,21,3.86E-05,21,4.78E-05,0,0,2
seem,21,3.86E-05,21,4.78E-05,0,0,1
moon,21,3.86E-05,21,4.78E-05,0,0,1
paso,21,3.86E-05,21,4.78E-05,0,0,2
seven,21,3.86E-05,17,3.87E-05,3.79E-05,4,2
track,21,3.86E-05,15,3.42E-05,5.68E-05,6,1
offer,21,3.86E-05,12,2.73E-05,8.53E-05,9,2
teams,21,3.86E-05,19,4.33E-05,1.89E-05,2,1
drive,21,3.86E-05,15,3.42E-05,5.68E-05,6,1
brown,21,3.86E-05,19,4.33E-05,1.89E-05,2,1
table,21,3.86E-05,12,2.73E-05,8.53E-05,9,2
armed,21,3.86E-05,17,3.87E-05,3.79E-05,4,1
quick,21,3.86E-05,12,2.73E-05,8.53E-05,9,1
tests,21,3.86E-05,20,4.56E-05,9.47E-06,1,1
prove,21,3.86E-05,17,3.87E-05,3.79E-05,4,1
basis,21,3.86E-05,21,4.78E-05,0,0,2
probe,21,3.86E-05,21,4.78E-05,0,0,1
invest,21,3.86E-05,6,1.37E-05,0.000142093,15,2
fourth,21,3.86E-05,11,2.51E-05,9.47E-05,10,1
review,21,3.86E-05,16,3.64E-05,4.74E-05,5,2
fixing,21,3.86E-05,15,3.42E-05,5.68E-05,6,2
island,21,3.86E-05,19,4.33E-05,1.89E-05,2,2
marine,21,3.86E-05,18,4.10E-05,2.84E-05,3,2
groups,21,3.86E-05,17,3.87E-05,3.79E-05,4,1
amount,21,3.86E-05,17,3.87E-05,3.79E-05,4,2
vision,21,3.86E-05,10,2.28E-05,0.000104201,11,2
costly,21,3.86E-05,20,4.56E-05,9.47E-06,1,2
sacred,21,3.86E-05,18,4.10E-05,2.84E-05,3,1
packed,21,3.86E-05,20,4.56E-05,9.47E-06,1,1
opened,21,3.86E-05,20,4.56E-05,9.47E-06,1,2
ronald,21,3.86E-05,20,4.56E-05,9.47E-06,1,2
nasdaq,21,3.86E-05,21,4.78E-05,0,0,2
psycho,21,3.86E-05,21,4.78E-05,0,0,2
crazed,21,3.86E-05,21,4.78E-05,0,0,1
asylum,21,3.86E-05,21,4.78E-05,0,0,3
deniers,21,3.86E-05,1,2.28E-06,0.000189457,20,2
wealthy,21,3.86E-05,5,1.14E-05,0.000151565,16,2
mission,21,3.86E-05,12,2.73E-05,8.53E-05,9,2
staying,21,3.86E-05,15,3.42E-05,5.68E-05,6,2
streets,21,3.86E-05,19,4.33E-05,1.89E-05,2,1
secured,21,3.86E-05,19,4.33E-05,1.89E-05,2,2
version,21,3.86E-05,19,4.33E-05,1.89E-05,2,2
embassy,21,3.86E-05,20,4.56E-05,9.47E-06,1,3
jackson,21,3.86E-05,21,4.78E-05,0,0,2
schiffs,21,3.86E-05,21,4.78E-05,0,0,1
lowering,21,3.86E-05,18,4.10E-05,2.84E-05,3,3
doubling,21,3.86E-05,5,1.14E-05,0.000151565,16,2
sentence,21,3.86E-05,20,4.56E-05,9.47E-06,1,2
possibly,21,3.86E-05,20,4.56E-05,9.47E-06,1,3
nebraska,21,3.86E-05,21,4.78E-05,0,0,3
compared,21,3.86E-05,21,4.78E-05,0,0,2
recognize,21,3.86E-05,17,3.87E-05,3.79E-05,4,3
neighbors,21,3.86E-05,14,3.19E-05,6.63E-05,7,2
supported,21,3.86E-05,12,2.73E-05,8.53E-05,9,2
standards,21,3.86E-05,9,2.05E-05,0.000113674,12,2
interests,21,3.86E-05,14,3.19E-05,6.63E-05,7,3
extremely,21,3.86E-05,20,4.56E-05,9.47E-06,1,4
religious,21,3.86E-05,18,4.10E-05,2.84E-05,3,4
landslide,21,3.86E-05,21,4.78E-05,0,0,2
desperate,21,3.86E-05,21,4.78E-05,0,0,3
equipment,21,3.86E-05,21,4.78E-05,0,0,3
remaining,21,3.86E-05,21,4.78E-05,0,0,3
argentina,21,3.86E-05,21,4.78E-05,0,0,4
journalism,21,3.86E-05,20,4.56E-05,9.47E-06,1,3
yesterdays,21,3.86E-05,10,2.28E-05,0.000104201,11,3
signatures,21,3.86E-05,20,4.56E-05,9.47E-06,1,3
particular,21,3.86E-05,21,4.78E-05,0,0,4
annual,21,3.86E-05,13,2.96E-05,7.58E-05,8,2
announcement,21,3.86E-05,14,3.19E-05,6.63E-05,7,4
independent,21,3.86E-05,21,4.78E-05,0,0,4
illegals,21,3.86E-05,21,4.78E-05,0,0,3
circuit,21,3.86E-05,21,4.78E-05,0,0,2
unlimited,21,3.86E-05,21,4.78E-05,0,0,3
professionals,21,3.86E-05,19,4.33E-05,1.89E-05,2,4
bay,20,3.67E-05,16,3.64E-05,3.79E-05,4,1
aoc,20,3.67E-05,20,4.56E-05,0,0,1
roy,20,3.67E-05,20,4.56E-05,0,0,1
wind,20,3.67E-05,2,4.56E-06,0.000170511,18,1
cool,20,3.67E-05,14,3.19E-05,5.68E-05,6,1
fund,20,3.67E-05,14,3.19E-05,5.68E-05,6,1
felt,20,3.67E-05,15,3.42E-05,4.74E-05,5,1
lack,20,3.67E-05,19,4.33E-05,9.47E-06,1,1
text,20,3.67E-05,14,3.19E-05,5.68E-05,6,1
josh,20,3.67E-05,19,4.33E-05,9.47E-06,1,1
rich,20,3.67E-05,17,3.87E-05,2.84E-05,3,1
pray,20,3.67E-05,19,4.33E-05,9.47E-06,1,1
solar,20,3.67E-05,0,0,0.000189457,20,2
round,20,3.67E-05,14,3.19E-05,5.68E-05,6,1
terms,20,3.67E-05,19,4.33E-05,9.47E-06,1,1
stood,20,3.67E-05,15,3.42E-05,4.74E-05,5,1
doors,20,3.67E-05,7,1.59E-05,0.000123147,13,1
moved,20,3.67E-05,17,3.87E-05,2.84E-05,3,1
award,20,3.67E-05,19,4.33E-05,9.47E-06,1,2
andor,20,3.67E-05,20,4.56E-05,0,0,2
soooo,20,3.67E-05,20,4.56E-05,0,0,2
likely,20,3.67E-05,13,2.96E-05,6.63E-05,7,3
urging,20,3.67E-05,11,2.51E-05,8.53E-05,9,2
ground,20,3.67E-05,16,3.64E-05,3.79E-05,4,1
begins,20,3.67E-05,14,3.19E-05,5.68E-05,6,2
tragic,20,3.67E-05,13,2.96E-05,6.63E-05,7,2
notice,20,3.67E-05,19,4.33E-05,9.47E-06,1,2
cancel,20,3.67E-05,19,4.33E-05,9.47E-06,1,2
garden,20,3.67E-05,17,3.87E-05,2.84E-05,3,2
seldom,20,3.67E-05,20,4.56E-05,0,0,2
wheres,20,3.67E-05,20,4.56E-05,0,0,1
ivanka,20,3.67E-05,20,4.56E-05,0,0,3
mostly,20,3.67E-05,20,4.56E-05,0,0,2
demean,20,3.67E-05,20,4.56E-05,0,0,2
nadler,20,3.67E-05,20,4.56E-05,0,0,2
journey,20,3.67E-05,7,1.59E-05,0.000123147,13,2
finding,20,3.67E-05,17,3.87E-05,2.84E-05,3,2
purpose,20,3.67E-05,17,3.87E-05,2.84E-05,3,2
mandate,20,3.67E-05,15,3.42E-05,4.74E-05,5,2
patrick,20,3.67E-05,19,4.33E-05,9.47E-06,1,2
leaking,20,3.67E-05,20,4.56E-05,0,0,2
medicaid,20,3.67E-05,1,2.28E-06,0.000179984,19,3
directly,20,3.67E-05,17,3.87E-05,2.84E-05,3,3
december,20,3.67E-05,15,3.42E-05,4.74E-05,5,3
purposes,20,3.67E-05,19,4.33E-05,9.47E-06,1,2
ceremony,20,3.67E-05,18,4.10E-05,1.89E-05,2,4
basement,20,3.67E-05,20,4.56E-05,0,0,3
seriously,20,3.67E-05,17,3.87E-05,2.84E-05,3,4
opponents,20,3.67E-05,16,3.64E-05,3.79E-05,4,3
scheduled,20,3.67E-05,19,4.33E-05,9.47E-06,1,2
volunteer,20,3.67E-05,13,2.96E-05,6.63E-05,7,3
electoral,20,3.67E-05,19,4.33E-05,9.47E-06,1,4
incorrect,20,3.67E-05,20,4.56E-05,0,0,3
departing,20,3.67E-05,20,4.56E-05,0,0,3
interested,20,3.67E-05,19,4.33E-05,9.47E-06,1,3
phenomenal,20,3.67E-05,20,4.56E-05,0,0,4
tightening,20,3.67E-05,20,4.56E-05,0,0,3
fill,20,3.67E-05,11,2.51E-05,8.53E-05,9,1
hill,20,3.67E-05,19,4.33E-05,9.47E-06,1,1
walls,20,3.67E-05,19,4.33E-05,9.47E-06,1,1
dallas,20,3.67E-05,20,4.56E-05,0,0,2
surveillance,20,3.67E-05,20,4.56E-05,0,0,3
monitoring,20,3.67E-05,20,4.56E-05,0,0,4
embarrassment,20,3.67E-05,20,4.56E-05,0,0,4
jon,19,3.49E-05,17,3.87E-05,1.89E-05,2,1
bel,19,3.49E-05,19,4.33E-05,0,0,1
walk,19,3.49E-05,9,2.05E-05,9.47E-05,10,1
fear,19,3.49E-05,12,2.73E-05,6.63E-05,7,1
math,19,3.49E-05,0,0,0.000179984,19,1
fans,19,3.49E-05,15,3.42E-05,3.79E-05,4,1
arms,19,3.49E-05,18,4.10E-05,9.47E-06,1,1
pres,19,3.49E-05,17,3.87E-05,1.89E-05,2,#ERROR!
veto,19,3.49E-05,18,4.10E-05,9.47E-06,1,2
pack,19,3.49E-05,19,4.33E-05,0,0,1
aside,19,3.49E-05,4,9.11E-06,0.000142093,15,2
fewer,19,3.49E-05,11,2.51E-05,7.58E-05,8,2
sides,19,3.49E-05,13,2.96E-05,5.68E-05,6,1
apple,19,3.49E-05,18,4.10E-05,9.47E-06,1,2
vegas,19,3.49E-05,17,3.87E-05,1.89E-05,2,2
jones,19,3.49E-05,19,4.33E-05,0,0,1
leaks,19,3.49E-05,19,4.33E-05,0,0,1
exact,19,3.49E-05,19,4.33E-05,0,0,2
planet,19,3.49E-05,7,1.59E-05,0.000113674,12,2
decade,19,3.49E-05,4,9.11E-06,0.000142093,15,2
ruling,19,3.49E-05,11,2.51E-05,7.58E-05,8,2
sexual,19,3.49E-05,5,1.14E-05,0.00013262,14,2
salute,19,3.49E-05,16,3.64E-05,2.84E-05,3,2
online,19,3.49E-05,11,2.51E-05,7.58E-05,8,2
mental,19,3.49E-05,12,2.73E-05,6.63E-05,7,2
grants,19,3.49E-05,9,2.05E-05,9.47E-05,10,1
minute,19,3.49E-05,12,2.73E-05,6.63E-05,7,2
rocket,19,3.49E-05,19,4.33E-05,0,0,2
wasted,19,3.49E-05,19,4.33E-05,0,0,1
bishop,19,3.49E-05,19,4.33E-05,0,0,2
wasting,19,3.49E-05,18,4.10E-05,9.47E-06,1,2
reduced,19,3.49E-05,13,2.96E-05,5.68E-05,6,2
warmest,19,3.49E-05,13,2.96E-05,5.68E-05,6,2
deepest,19,3.49E-05,16,3.64E-05,2.84E-05,3,2
peoples,19,3.49E-05,11,2.51E-05,7.58E-05,8,2
warrior,19,3.49E-05,18,4.10E-05,9.47E-06,1,2
garbage,19,3.49E-05,19,4.33E-05,0,0,2
charles,19,3.49E-05,19,4.33E-05,0,0,2
handled,19,3.49E-05,19,4.33E-05,0,0,1
charlie,19,3.49E-05,19,4.33E-05,0,0,2
arrested,19,3.49E-05,18,4.10E-05,9.47E-06,1,2
blocking,19,3.49E-05,9,2.05E-05,9.47E-05,10,2
february,19,3.49E-05,13,2.96E-05,5.68E-05,6,3
surprise,19,3.49E-05,18,4.10E-05,9.47E-06,1,2
strategy,19,3.49E-05,13,2.96E-05,5.68E-05,6,3
property,19,3.49E-05,17,3.87E-05,1.89E-05,2,3
articles,19,3.49E-05,19,4.33E-05,0,0,3
aluminum,19,3.49E-05,19,4.33E-05,0,0,4
champions,19,3.49E-05,14,3.19E-05,4.74E-05,5,2
violation,19,3.49E-05,18,4.10E-05,9.47E-06,1,3
reduction,19,3.49E-05,13,2.96E-05,5.68E-05,6,3
singapore,19,3.49E-05,18,4.10E-05,9.47E-06,1,3
observers,19,3.49E-05,19,4.33E-05,0,0,3
migration,19,3.49E-05,19,4.33E-05,0,0,3
experience,19,3.49E-05,16,3.64E-05,2.84E-05,3,3
conspiracy,19,3.49E-05,19,4.33E-05,0,0,4
battle,19,3.49E-05,18,4.10E-05,9.47E-06,1,2
seattle,19,3.49E-05,19,4.33E-05,0,0,2
lottery,19,3.49E-05,19,4.33E-05,0,0,3
investments,19,3.49E-05,8,1.82E-05,0.000104201,11,3
alternative,19,3.49E-05,18,4.10E-05,9.47E-06,1,4
negotiating,19,3.49E-05,18,4.10E-05,9.47E-06,1,4
campaigning,19,3.49E-05,17,3.87E-05,1.89E-05,2,3
legally,19,3.49E-05,19,4.33E-05,0,0,3
quite,19,3.49E-05,18,4.10E-05,9.47E-06,1,1
citizen,19,3.49E-05,14,3.19E-05,4.74E-05,5,3
capacity,19,3.49E-05,14,3.19E-05,4.74E-05,5,4
priority,19,3.49E-05,10,2.28E-05,8.53E-05,9,3
authorities,19,3.49E-05,18,4.10E-05,9.47E-06,1,4
constitutional,19,3.49E-05,18,4.10E-05,9.47E-06,1,5
proclamation,19,3.49E-05,18,4.10E-05,9.47E-06,1,4
discrimination,19,3.49E-05,3,6.83E-06,0.000151565,16,5
cup,18,3.31E-05,13,2.96E-05,4.74E-05,5,1
las,18,3.31E-05,17,3.87E-05,9.47E-06,1,1
view,18,3.31E-05,11,2.51E-05,6.63E-05,7,1
earn,18,3.31E-05,1,2.28E-06,0.000161038,17,1
link,18,3.31E-05,3,6.83E-06,0.000142093,15,1
lift,18,3.31E-05,9,2.05E-05,8.53E-05,9,1
glad,18,3.31E-05,15,3.42E-05,2.84E-05,3,1
burn,18,3.31E-05,17,3.87E-05,9.47E-06,1,1
nick,18,3.31E-05,17,3.87E-05,9.47E-06,1,1
blue,18,3.31E-05,15,3.42E-05,2.84E-05,3,1
coal,18,3.31E-05,18,4.10E-05,0,0,1
evil,18,3.31E-05,18,4.10E-05,0,0,2
cash,18,3.31E-05,18,4.10E-05,0,0,1
liar,18,3.31E-05,18,4.10E-05,0,0,1
apply,18,3.31E-05,9,2.05E-05,8.53E-05,9,2
turns,18,3.31E-05,13,2.96E-05,4.74E-05,5,1
stake,18,3.31E-05,4,9.11E-06,0.00013262,14,1
trail,18,3.31E-05,13,2.96E-05,4.74E-05,5,1
signs,18,3.31E-05,14,3.19E-05,3.79E-05,4,1
elect,18,3.31E-05,16,3.64E-05,1.89E-05,2,2
phase,18,3.31E-05,18,4.10E-05,0,0,1
eddie,18,3.31E-05,18,4.10E-05,0,0,2
gained,18,3.31E-05,10,2.28E-05,7.58E-05,8,1
latest,18,3.31E-05,9,2.05E-05,8.53E-05,9,2
doctor,18,3.31E-05,11,2.51E-05,6.63E-05,7,2
expect,18,3.31E-05,13,2.96E-05,4.74E-05,5,2
earned,18,3.31E-05,11,2.51E-05,6.63E-05,7,1
owners,18,3.31E-05,10,2.28E-05,7.58E-05,8,2
search,18,3.31E-05,17,3.87E-05,9.47E-06,1,1
buying,18,3.31E-05,16,3.64E-05,1.89E-05,2,2
hiring,18,3.31E-05,9,2.05E-05,8.53E-05,9,2
assist,18,3.31E-05,15,3.42E-05,2.84E-05,3,2
nicely,18,3.31E-05,18,4.10E-05,0,0,3
forgot,18,3.31E-05,18,4.10E-05,0,0,2
reveal,18,3.31E-05,18,4.10E-05,0,0,2
regime,18,3.31E-05,18,4.10E-05,0,0,2
jewish,18,3.31E-05,18,4.10E-05,0,0,2
pompeo,18,3.31E-05,18,4.10E-05,0,0,2
elijah,18,3.31E-05,18,4.10E-05,0,0,3
excuses,18,3.31E-05,14,3.19E-05,3.79E-05,4,2
tribute,18,3.31E-05,10,2.28E-05,7.58E-05,8,2
traffic,18,3.31E-05,16,3.64E-05,1.89E-05,2,2
husband,18,3.31E-05,17,3.87E-05,9.47E-06,1,2
parties,18,3.31E-05,10,2.28E-05,7.58E-05,8,2
hostage,18,3.31E-05,15,3.42E-05,2.84E-05,3,2
smarter,18,3.31E-05,16,3.64E-05,1.89E-05,2,2
driving,18,3.31E-05,15,3.42E-05,2.84E-05,3,2
feeling,18,3.31E-05,12,2.73E-05,5.68E-05,6,2
hosting,18,3.31E-05,15,3.42E-05,2.84E-05,3,2
orlando,18,3.31E-05,16,3.64E-05,1.89E-05,2,3
largely,18,3.31E-05,17,3.87E-05,9.47E-06,1,3
apology,18,3.31E-05,18,4.10E-05,0,0,4
prevail,18,3.31E-05,18,4.10E-05,0,0,2
islamic,18,3.31E-05,18,4.10E-05,0,0,3
rioters,18,3.31E-05,18,4.10E-05,0,0,2
suburbs,18,3.31E-05,18,4.10E-05,0,0,2
obvious,18,3.31E-05,18,4.10E-05,0,0,3
tickets,18,3.31E-05,18,4.10E-05,0,0,2
honoring,18,3.31E-05,12,2.73E-05,5.68E-05,6,3
believes,18,3.31E-05,10,2.28E-05,7.58E-05,8,2
creation,18,3.31E-05,7,1.59E-05,0.000104201,11,2
delivers,18,3.31E-05,10,2.28E-05,7.58E-05,8,3
maryland,18,3.31E-05,14,3.19E-05,3.79E-05,4,3
balanced,18,3.31E-05,5,1.14E-05,0.000123147,13,2
referred,18,3.31E-05,17,3.87E-05,9.47E-06,1,2
endorsed,18,3.31E-05,15,3.42E-05,2.84E-05,3,2
judicial,18,3.31E-05,16,3.64E-05,1.89E-05,2,3
revealed,18,3.31E-05,18,4.10E-05,0,0,2
pandemic,18,3.31E-05,18,4.10E-05,0,0,3
accurate,18,3.31E-05,18,4.10E-05,0,0,3
honduras,18,3.31E-05,18,4.10E-05,0,0,3
hostages,18,3.31E-05,18,4.10E-05,0,0,2
lawmakers,18,3.31E-05,11,2.51E-05,6.63E-05,7,3
hispanics,18,3.31E-05,17,3.87E-05,9.47E-06,1,3
protected,18,3.31E-05,16,3.64E-05,1.89E-05,2,2
knowingly,18,3.31E-05,18,4.10E-05,0,0,3
receiving,18,3.31E-05,18,4.10E-05,0,0,3
caliphate,18,3.31E-05,18,4.10E-05,0,0,3
increasing,18,3.31E-05,10,2.28E-05,7.58E-05,8,3
technology,18,3.31E-05,16,3.64E-05,1.89E-05,2,4
depression,18,3.31E-05,15,3.42E-05,2.84E-05,3,3
acceptable,18,3.31E-05,17,3.87E-05,9.47E-06,1,4
reputation,18,3.31E-05,18,4.10E-05,0,0,4
dishonesty,18,3.31E-05,18,4.10E-05,0,0,4
bedminster,18,3.31E-05,18,4.10E-05,0,0,3
fabricated,18,3.31E-05,18,4.10E-05,0,0,3
pretty,18,3.31E-05,14,3.19E-05,3.79E-05,4,2
fell,18,3.31E-05,10,2.28E-05,7.58E-05,8,1
hall,18,3.31E-05,15,3.42E-05,2.84E-05,3,1
falling,18,3.31E-05,16,3.64E-05,1.89E-05,2,2
quit,18,3.31E-05,13,2.96E-05,4.74E-05,5,1
excited,18,3.31E-05,12,2.73E-05,5.68E-05,6,2
entitled,18,3.31E-05,17,3.87E-05,9.47E-06,1,2
condition,18,3.31E-05,8,1.82E-05,9.47E-05,10,3
quantitative,18,3.31E-05,18,4.10E-05,0,0,4
inauguration,18,3.31E-05,13,2.96E-05,4.74E-05,5,5
professional,18,3.31E-05,17,3.87E-05,9.47E-06,1,4
disappointed,18,3.31E-05,13,2.96E-05,4.74E-05,5,3
investigated,18,3.31E-05,18,4.10E-05,0,0,4
ridiculously,18,3.31E-05,18,4.10E-05,0,0,5
denuclearization,18,3.31E-05,18,4.10E-05,0,0,6
owe,17,3.12E-05,6,1.37E-05,0.000104201,11,1
dog,17,3.12E-05,12,2.73E-05,4.74E-05,5,1
sen,17,3.12E-05,12,2.73E-05,4.74E-05,5,1
data,17,3.12E-05,15,3.42E-05,1.89E-05,2,2
wise,17,3.12E-05,15,3.42E-05,1.89E-05,2,1
jack,17,3.12E-05,15,3.42E-05,1.89E-05,2,1
blew,17,3.12E-05,17,3.87E-05,0,0,1
flow,17,3.12E-05,17,3.87E-05,0,0,1
pour,17,3.12E-05,17,3.87E-05,0,0,1
reed,17,3.12E-05,17,3.87E-05,0,0,1
value,17,3.12E-05,13,2.96E-05,3.79E-05,4,2
roads,17,3.12E-05,9,2.05E-05,7.58E-05,8,1
grows,17,3.12E-05,4,9.11E-06,0.000123147,13,1
april,17,3.12E-05,13,2.96E-05,3.79E-05,4,2
beach,17,3.12E-05,16,3.64E-05,9.47E-06,1,1
karen,17,3.12E-05,17,3.87E-05,0,0,2
upset,17,3.12E-05,17,3.87E-05,0,0,2
msnbc,17,3.12E-05,17,3.87E-05,0,0,#ERROR!
rogue,17,3.12E-05,17,3.87E-05,0,0,2
intel,17,3.12E-05,17,3.87E-05,0,0,2
beauty,17,3.12E-05,16,3.64E-05,9.47E-06,1,3
waters,17,3.12E-05,15,3.42E-05,1.89E-05,2,2
danger,17,3.12E-05,16,3.64E-05,9.47E-06,1,2
tweets,17,3.12E-05,11,2.51E-05,5.68E-05,6,1
martin,17,3.12E-05,11,2.51E-05,5.68E-05,6,2
korean,17,3.12E-05,16,3.64E-05,9.47E-06,1,2
powers,17,3.12E-05,16,3.64E-05,9.47E-06,1,2
pardon,17,3.12E-05,16,3.64E-05,9.47E-06,1,2
loaded,17,3.12E-05,13,2.96E-05,3.79E-05,4,1
placed,17,3.12E-05,16,3.64E-05,9.47E-06,1,1
region,17,3.12E-05,16,3.64E-05,9.47E-06,1,2
larger,17,3.12E-05,16,3.64E-05,9.47E-06,1,2
rarely,17,3.12E-05,16,3.64E-05,9.47E-06,1,3
plague,17,3.12E-05,17,3.87E-05,0,0,2
proper,17,3.12E-05,17,3.87E-05,0,0,2
respond,17,3.12E-05,11,2.51E-05,5.68E-05,6,2
housing,17,3.12E-05,12,2.73E-05,4.74E-05,5,2
express,17,3.12E-05,15,3.42E-05,1.89E-05,2,2
recover,17,3.12E-05,15,3.42E-05,1.89E-05,2,3
counted,17,3.12E-05,16,3.64E-05,9.47E-06,1,1
doctors,17,3.12E-05,16,3.64E-05,9.47E-06,1,2
details,17,3.12E-05,17,3.87E-05,0,0,2
causing,17,3.12E-05,17,3.87E-05,0,0,2
barrier,17,3.12E-05,17,3.87E-05,0,0,2
thankful,17,3.12E-05,11,2.51E-05,5.68E-05,6,2
taxpayer,17,3.12E-05,12,2.73E-05,4.74E-05,5,3
original,17,3.12E-05,16,3.64E-05,9.47E-06,1,4
thriving,17,3.12E-05,10,2.28E-05,6.63E-05,7,2
launched,17,3.12E-05,8,1.82E-05,8.53E-05,9,1
chrysler,17,3.12E-05,10,2.28E-05,6.63E-05,7,2
homeless,17,3.12E-05,16,3.64E-05,9.47E-06,1,3
dominion,17,3.12E-05,17,3.87E-05,0,0,3
produced,17,3.12E-05,17,3.87E-05,0,0,2
stopping,17,3.12E-05,17,3.87E-05,0,0,2
networks,17,3.12E-05,17,3.87E-05,0,0,2
woodward,17,3.12E-05,17,3.87E-05,0,0,2
laughing,17,3.12E-05,17,3.87E-05,0,0,2
subjects,17,3.12E-05,17,3.87E-05,0,0,2
consumers,17,3.12E-05,11,2.51E-05,5.68E-05,6,3
resources,17,3.12E-05,12,2.73E-05,4.74E-05,5,2
demanding,17,3.12E-05,12,2.73E-05,4.74E-05,5,3
regarding,17,3.12E-05,16,3.64E-05,9.47E-06,1,3
eliminate,17,3.12E-05,11,2.51E-05,5.68E-05,6,4
taxpayers,17,3.12E-05,14,3.19E-05,2.84E-05,3,3
nominated,17,3.12E-05,15,3.42E-05,1.89E-05,2,3
operation,17,3.12E-05,16,3.64E-05,9.47E-06,1,4
returning,17,3.12E-05,15,3.42E-05,1.89E-05,2,3
suffering,17,3.12E-05,16,3.64E-05,9.47E-06,1,3
monuments,17,3.12E-05,17,3.87E-05,0,0,3
surprised,17,3.12E-05,17,3.87E-05,0,0,2
socialist,17,3.12E-05,17,3.87E-05,0,0,3
volunteers,17,3.12E-05,2,4.56E-06,0.000142093,15,3
assistance,17,3.12E-05,15,3.42E-05,1.89E-05,2,3
wealthiest,17,3.12E-05,0,0,0.000161038,17,2
devastated,17,3.12E-05,16,3.64E-05,9.47E-06,1,3
compromise,17,3.12E-05,3,6.83E-06,0.00013262,14,3
destroying,17,3.12E-05,16,3.64E-05,9.47E-06,1,3
management,17,3.12E-05,17,3.87E-05,0,0,4
innovation,17,3.12E-05,5,1.14E-05,0.000113674,12,4
achievement,17,3.12E-05,15,3.42E-05,1.89E-05,2,4
accountable,17,3.12E-05,7,1.59E-05,9.47E-05,10,4
complaining,17,3.12E-05,17,3.87E-05,0,0,3
negotiation,17,3.12E-05,17,3.87E-05,0,0,4
baseball,17,3.12E-05,14,3.19E-05,2.84E-05,3,3
originally,17,3.12E-05,16,3.64E-05,9.47E-06,1,5
controlled,17,3.12E-05,17,3.87E-05,0,0,2
gathered,17,3.12E-05,16,3.64E-05,9.47E-06,1,2
unity,17,3.12E-05,16,3.64E-05,9.47E-06,1,3
italy,17,3.12E-05,17,3.87E-05,0,0,3
reality,17,3.12E-05,9,2.05E-05,7.58E-05,8,3
lawsuit,17,3.12E-05,16,3.64E-05,9.47E-06,1,2
neither,17,3.12E-05,14,3.19E-05,2.84E-05,3,2
fraudulently,17,3.12E-05,17,3.87E-05,0,0,4
commerce,17,3.12E-05,17,3.87E-05,0,0,2
bet,16,2.94E-05,8,1.82E-05,7.58E-05,8,1
odds,16,2.94E-05,12,2.73E-05,3.79E-05,4,1
role,16,2.94E-05,12,2.73E-05,3.79E-05,4,2
wake,16,2.94E-05,8,1.82E-05,7.58E-05,8,1
onto,16,2.94E-05,14,3.19E-05,1.89E-05,2,2
oath,16,2.94E-05,14,3.19E-05,1.89E-05,2,1
juan,16,2.94E-05,16,3.64E-05,0,0,1
lands,16,2.94E-05,14,3.19E-05,1.89E-05,2,1
twice,16,2.94E-05,11,2.51E-05,4.74E-05,5,1
sworn,16,2.94E-05,10,2.28E-05,5.68E-05,6,1
avoid,16,2.94E-05,8,1.82E-05,7.58E-05,8,2
scene,16,2.94E-05,14,3.19E-05,1.89E-05,2,1
marks,16,2.94E-05,9,2.05E-05,6.63E-05,7,1
gains,16,2.94E-05,15,3.42E-05,9.47E-06,1,1
eight,16,2.94E-05,11,2.51E-05,4.74E-05,5,1
brand,16,2.94E-05,15,3.42E-05,9.47E-06,1,1
miami,16,2.94E-05,14,3.19E-05,1.89E-05,2,2
gangs,16,2.94E-05,16,3.64E-05,0,0,1
liked,16,2.94E-05,16,3.64E-05,0,0,1
wacky,16,2.94E-05,16,3.64E-05,0,0,2
weapon,16,2.94E-05,12,2.73E-05,3.79E-05,4,2
boston,16,2.94E-05,11,2.51E-05,4.74E-05,5,2
cancer,16,2.94E-05,3,6.83E-06,0.000123147,13,2
rescue,16,2.94E-05,13,2.96E-05,2.84E-05,3,2
direct,16,2.94E-05,14,3.19E-05,1.89E-05,2,2
series,16,2.94E-05,11,2.51E-05,4.74E-05,5,2
hoping,16,2.94E-05,11,2.51E-05,4.74E-05,5,2
strike,16,2.94E-05,14,3.19E-05,1.89E-05,2,1
martha,16,2.94E-05,14,3.19E-05,1.89E-05,2,2
harris,16,2.94E-05,16,3.64E-05,0,0,2
corker,16,2.94E-05,16,3.64E-05,0,0,2
player,16,2.94E-05,16,3.64E-05,0,0,2
opioid,16,2.94E-05,16,3.64E-05,0,0,3
session,16,2.94E-05,13,2.96E-05,2.84E-05,3,2
confirm,16,2.94E-05,10,2.28E-05,5.68E-05,6,2
moments,16,2.94E-05,8,1.82E-05,7.58E-05,8,2
fastest,16,2.94E-05,10,2.28E-05,5.68E-05,6,2
choices,16,2.94E-05,5,1.14E-05,0.000104201,11,1
doubled,16,2.94E-05,4,9.11E-06,0.000113674,12,1
machine,16,2.94E-05,15,3.42E-05,9.47E-06,1,2
officer,16,2.94E-05,14,3.19E-05,1.89E-05,2,3
briefed,16,2.94E-05,15,3.42E-05,9.47E-06,1,1
granted,16,2.94E-05,15,3.42E-05,9.47E-06,1,1
fleeing,16,2.94E-05,16,3.64E-05,0,0,2
dumbest,16,2.94E-05,16,3.64E-05,0,0,2
nowhere,16,2.94E-05,16,3.64E-05,0,0,2
blaming,16,2.94E-05,16,3.64E-05,0,0,2
pelosis,16,2.94E-05,16,3.64E-05,0,0,3
tiffany,16,2.94E-05,16,3.64E-05,0,0,3
advanced,16,2.94E-05,11,2.51E-05,4.74E-05,5,2
reminder,16,2.94E-05,3,6.83E-06,0.000123147,13,3
learning,16,2.94E-05,12,2.73E-05,3.79E-05,4,2
consider,16,2.94E-05,15,3.42E-05,9.47E-06,1,3
combined,16,2.94E-05,12,2.73E-05,3.79E-05,4,2
clintons,16,2.94E-05,15,3.42E-05,9.47E-06,1,2
covering,16,2.94E-05,15,3.42E-05,9.47E-06,1,3
machines,16,2.94E-05,16,3.64E-05,0,0,2
suffered,16,2.94E-05,16,3.64E-05,0,0,2
replaced,16,2.94E-05,16,3.64E-05,0,0,2
ranchers,16,2.94E-05,16,3.64E-05,0,0,2
mcmaster,16,2.94E-05,16,3.64E-05,0,0,2
repealing,16,2.94E-05,2,4.56E-06,0.00013262,14,3
recession,16,2.94E-05,10,2.28E-05,5.68E-05,6,3
continued,16,2.94E-05,12,2.73E-05,3.79E-05,4,3
mentioned,16,2.94E-05,16,3.64E-05,0,0,2
conflicts,16,2.94E-05,16,3.64E-05,0,0,2
victories,16,2.94E-05,16,3.64E-05,0,0,3
meaningful,16,2.94E-05,11,2.51E-05,4.74E-05,5,3
scientists,16,2.94E-05,7,1.59E-05,8.53E-05,9,2
recognized,16,2.94E-05,14,3.19E-05,1.89E-05,2,3
determined,16,2.94E-05,12,2.73E-05,3.79E-05,4,3
industries,16,2.94E-05,15,3.42E-05,9.47E-06,1,3
disastrous,16,2.94E-05,15,3.42E-05,9.47E-06,1,3
apologized,16,2.94E-05,16,3.64E-05,0,0,4
disrespect,16,2.94E-05,16,3.64E-05,0,0,3
ronny,16,2.94E-05,16,3.64E-05,0,0,2
celebration,16,2.94E-05,13,2.96E-05,2.84E-05,3,4
understands,16,2.94E-05,15,3.42E-05,9.47E-06,1,3
ineffective,16,2.94E-05,16,3.64E-05,0,0,4
legislative,16,2.94E-05,16,3.64E-05,0,0,4
scarborough,16,2.94E-05,16,3.64E-05,0,0,3
magnificent,16,2.94E-05,16,3.64E-05,0,0,4
impeachable,16,2.94E-05,16,3.64E-05,0,0,4
governments,16,2.94E-05,16,3.64E-05,0,0,3
spectacular,16,2.94E-05,16,3.64E-05,0,0,4
roll,16,2.94E-05,9,2.05E-05,6.63E-05,7,1
overall,16,2.94E-05,16,3.64E-05,0,0,3
merit,16,2.94E-05,16,3.64E-05,0,0,2
writing,16,2.94E-05,12,2.73E-05,3.79E-05,4,2
deficits,16,2.94E-05,10,2.28E-05,5.68E-05,6,3
transition,16,2.94E-05,14,3.19E-05,1.89E-05,2,3
competitive,16,2.94E-05,14,3.19E-05,1.89E-05,2,4
unbelievable,16,2.94E-05,15,3.42E-05,9.47E-06,1,5
continuation,16,2.94E-05,16,3.64E-05,0,0,4
incompetence,16,2.94E-05,16,3.64E-05,0,0,4
comments,16,2.94E-05,14,3.19E-05,1.89E-05,2,2
conversations,16,2.94E-05,14,3.19E-05,1.89E-05,2,4
authorization,16,2.94E-05,15,3.42E-05,9.47E-06,1,5
uk,15,2.75E-05,15,3.42E-05,0,0,1
gap,15,2.75E-05,0,0,0.000142093,15,1
born,15,2.75E-05,5,1.14E-05,9.47E-05,10,1
urge,15,2.75E-05,3,6.83E-06,0.000113674,12,1
farm,15,2.75E-05,14,3.19E-05,9.47E-06,1,1
rock,15,2.75E-05,14,3.19E-05,9.47E-06,1,1
mary,15,2.75E-05,14,3.19E-05,9.47E-06,1,2
rape,15,2.75E-05,1,2.28E-06,0.00013262,14,1
hide,15,2.75E-05,12,2.73E-05,2.84E-05,3,1
gold,15,2.75E-05,11,2.51E-05,3.79E-05,4,1
alex,15,2.75E-05,10,2.28E-05,4.74E-05,5,2
alan,15,2.75E-05,14,3.19E-05,9.47E-06,1,2
kemp,15,2.75E-05,15,3.42E-05,0,0,1
tiny,15,2.75E-05,15,3.42E-05,0,0,2
lyin,15,2.75E-05,15,3.42E-05,0,0,1
leads,15,2.75E-05,11,2.51E-05,3.79E-05,4,1
carry,15,2.75E-05,10,2.28E-05,4.74E-05,5,2
names,15,2.75E-05,14,3.19E-05,9.47E-06,1,1
throw,15,2.75E-05,7,1.59E-05,7.58E-05,8,1
seats,15,2.75E-05,13,2.96E-05,1.89E-05,2,1
grand,15,2.75E-05,14,3.19E-05,9.47E-06,1,1
egypt,15,2.75E-05,13,2.96E-05,1.89E-05,2,2
fredo,15,2.75E-05,15,3.42E-05,0,0,2
sided,15,2.75E-05,15,3.42E-05,0,0,1
tower,15,2.75E-05,15,3.42E-05,0,0,2
texts,15,2.75E-05,15,3.42E-05,0,0,1
coach,15,2.75E-05,15,3.42E-05,0,0,1
siege,15,2.75E-05,15,3.42E-05,0,0,1
adults,15,2.75E-05,2,4.56E-06,0.000123147,13,2
tested,15,2.75E-05,13,2.96E-05,1.89E-05,2,1
deeply,15,2.75E-05,10,2.28E-05,4.74E-05,5,2
proved,15,2.75E-05,9,2.05E-05,5.68E-05,6,1
rising,15,2.75E-05,9,2.05E-05,5.68E-05,6,2
easter,15,2.75E-05,10,2.28E-05,4.74E-05,5,2
shares,15,2.75E-05,5,1.14E-05,9.47E-05,10,1
bright,15,2.75E-05,14,3.19E-05,9.47E-06,1,1
hosted,15,2.75E-05,11,2.51E-05,3.79E-05,4,1
poland,15,2.75E-05,13,2.96E-05,1.89E-05,2,2
church,15,2.75E-05,14,3.19E-05,9.47E-06,1,1
ripped,15,2.75E-05,15,3.42E-05,0,0,1
pharma,15,2.75E-05,15,3.42E-05,0,0,2
deputy,15,2.75E-05,15,3.42E-05,0,0,3
tester,15,2.75E-05,15,3.42E-05,0,0,2
becomes,15,2.75E-05,13,2.96E-05,1.89E-05,2,2
walking,15,2.75E-05,12,2.73E-05,2.84E-05,3,2
society,15,2.75E-05,9,2.05E-05,5.68E-05,6,3
meaning,15,2.75E-05,12,2.73E-05,2.84E-05,3,2
passage,15,2.75E-05,11,2.51E-05,3.79E-05,4,2
reforms,15,2.75E-05,5,1.14E-05,9.47E-05,10,2
injured,15,2.75E-05,13,2.96E-05,1.89E-05,2,2
bravery,15,2.75E-05,13,2.96E-05,1.89E-05,2,3
cherish,15,2.75E-05,14,3.19E-05,9.47E-06,1,2
clearly,15,2.75E-05,15,3.42E-05,0,0,2
related,15,2.75E-05,15,3.42E-05,0,0,2
caravan,15,2.75E-05,15,3.42E-05,0,0,3
expanded,15,2.75E-05,5,1.14E-05,9.47E-05,10,2
conflict,15,2.75E-05,12,2.73E-05,2.84E-05,3,2
midnight,15,2.75E-05,3,6.83E-06,0.000113674,12,2
achieved,15,2.75E-05,14,3.19E-05,9.47E-06,1,2
threaten,15,2.75E-05,8,1.82E-05,6.63E-05,7,2
mistakes,15,2.75E-05,13,2.96E-05,1.89E-05,2,2
audience,15,2.75E-05,11,2.51E-05,3.79E-05,4,2
refusing,15,2.75E-05,15,3.42E-05,0,0,3
location,15,2.75E-05,15,3.42E-05,0,0,3
deranged,15,2.75E-05,15,3.42E-05,0,0,2
targeted,15,2.75E-05,15,3.42E-05,0,0,2
treasury,15,2.75E-05,15,3.42E-05,0,0,3
prisoners,15,2.75E-05,13,2.96E-05,1.89E-05,2,3
discusses,15,2.75E-05,3,6.83E-06,0.000113674,12,2
expanding,15,2.75E-05,11,2.51E-05,3.79E-05,4,3
certainly,15,2.75E-05,14,3.19E-05,9.47E-06,1,3
viciously,15,2.75E-05,15,3.42E-05,0,0,4
obamagate,15,2.75E-05,15,3.42E-05,0,0,4
requested,15,2.75E-05,15,3.42E-05,0,0,2
socialism,15,2.75E-05,15,3.42E-05,0,0,3
resolution,15,2.75E-05,12,2.73E-05,2.84E-05,3,4
operations,15,2.75E-05,14,3.19E-05,9.47E-06,1,4
everywhere,15,2.75E-05,15,3.42E-05,0,0,4
delegation,15,2.75E-05,15,3.42E-05,0,0,4
attempt,15,2.75E-05,14,3.19E-05,9.47E-06,1,2
remembrance,15,2.75E-05,11,2.51E-05,3.79E-05,4,3
hello,15,2.75E-05,11,2.51E-05,3.79E-05,4,2
billy,15,2.75E-05,14,3.19E-05,9.47E-06,1,2
skills,15,2.75E-05,4,9.11E-06,0.000104201,11,1
selling,15,2.75E-05,9,2.05E-05,5.68E-05,6,2
followed,15,2.75E-05,13,2.96E-05,1.89E-05,2,2
pollster,15,2.75E-05,15,3.42E-05,0,0,2
challenges,15,2.75E-05,3,6.83E-06,0.000113674,12,2
allegations,15,2.75E-05,15,3.42E-05,0,0,4
capital,15,2.75E-05,13,2.96E-05,1.89E-05,2,3
authority,15,2.75E-05,11,2.51E-05,3.79E-05,4,4
editorial,15,2.75E-05,15,3.42E-05,0,0,4
initiative,15,2.75E-05,9,2.05E-05,5.68E-05,6,4
opportunities,15,2.75E-05,5,1.14E-05,9.47E-05,10,5
fathers,15,2.75E-05,2,4.56E-06,0.000123147,13,2
nevertheless,15,2.75E-05,15,3.42E-05,0,0,4
cummings,15,2.75E-05,15,3.42E-05,0,0,2
commission,15,2.75E-05,15,3.42E-05,0,0,3
conservatives,15,2.75E-05,14,3.19E-05,9.47E-06,1,4
whistleblowers,15,2.75E-05,15,3.42E-05,0,0,4
accomplishments,15,2.75E-05,13,2.96E-05,1.89E-05,2,4
park,14,2.57E-05,10,2.28E-05,3.79E-05,4,1
desk,14,2.57E-05,11,2.51E-05,2.84E-05,3,1
warm,14,2.57E-05,9,2.05E-05,4.74E-05,5,1
busy,14,2.57E-05,12,2.73E-05,1.89E-05,2,2
harm,14,2.57E-05,11,2.51E-05,2.84E-05,3,1
asks,14,2.57E-05,8,1.82E-05,5.68E-05,6,1
mask,14,2.57E-05,14,3.19E-05,0,0,1
heed,14,2.57E-05,14,3.19E-05,0,0,1
plain,14,2.57E-05,11,2.51E-05,2.84E-05,3,1
boost,14,2.57E-05,10,2.28E-05,3.79E-05,4,1
minds,14,2.57E-05,11,2.51E-05,2.84E-05,3,1
heads,14,2.57E-05,9,2.05E-05,4.74E-05,5,1
views,14,2.57E-05,10,2.28E-05,3.79E-05,4,1
kerry,14,2.57E-05,12,2.73E-05,1.89E-05,2,2
began,14,2.57E-05,13,2.96E-05,9.47E-06,1,2
sarah,14,2.57E-05,10,2.28E-05,3.79E-05,4,2
starr,14,2.57E-05,14,3.19E-05,0,0,1
rooms,14,2.57E-05,14,3.19E-05,0,0,1
highs,14,2.57E-05,14,3.19E-05,0,0,1
fires,14,2.57E-05,14,3.19E-05,0,0,1
agrees,14,2.57E-05,10,2.28E-05,3.79E-05,4,2
wisdom,14,2.57E-05,13,2.96E-05,9.47E-06,1,2
brings,14,2.57E-05,11,2.51E-05,2.84E-05,3,1
walter,14,2.57E-05,13,2.96E-05,9.47E-06,1,2
covers,14,2.57E-05,9,2.05E-05,4.74E-05,5,2
lovers,14,2.57E-05,13,2.96E-05,9.47E-06,1,2
papers,14,2.57E-05,13,2.96E-05,9.47E-06,1,2
handle,14,2.57E-05,14,3.19E-05,0,0,2
raises,14,2.57E-05,14,3.19E-05,0,0,1
resign,14,2.57E-05,14,3.19E-05,0,0,2
losses,14,2.57E-05,14,3.19E-05,0,0,1
washed,14,2.57E-05,14,3.19E-05,0,0,1
supply,14,2.57E-05,14,3.19E-05,0,0,2
remove,14,2.57E-05,14,3.19E-05,0,0,2
funded,14,2.57E-05,14,3.19E-05,0,0,1
horror,14,2.57E-05,14,3.19E-05,0,0,2
leaker,14,2.57E-05,14,3.19E-05,0,0,2
guilty,14,2.57E-05,14,3.19E-05,0,0,2
comeys,14,2.57E-05,14,3.19E-05,0,0,2
fusion,14,2.57E-05,14,3.19E-05,0,0,2
dayton,14,2.57E-05,14,3.19E-05,0,0,2
towards,14,2.57E-05,7,1.59E-05,6.63E-05,7,2
entered,14,2.57E-05,5,1.14E-05,8.53E-05,9,2
produce,14,2.57E-05,12,2.73E-05,1.89E-05,2,2
wishing,14,2.57E-05,10,2.28E-05,3.79E-05,4,2
beloved,14,2.57E-05,12,2.73E-05,1.89E-05,2,2
package,14,2.57E-05,12,2.73E-05,1.89E-05,2,2
kidding,14,2.57E-05,12,2.73E-05,1.89E-05,2,2
enemies,14,2.57E-05,11,2.51E-05,2.84E-05,3,3
returns,14,2.57E-05,5,1.14E-05,8.53E-05,9,2
trusted,14,2.57E-05,13,2.96E-05,9.47E-06,1,1
advisor,14,2.57E-05,13,2.96E-05,9.47E-06,1,3
ongoing,14,2.57E-05,12,2.73E-05,1.89E-05,2,2
display,14,2.57E-05,13,2.96E-05,9.47E-06,1,2
rampant,14,2.57E-05,14,3.19E-05,0,0,2
cabinet,14,2.57E-05,14,3.19E-05,0,0,3
helpful,14,2.57E-05,14,3.19E-05,0,0,2
someday,14,2.57E-05,14,3.19E-05,0,0,3
penalty,14,2.57E-05,14,3.19E-05,0,0,3
shooter,14,2.57E-05,14,3.19E-05,0,0,2
podesta,14,2.57E-05,14,3.19E-05,0,0,3
councel,14,2.57E-05,14,3.19E-05,0,0,2
succeeds,14,2.57E-05,3,6.83E-06,0.000104201,11,2
proposed,14,2.57E-05,7,1.59E-05,6.63E-05,7,2
approach,14,2.57E-05,5,1.14E-05,8.53E-05,9,2
existing,14,2.57E-05,12,2.73E-05,1.89E-05,2,3
contract,14,2.57E-05,12,2.73E-05,1.89E-05,2,2
reaching,14,2.57E-05,10,2.28E-05,3.79E-05,4,2
upcoming,14,2.57E-05,13,2.96E-05,9.47E-06,1,3
programs,14,2.57E-05,7,1.59E-05,6.63E-05,7,2
columbus,14,2.57E-05,6,1.37E-05,7.58E-05,8,3
abortion,14,2.57E-05,12,2.73E-05,1.89E-05,2,3
messages,14,2.57E-05,13,2.96E-05,9.47E-06,1,2
multiple,14,2.57E-05,14,3.19E-05,0,0,3
covid-19,14,2.57E-05,14,3.19E-05,0,0,2
stupidly,14,2.57E-05,14,3.19E-05,0,0,3
headline,14,2.57E-05,14,3.19E-05,0,0,2
trumpers,14,2.57E-05,14,3.19E-05,0,0,2
sections,14,2.57E-05,14,3.19E-05,0,0,2
complain,14,2.57E-05,14,3.19E-05,0,0,2
flooding,14,2.57E-05,14,3.19E-05,0,0,2
missiles,14,2.57E-05,14,3.19E-05,0,0,3
securing,14,2.57E-05,14,3.19E-05,0,0,3
generals,14,2.57E-05,14,3.19E-05,0,0,3
provided,14,2.57E-05,14,3.19E-05,0,0,2
defending,14,2.57E-05,11,2.51E-05,2.84E-05,3,3
workforce,14,2.57E-05,8,1.82E-05,5.68E-05,6,2
solutions,14,2.57E-05,11,2.51E-05,2.84E-05,3,3
tomorrows,14,2.57E-05,2,4.56E-06,0.000113674,12,3
providing,14,2.57E-05,9,2.05E-05,4.74E-05,5,3
fireworks,14,2.57E-05,12,2.73E-05,1.89E-05,2,3
perfectly,14,2.57E-05,12,2.73E-05,1.89E-05,2,3
suggested,14,2.57E-05,13,2.96E-05,9.47E-06,1,2
corporate,14,2.57E-05,6,1.37E-05,7.58E-05,8,3
locations,14,2.57E-05,14,3.19E-05,0,0,3
judiciary,14,2.57E-05,14,3.19E-05,0,0,4
invisible,14,2.57E-05,14,3.19E-05,0,0,4
preventive,14,2.57E-05,0,0,0.00013262,14,3
executives,14,2.57E-05,11,2.51E-05,2.84E-05,3,4
previously,14,2.57E-05,11,2.51E-05,2.84E-05,3,4
filibuster,14,2.57E-05,10,2.28E-05,3.79E-05,4,4
instructed,14,2.57E-05,13,2.96E-05,9.47E-06,1,2
incredibly,14,2.57E-05,13,2.96E-05,9.47E-06,1,4
accurately,14,2.57E-05,14,3.19E-05,0,0,5
authorized,14,2.57E-05,14,3.19E-05,0,0,3
blumenthal,14,2.57E-05,14,3.19E-05,0,0,3
banned,14,2.57E-05,13,2.96E-05,9.47E-06,1,1
kennedy,14,2.57E-05,6,1.37E-05,7.58E-05,8,3
unnecessary,14,2.57E-05,14,3.19E-05,0,0,5
attempted,14,2.57E-05,13,2.96E-05,9.47E-06,1,2
pull,14,2.57E-05,8,1.82E-05,5.68E-05,6,1
protections,14,2.57E-05,4,9.11E-06,9.47E-05,10,3
environment,14,2.57E-05,10,2.28E-05,3.79E-05,4,4
association,14,2.57E-05,13,2.96E-05,9.47E-06,1,4
prosecutors,14,2.57E-05,14,3.19E-05,0,0,4
discussions,14,2.57E-05,14,3.19E-05,0,0,3
allows,14,2.57E-05,9,2.05E-05,4.74E-05,5,2
rolling,14,2.57E-05,12,2.73E-05,1.89E-05,2,2
admit,14,2.57E-05,14,3.19E-05,0,0,2
dershowitz,14,2.57E-05,14,3.19E-05,0,0,3
electricity,14,2.57E-05,3,6.83E-06,0.000104201,11,5
additionally,14,2.57E-05,14,3.19E-05,0,0,5
mothers,14,2.57E-05,5,1.14E-05,8.53E-05,9,2
congratulate,14,2.57E-05,11,2.51E-05,2.84E-05,3,4
improvements,14,2.57E-05,14,3.19E-05,0,0,4
misdemeanors,14,2.57E-05,14,3.19E-05,0,0,4
commercial,14,2.57E-05,14,3.19E-05,0,0,3
contributions,14,2.57E-05,12,2.73E-05,1.89E-05,2,4
understanding,14,2.57E-05,13,2.96E-05,9.47E-06,1,4
investigators,14,2.57E-05,14,3.19E-05,0,0,5
nor,13,2.39E-05,12,2.73E-05,9.47E-06,1,1
hot,13,2.39E-05,10,2.28E-05,2.84E-05,3,1
nra,13,2.39E-05,12,2.73E-05,9.47E-06,1,1
cop,13,2.39E-05,12,2.73E-05,9.47E-06,1,1
hat,13,2.39E-05,4,9.11E-06,8.53E-05,9,1
ben,13,2.39E-05,12,2.73E-05,9.47E-06,1,1
sue,13,2.39E-05,13,2.96E-05,0,0,1
cbs,13,2.39E-05,13,2.96E-05,0,0,1
gps,13,2.39E-05,13,2.96E-05,0,0,1
chip,13,2.39E-05,1,2.28E-06,0.000113674,12,1
note,13,2.39E-05,4,9.11E-06,8.53E-05,9,1
drew,13,2.39E-05,12,2.73E-05,9.47E-06,1,1
fuel,13,2.39E-05,5,1.14E-05,7.58E-05,8,1
boss,13,2.39E-05,11,2.51E-05,1.89E-05,2,1
wild,13,2.39E-05,12,2.73E-05,9.47E-06,1,1
fort,13,2.39E-05,12,2.73E-05,9.47E-06,1,1
asia,13,2.39E-05,11,2.51E-05,1.89E-05,2,2
gulf,13,2.39E-05,5,1.14E-05,7.58E-05,8,1
wide,13,2.39E-05,13,2.96E-05,0,0,1
boom,13,2.39E-05,13,2.96E-05,0,0,1
calm,13,2.39E-05,13,2.96E-05,0,0,1
joes,13,2.39E-05,13,2.96E-05,0,0,1
copy,13,2.39E-05,13,2.96E-05,0,0,2
sale,13,2.39E-05,13,2.96E-05,0,0,2
parks,13,2.39E-05,6,1.37E-05,6.63E-05,7,1
renew,13,2.39E-05,5,1.14E-05,7.58E-05,8,2
range,13,2.39E-05,12,2.73E-05,9.47E-06,1,1
daily,13,2.39E-05,11,2.51E-05,1.89E-05,2,2
stick,13,2.39E-05,11,2.51E-05,1.89E-05,2,1
yorks,13,2.39E-05,12,2.73E-05,9.47E-06,1,1
cindy,13,2.39E-05,13,2.96E-05,0,0,2
flake,13,2.39E-05,13,2.96E-05,0,0,1
wacko,13,2.39E-05,13,2.96E-05,0,0,2
owner,13,2.39E-05,13,2.96E-05,0,0,2
boris,13,2.39E-05,13,2.96E-05,0,0,2
baker,13,2.39E-05,13,2.96E-05,0,0,2
ocare,13,2.39E-05,13,2.96E-05,0,0,2
actual,13,2.39E-05,12,2.73E-05,9.47E-06,1,2
ticket,13,2.39E-05,10,2.28E-05,2.84E-05,3,2
adding,13,2.39E-05,9,2.05E-05,3.79E-05,4,2
storms,13,2.39E-05,11,2.51E-05,1.89E-05,2,1
status,13,2.39E-05,6,1.37E-05,6.63E-05,7,2
nelson,13,2.39E-05,7,1.59E-05,5.68E-05,6,2
daniel,13,2.39E-05,11,2.51E-05,1.89E-05,2,2
couple,13,2.39E-05,10,2.28E-05,2.84E-05,3,2
caucus,13,2.39E-05,11,2.51E-05,1.89E-05,2,2
expose,13,2.39E-05,13,2.96E-05,0,0,2
dumped,13,2.39E-05,13,2.96E-05,0,0,1
murphy,13,2.39E-05,13,2.96E-05,0,0,2
beaten,13,2.39E-05,13,2.96E-05,0,0,2
brazil,13,2.39E-05,13,2.96E-05,0,0,2
census,13,2.39E-05,13,2.96E-05,0,0,2
target,13,2.39E-05,13,2.96E-05,0,0,2
spoken,13,2.39E-05,13,2.96E-05,0,0,2
resist,13,2.39E-05,13,2.96E-05,0,0,2
mcgahn,13,2.39E-05,13,2.96E-05,0,0,1
jobless,13,2.39E-05,12,2.73E-05,9.47E-06,1,2
require,13,2.39E-05,3,6.83E-06,9.47E-05,10,2
natural,13,2.39E-05,11,2.51E-05,1.89E-05,2,3
options,13,2.39E-05,7,1.59E-05,5.68E-05,6,2
blocked,13,2.39E-05,8,1.82E-05,4.74E-05,5,1
central,13,2.39E-05,10,2.28E-05,2.84E-05,3,2
crashed,13,2.39E-05,5,1.14E-05,7.58E-05,8,1
article,13,2.39E-05,12,2.73E-05,9.47E-06,1,3
trading,13,2.39E-05,8,1.82E-05,4.74E-05,5,2
updates,13,2.39E-05,9,2.05E-05,3.79E-05,4,2
culture,13,2.39E-05,12,2.73E-05,9.47E-06,1,2
offered,13,2.39E-05,12,2.73E-05,9.47E-06,1,2
seeking,13,2.39E-05,13,2.96E-05,0,0,2
forming,13,2.39E-05,13,2.96E-05,0,0,2
ashamed,13,2.39E-05,13,2.96E-05,0,0,2
trumper,13,2.39E-05,13,2.96E-05,0,0,2
falsely,13,2.39E-05,13,2.96E-05,0,0,3
defends,13,2.39E-05,13,2.96E-05,0,0,2
pricing,13,2.39E-05,13,2.96E-05,0,0,2
admiral,13,2.39E-05,13,2.96E-05,0,0,3
concast,13,2.39E-05,13,2.96E-05,0,0,2
whoever,13,2.39E-05,13,2.96E-05,0,0,2
anthony,13,2.39E-05,13,2.96E-05,0,0,3
contact,13,2.39E-05,13,2.96E-05,0,0,2
missile,13,2.39E-05,13,2.96E-05,0,0,3
charging,13,2.39E-05,9,2.05E-05,3.79E-05,4,2
bankrupt,13,2.39E-05,0,0,0.000123147,13,2
accident,13,2.39E-05,11,2.51E-05,1.89E-05,2,3
extended,13,2.39E-05,12,2.73E-05,9.47E-06,1,2
saddened,13,2.39E-05,10,2.28E-05,2.84E-05,3,2
suburban,13,2.39E-05,13,2.96E-05,0,0,3
exposing,13,2.39E-05,13,2.96E-05,0,0,3
friendly,13,2.39E-05,13,2.96E-05,0,0,2
warriors,13,2.39E-05,13,2.96E-05,0,0,2
protests,13,2.39E-05,13,2.96E-05,0,0,2
although,13,2.39E-05,13,2.96E-05,0,0,2
unhinged,13,2.39E-05,13,2.96E-05,0,0,2
sheriffs,13,2.39E-05,13,2.96E-05,0,0,2
captured,13,2.39E-05,13,2.96E-05,0,0,2
horrific,13,2.39E-05,13,2.96E-05,0,0,3
midterms,13,2.39E-05,13,2.96E-05,0,0,2
treatment,13,2.39E-05,8,1.82E-05,4.74E-05,5,2
referring,13,2.39E-05,12,2.73E-05,9.47E-06,1,3
newspaper,13,2.39E-05,12,2.73E-05,9.47E-06,1,3
exclusive,13,2.39E-05,12,2.73E-05,9.47E-06,1,3
pensacola,13,2.39E-05,13,2.96E-05,0,0,4
broadcast,13,2.39E-05,13,2.96E-05,0,0,2
watergate,13,2.39E-05,13,2.96E-05,0,0,3
terminate,13,2.39E-05,13,2.96E-05,0,0,3
predicted,13,2.39E-05,13,2.96E-05,0,0,2
bilateral,13,2.39E-05,13,2.96E-05,0,0,4
addressing,13,2.39E-05,4,9.11E-06,8.53E-05,9,3
population,13,2.39E-05,9,2.05E-05,3.79E-05,4,4
ultimately,13,2.39E-05,11,2.51E-05,1.89E-05,2,5
associated,13,2.39E-05,12,2.73E-05,9.47E-06,1,3
discussion,13,2.39E-05,11,2.51E-05,1.89E-05,2,3
horrendous,13,2.39E-05,13,2.96E-05,0,0,3
apprentice,13,2.39E-05,13,2.96E-05,0,0,3
prosecutor,13,2.39E-05,13,2.96E-05,0,0,4
letting,13,2.39E-05,11,2.51E-05,1.89E-05,2,2
pell,13,2.39E-05,0,0,0.000123147,13,1
lilly,13,2.39E-05,0,0,0.000123147,13,2
williams,13,2.39E-05,12,2.73E-05,9.47E-06,1,2
basketball,13,2.39E-05,8,1.82E-05,4.74E-05,5,3
fundraising,13,2.39E-05,4,9.11E-06,8.53E-05,9,3
threatening,13,2.39E-05,7,1.59E-05,5.68E-05,6,3
inspiration,13,2.39E-05,6,1.37E-05,6.63E-05,7,4
appointment,13,2.39E-05,13,2.96E-05,0,0,3
keith,13,2.39E-05,13,2.96E-05,0,0,1
limits,13,2.39E-05,4,9.11E-06,8.53E-05,9,2
waited,13,2.39E-05,11,2.51E-05,1.89E-05,2,1
profits,13,2.39E-05,3,6.83E-06,9.47E-05,10,2
capitol,13,2.39E-05,9,2.05E-05,3.79E-05,4,3
pundits,13,2.39E-05,12,2.73E-05,9.47E-06,1,2
positions,13,2.39E-05,5,1.14E-05,7.58E-05,8,3
mother,13,2.39E-05,4,9.11E-06,8.53E-05,9,2
mortality,13,2.39E-05,13,2.96E-05,0,0,4
theyll,13,2.39E-05,8,1.82E-05,4.74E-05,5,1
overwhelming,13,2.39E-05,10,2.28E-05,2.84E-05,3,4
consequences,13,2.39E-05,11,2.51E-05,1.89E-05,2,3
commonwealth,13,2.39E-05,13,2.96E-05,0,0,3
mom,12,2.20E-05,3,6.83E-06,8.53E-05,9,1
mrs,12,2.20E-05,12,2.73E-05,0,0,1
bold,12,2.20E-05,9,2.05E-05,2.84E-05,3,1
grew,12,2.20E-05,6,1.37E-05,5.68E-05,6,1
seek,12,2.20E-05,10,2.28E-05,1.89E-05,2,1
roof,12,2.20E-05,8,1.82E-05,3.79E-05,4,1
wear,12,2.20E-05,9,2.05E-05,2.84E-05,3,1
main,12,2.20E-05,10,2.28E-05,1.89E-05,2,1
arab,12,2.20E-05,12,2.73E-05,0,0,2
flip,12,2.20E-05,12,2.73E-05,0,0,1
seal,12,2.20E-05,12,2.73E-05,0,0,1
pure,12,2.20E-05,12,2.73E-05,0,0,1
leak,12,2.20E-05,12,2.73E-05,0,0,1
opec,12,2.20E-05,12,2.73E-05,0,0,2
pols,12,2.20E-05,12,2.73E-05,0,0,1
icymi,12,2.20E-05,0,0,0.000113674,12,3
color,12,2.20E-05,7,1.59E-05,4.74E-05,5,2
youth,12,2.20E-05,8,1.82E-05,3.79E-05,4,1
girls,12,2.20E-05,1,2.28E-06,0.000104201,11,1
acted,12,2.20E-05,9,2.05E-05,2.84E-05,3,1
backs,12,2.20E-05,6,1.37E-05,5.68E-05,6,1
grant,12,2.20E-05,7,1.59E-05,4.74E-05,5,1
feels,12,2.20E-05,9,2.05E-05,2.84E-05,3,1
moves,12,2.20E-05,9,2.05E-05,2.84E-05,3,1
chair,12,2.20E-05,11,2.51E-05,9.47E-06,1,1
lunch,12,2.20E-05,9,2.05E-05,2.84E-05,3,1
plane,12,2.20E-05,11,2.51E-05,9.47E-06,1,1
harry,12,2.20E-05,12,2.73E-05,0,0,2
ocean,12,2.20E-05,12,2.73E-05,0,0,2
taxed,12,2.20E-05,12,2.73E-05,0,0,1
maria,12,2.20E-05,12,2.73E-05,0,0,2
laura,12,2.20E-05,12,2.73E-05,0,0,2
pages,12,2.20E-05,12,2.73E-05,0,0,1
cable,12,2.20E-05,12,2.73E-05,0,0,2
magic,12,2.20E-05,12,2.73E-05,0,0,2
mayors,12,2.20E-05,11,2.51E-05,9.47E-06,1,2
sooner,12,2.20E-05,10,2.28E-05,1.89E-05,2,2
womans,12,2.20E-05,0,0,0.000113674,12,2
burden,12,2.20E-05,5,1.14E-05,6.63E-05,7,2
loving,12,2.20E-05,11,2.51E-05,9.47E-06,1,2
affect,12,2.20E-05,2,4.56E-06,9.47E-05,10,2
winter,12,2.20E-05,8,1.82E-05,3.79E-05,4,2
soccer,12,2.20E-05,6,1.37E-05,5.68E-05,6,2
luxury,12,2.20E-05,1,2.28E-06,0.000104201,11,3
severe,12,2.20E-05,5,1.14E-05,6.63E-05,7,2
picked,12,2.20E-05,8,1.82E-05,3.79E-05,4,1
donors,12,2.20E-05,6,1.37E-05,5.68E-05,6,2
update,12,2.20E-05,9,2.05E-05,2.84E-05,3,2
openly,12,2.20E-05,8,1.82E-05,3.79E-05,4,3
nurses,12,2.20E-05,10,2.28E-05,1.89E-05,2,1
square,12,2.20E-05,12,2.73E-05,0,0,1
liddle,12,2.20E-05,12,2.73E-05,0,0,2
senior,12,2.20E-05,12,2.73E-05,0,0,2
deadly,12,2.20E-05,12,2.73E-05,0,0,2
mildly,12,2.20E-05,12,2.73E-05,0,0,2
slowly,12,2.20E-05,12,2.73E-05,0,0,2
murder,12,2.20E-05,12,2.73E-05,0,0,2
phones,12,2.20E-05,12,2.73E-05,0,0,1
sounds,12,2.20E-05,12,2.73E-05,0,0,1
macron,12,2.20E-05,12,2.73E-05,0,0,2
steyer,12,2.20E-05,12,2.73E-05,0,0,2
carter,12,2.20E-05,12,2.73E-05,0,0,2
endure,12,2.20E-05,12,2.73E-05,0,0,2
flying,12,2.20E-05,12,2.73E-05,0,0,1
merely,12,2.20E-05,12,2.73E-05,0,0,3
maxine,12,2.20E-05,12,2.73E-05,0,0,2
dorian,12,2.20E-05,12,2.73E-05,0,0,2
kicking,12,2.20E-05,4,9.11E-06,7.58E-05,8,2
longest,12,2.20E-05,6,1.37E-05,5.68E-05,6,2
destiny,12,2.20E-05,6,1.37E-05,5.68E-05,6,3
blessed,12,2.20E-05,9,2.05E-05,2.84E-05,3,1
embrace,12,2.20E-05,5,1.14E-05,6.63E-05,7,2
healthy,12,2.20E-05,7,1.59E-05,4.74E-05,5,2
achieve,12,2.20E-05,11,2.51E-05,9.47E-06,1,2
phoenix,12,2.20E-05,11,2.51E-05,9.47E-06,1,2
finance,12,2.20E-05,11,2.51E-05,9.47E-06,1,2
advance,12,2.20E-05,6,1.37E-05,5.68E-05,6,2
declare,12,2.20E-05,7,1.59E-05,4.74E-05,5,2
voucher,12,2.20E-05,0,0,0.000113674,12,2
exports,12,2.20E-05,8,1.82E-05,3.79E-05,4,2
bailout,12,2.20E-05,9,2.05E-05,2.84E-05,3,2
uranium,12,2.20E-05,11,2.51E-05,9.47E-06,1,3
consent,12,2.20E-05,12,2.73E-05,0,0,2
watcher,12,2.20E-05,12,2.73E-05,0,0,2
unhappy,12,2.20E-05,12,2.73E-05,0,0,3
fishing,12,2.20E-05,12,2.73E-05,0,0,2
foolish,12,2.20E-05,12,2.73E-05,0,0,2
comcast,12,2.20E-05,12,2.73E-05,0,0,2
threats,12,2.20E-05,12,2.73E-05,0,0,1
harvard,12,2.20E-05,12,2.73E-05,0,0,2
cemetery,12,2.20E-05,10,2.28E-05,1.89E-05,2,4
devotion,12,2.20E-05,11,2.51E-05,9.47E-06,1,3
epidemic,12,2.20E-05,11,2.51E-05,9.47E-06,1,4
included,12,2.20E-05,6,1.37E-05,5.68E-05,6,2
exercise,12,2.20E-05,11,2.51E-05,9.47E-06,1,3
nonsense,12,2.20E-05,11,2.51E-05,9.47E-06,1,2
proposal,12,2.20E-05,8,1.82E-05,3.79E-05,4,3
arkansas,12,2.20E-05,12,2.73E-05,0,0,3
underway,12,2.20E-05,12,2.73E-05,0,0,3
franklin,12,2.20E-05,12,2.73E-05,0,0,2
religion,12,2.20E-05,12,2.73E-05,0,0,3
weakness,12,2.20E-05,12,2.73E-05,0,0,2
limbaugh,12,2.20E-05,12,2.73E-05,0,0,2
defeated,12,2.20E-05,12,2.73E-05,0,0,2
language,12,2.20E-05,12,2.73E-05,0,0,2
desantis,12,2.20E-05,12,2.73E-05,0,0,3
lobbyist,12,2.20E-05,12,2.73E-05,0,0,2
migrants,12,2.20E-05,12,2.73E-05,0,0,2
florence,12,2.20E-05,12,2.73E-05,0,0,2
milestone,12,2.20E-05,6,1.37E-05,5.68E-05,6,3
cherished,12,2.20E-05,9,2.05E-05,2.84E-05,3,2
rewarding,12,2.20E-05,0,0,0.000113674,12,3
improving,12,2.20E-05,8,1.82E-05,3.79E-05,4,3
donations,12,2.20E-05,2,4.56E-06,9.47E-05,10,3
milwaukee,12,2.20E-05,9,2.05E-05,2.84E-05,3,3
explained,12,2.20E-05,11,2.51E-05,9.47E-06,1,2
suspended,12,2.20E-05,12,2.73E-05,0,0,2
soleimani,12,2.20E-05,12,2.73E-05,0,0,4
relations,12,2.20E-05,12,2.73E-05,0,0,3
massively,12,2.20E-05,12,2.73E-05,0,0,4
unpopular,12,2.20E-05,12,2.73E-05,0,0,4
intention,12,2.20E-05,12,2.73E-05,0,0,3
releasing,12,2.20E-05,12,2.73E-05,0,0,3
inspector,12,2.20E-05,12,2.73E-05,0,0,3
shootings,12,2.20E-05,12,2.73E-05,0,0,2
unrelated,12,2.20E-05,12,2.73E-05,0,0,3
ceasefire,12,2.20E-05,12,2.73E-05,0,0,3
remarkable,12,2.20E-05,8,1.82E-05,3.79E-05,4,4
prevention,12,2.20E-05,3,6.83E-06,8.53E-05,9,3
dedication,12,2.20E-05,8,1.82E-05,3.79E-05,4,4
interviews,12,2.20E-05,12,2.73E-05,0,0,3
negotiated,12,2.20E-05,12,2.73E-05,0,0,3
friendship,12,2.20E-05,12,2.73E-05,0,0,2
impeaching,12,2.20E-05,12,2.73E-05,0,0,3
hurricanes,12,2.20E-05,12,2.73E-05,0,0,3
danny,12,2.20E-05,11,2.51E-05,9.47E-06,1,2
attend,12,2.20E-05,10,2.28E-05,1.89E-05,2,2
hottest,12,2.20E-05,6,1.37E-05,5.68E-05,6,2
ledbetter,12,2.20E-05,0,0,0.000113674,12,3
filled,12,2.20E-05,5,1.14E-05,6.63E-05,7,1
colluded,12,2.20E-05,12,2.73E-05,0,0,2
muellers,12,2.20E-05,12,2.73E-05,0,0,2
personally,12,2.20E-05,10,2.28E-05,1.89E-05,2,4
potentially,12,2.20E-05,9,2.05E-05,2.84E-05,3,4
smith,12,2.20E-05,12,2.73E-05,0,0,1
consecutive,12,2.20E-05,2,4.56E-06,9.47E-05,10,4
legislators,12,2.20E-05,4,9.11E-06,7.58E-05,8,4
permanently,12,2.20E-05,10,2.28E-05,1.89E-05,2,4
significant,12,2.20E-05,11,2.51E-05,9.47E-06,1,4
embarrassed,12,2.20E-05,12,2.73E-05,0,0,3
journalists,12,2.20E-05,12,2.73E-05,0,0,3
admits,12,2.20E-05,12,2.73E-05,0,0,2
lightweight,12,2.20E-05,12,2.73E-05,0,0,2
traffickers,12,2.20E-05,12,2.73E-05,0,0,3
deductibles,12,2.20E-05,12,2.73E-05,0,0,4
dignity,12,2.20E-05,6,1.37E-05,5.68E-05,6,3
integrity,12,2.20E-05,9,2.05E-05,2.84E-05,3,4
territory,12,2.20E-05,12,2.73E-05,0,0,4
committees,12,2.20E-05,11,2.51E-05,9.47E-06,1,3
switzerland,12,2.20E-05,12,2.73E-05,0,0,3
weather,12,2.20E-05,9,2.05E-05,2.84E-05,3,2
breakthrough,12,2.20E-05,7,1.59E-05,4.74E-05,5,2
enthusiastic,12,2.20E-05,12,2.73E-05,0,0,4
environmental,12,2.20E-05,9,2.05E-05,2.84E-05,3,5
approximately,12,2.20E-05,11,2.51E-05,9.47E-06,1,6
organizations,12,2.20E-05,12,2.73E-05,0,0,5
correspondents,12,2.20E-05,6,1.37E-05,5.68E-05,6,4
wed,11,2.02E-05,3,6.83E-06,7.58E-05,8,1
bin,11,2.02E-05,5,1.14E-05,5.68E-05,6,1
nov,11,2.02E-05,7,1.59E-05,3.79E-05,4,1
box,11,2.02E-05,10,2.28E-05,9.47E-06,1,1
van,11,2.02E-05,11,2.51E-05,0,0,1
rod,11,2.02E-05,11,2.51E-05,0,0,1
door,11,2.02E-05,8,1.82E-05,2.84E-05,3,1
sons,11,2.02E-05,3,6.83E-06,7.58E-05,8,1
palm,11,2.02E-05,10,2.28E-05,9.47E-06,1,1
rudy,11,2.02E-05,11,2.51E-05,0,0,2
zone,11,2.02E-05,11,2.51E-05,0,0,1
visa,11,2.02E-05,11,2.51E-05,0,0,2
jury,11,2.02E-05,11,2.51E-05,0,0,2
crew,11,2.02E-05,11,2.51E-05,0,0,1
dirt,11,2.02E-05,11,2.51E-05,0,0,1
stars,11,2.02E-05,8,1.82E-05,2.84E-05,3,1
opens,11,2.02E-05,8,1.82E-05,2.84E-05,3,2
tears,11,2.02E-05,9,2.05E-05,1.89E-05,2,1
extra,11,2.02E-05,2,4.56E-06,8.53E-05,9,2
hikes,11,2.02E-05,7,1.59E-05,3.79E-05,4,1
email,11,2.02E-05,8,1.82E-05,2.84E-05,3,2
ought,11,2.02E-05,8,1.82E-05,2.84E-05,3,1
chant,11,2.02E-05,8,1.82E-05,2.84E-05,3,1
guest,11,2.02E-05,5,1.14E-05,5.68E-05,6,1
forum,11,2.02E-05,9,2.05E-05,1.89E-05,2,2
entry,11,2.02E-05,11,2.51E-05,0,0,2
races,11,2.02E-05,11,2.51E-05,0,0,1
squad,11,2.02E-05,11,2.51E-05,0,0,1
frame,11,2.02E-05,11,2.51E-05,0,0,1
stiff,11,2.02E-05,11,2.51E-05,0,0,1
mourn,11,2.02E-05,11,2.51E-05,0,0,1
doral,11,2.02E-05,11,2.51E-05,0,0,2
ruled,11,2.02E-05,11,2.51E-05,0,0,1
quote,11,2.02E-05,11,2.51E-05,0,0,1
tiger,11,2.02E-05,11,2.51E-05,0,0,2
memos,11,2.02E-05,11,2.51E-05,0,0,2
issued,11,2.02E-05,8,1.82E-05,2.84E-05,3,2
statue,11,2.02E-05,8,1.82E-05,2.84E-05,3,2
loudly,11,2.02E-05,9,2.05E-05,1.89E-05,2,2
honors,11,2.02E-05,4,9.11E-06,6.63E-05,7,2
sought,11,2.02E-05,10,2.28E-05,9.47E-06,1,1
belong,11,2.02E-05,7,1.59E-05,3.79E-05,4,2
breaks,11,2.02E-05,2,4.56E-06,8.53E-05,9,1
victim,11,2.02E-05,9,2.05E-05,1.89E-05,2,2
morgan,11,2.02E-05,7,1.59E-05,3.79E-05,4,2
option,11,2.02E-05,9,2.05E-05,1.89E-05,2,2
ruined,11,2.02E-05,11,2.51E-05,0,0,1
easing,11,2.02E-05,11,2.51E-05,0,0,2
chiefs,11,2.02E-05,11,2.51E-05,0,0,1
hilton,11,2.02E-05,11,2.51E-05,0,0,2
station,11,2.02E-05,9,2.05E-05,1.89E-05,2,2
resolve,11,2.02E-05,4,9.11E-06,6.63E-05,7,2
condemn,11,2.02E-05,9,2.05E-05,1.89E-05,2,2
demands,11,2.02E-05,10,2.28E-05,9.47E-06,1,2
reminds,11,2.02E-05,7,1.59E-05,3.79E-05,4,2
complex,11,2.02E-05,10,2.28E-05,9.47E-06,1,2
ordered,11,2.02E-05,9,2.05E-05,1.89E-05,2,2
outcome,11,2.02E-05,9,2.05E-05,1.89E-05,2,2
pacific,11,2.02E-05,10,2.28E-05,9.47E-06,1,3
passion,11,2.02E-05,10,2.28E-05,9.47E-06,1,2
virtual,11,2.02E-05,10,2.28E-05,9.47E-06,1,2
daytime,11,2.02E-05,11,2.51E-05,0,0,2
unified,11,2.02E-05,11,2.51E-05,0,0,3
hacking,11,2.02E-05,11,2.51E-05,0,0,2
beating,11,2.02E-05,11,2.51E-05,0,0,2
mexican,11,2.02E-05,11,2.51E-05,0,0,3
hostile,11,2.02E-05,11,2.51E-05,0,0,3
counter,11,2.02E-05,11,2.51E-05,0,0,2
leakers,11,2.02E-05,11,2.51E-05,0,0,2
brunson,11,2.02E-05,11,2.51E-05,0,0,2
dropping,11,2.02E-05,10,2.28E-05,9.47E-06,1,2
training,11,2.02E-05,6,1.37E-05,4.74E-05,5,2
concrete,11,2.02E-05,8,1.82E-05,2.84E-05,3,2
listened,11,2.02E-05,9,2.05E-05,1.89E-05,2,2
precious,11,2.02E-05,8,1.82E-05,2.84E-05,3,3
overturn,11,2.02E-05,10,2.28E-05,9.47E-06,1,3
nominate,11,2.02E-05,10,2.28E-05,9.47E-06,1,3
trending,11,2.02E-05,11,2.51E-05,0,0,2
violated,11,2.02E-05,11,2.51E-05,0,0,2
treasure,11,2.02E-05,11,2.51E-05,0,0,2
somewhat,11,2.02E-05,11,2.51E-05,0,0,3
depleted,11,2.02E-05,11,2.51E-05,0,0,2
requests,11,2.02E-05,11,2.51E-05,0,0,2
manafort,11,2.02E-05,11,2.51E-05,0,0,3
fraction,11,2.02E-05,11,2.51E-05,0,0,2
salvador,11,2.02E-05,11,2.51E-05,0,0,3
determine,11,2.02E-05,7,1.59E-05,3.79E-05,4,3
welcoming,11,2.02E-05,6,1.37E-05,4.74E-05,5,3
wednesday,11,2.02E-05,8,1.82E-05,2.84E-05,3,3
restoring,11,2.02E-05,4,9.11E-06,6.63E-05,7,3
educators,11,2.02E-05,5,1.14E-05,5.68E-05,6,4
proposing,11,2.02E-05,5,1.14E-05,5.68E-05,6,3
campaigns,11,2.02E-05,8,1.82E-05,2.84E-05,3,2
subsidies,11,2.02E-05,5,1.14E-05,5.68E-05,6,3
francisco,11,2.02E-05,10,2.28E-05,9.47E-06,1,3
patriotic,11,2.02E-05,10,2.28E-05,9.47E-06,1,3
envelopes,11,2.02E-05,11,2.51E-05,0,0,3
factories,11,2.02E-05,11,2.51E-05,0,0,3
legendary,11,2.02E-05,11,2.51E-05,0,0,4
disparage,11,2.02E-05,11,2.51E-05,0,0,3
foolishly,11,2.02E-05,11,2.51E-05,0,0,3
jerusalem,11,2.02E-05,11,2.51E-05,0,0,4
correctly,11,2.02E-05,11,2.51E-05,0,0,3
sacrifices,11,2.02E-05,4,9.11E-06,6.63E-05,7,3
nationwide,11,2.02E-05,6,1.37E-05,4.74E-05,5,3
understood,11,2.02E-05,10,2.28E-05,9.47E-06,1,3
campaigned,11,2.02E-05,10,2.28E-05,9.47E-06,1,2
percentage,11,2.02E-05,9,2.05E-05,1.89E-05,2,3
treasonous,11,2.02E-05,11,2.51E-05,0,0,3
helicopter,11,2.02E-05,11,2.51E-05,0,0,4
supposedly,11,2.02E-05,11,2.51E-05,0,0,4
propaganda,11,2.02E-05,11,2.51E-05,0,0,4
announces,11,2.02E-05,4,9.11E-06,6.63E-05,7,2
connecticut,11,2.02E-05,11,2.51E-05,0,0,4
buffett,11,2.02E-05,0,0,0.000104201,11,2
ball,11,2.02E-05,8,1.82E-05,2.84E-05,3,1
ally,11,2.02E-05,11,2.51E-05,0,0,2
gallup,11,2.02E-05,11,2.51E-05,0,0,2
unwilling,11,2.02E-05,11,2.51E-05,0,0,3
intellectual,11,2.02E-05,10,2.28E-05,9.47E-06,1,4
stupidity,11,2.02E-05,11,2.51E-05,0,0,4
criticized,11,2.02E-05,9,2.05E-05,1.89E-05,2,3
hitting,11,2.02E-05,9,2.05E-05,1.89E-05,2,2
possibility,11,2.02E-05,10,2.28E-05,9.47E-06,1,5
marketplace,11,2.02E-05,0,0,0.000104201,11,3
individuals,11,2.02E-05,9,2.05E-05,1.89E-05,2,4
partnership,11,2.02E-05,10,2.28E-05,9.47E-06,1,3
cooperation,11,2.02E-05,11,2.51E-05,0,0,4
agriculture,11,2.02E-05,11,2.51E-05,0,0,4
declaration,11,2.02E-05,11,2.51E-05,0,0,4
disappeared,11,2.02E-05,11,2.51E-05,0,0,3
ambassadors,11,2.02E-05,11,2.51E-05,0,0,4
theft,11,2.02E-05,11,2.51E-05,0,0,1
strengthening,11,2.02E-05,7,1.59E-05,3.79E-05,4,3
unacceptable,11,2.02E-05,9,2.05E-05,1.89E-05,2,5
appreciation,11,2.02E-05,7,1.59E-05,3.79E-05,4,4
commissioner,11,2.02E-05,11,2.51E-05,0,0,4
disinformation,11,2.02E-05,10,2.28E-05,9.47E-06,1,5
obstructionist,11,2.02E-05,11,2.51E-05,0,0,4
mad,10,1.84E-05,8,1.82E-05,1.89E-05,2,1
dad,10,1.84E-05,4,9.11E-06,5.68E-05,6,1
roe,10,1.84E-05,2,4.56E-06,7.58E-05,8,1
tea,10,1.84E-05,0,0,9.47E-05,10,1
jet,10,1.84E-05,10,2.28E-05,0,0,1
mob,10,1.84E-05,10,2.28E-05,0,0,1
runs,10,1.84E-05,9,2.05E-05,9.47E-06,1,1
wade,10,1.84E-05,2,4.56E-06,7.58E-05,8,1
ties,10,1.84E-05,9,2.05E-05,9.47E-06,1,1
fred,10,1.84E-05,9,2.05E-05,9.47E-06,1,#ERROR!
kick,10,1.84E-05,6,1.37E-05,3.79E-05,4,1
nuts,10,1.84E-05,9,2.05E-05,9.47E-06,1,1
govt,10,1.84E-05,9,2.05E-05,9.47E-06,1,1
wing,10,1.84E-05,7,1.59E-05,2.84E-05,3,1
jews,10,1.84E-05,9,2.05E-05,9.47E-06,1,1
tony,10,1.84E-05,10,2.28E-05,0,0,2
cure,10,1.84E-05,10,2.28E-05,0,0,1
bail,10,1.84E-05,10,2.28E-05,0,0,1
lake,10,1.84E-05,10,2.28E-05,0,0,1
dana,10,1.84E-05,10,2.28E-05,0,0,2
iron,10,1.84E-05,10,2.28E-05,0,0,2
blow,10,1.84E-05,10,2.28E-05,0,0,1
memo,10,1.84E-05,10,2.28E-05,0,0,2
dark,10,1.84E-05,10,2.28E-05,0,0,1
tate,10,1.84E-05,10,2.28E-05,0,0,1
zones,10,1.84E-05,8,1.82E-05,1.89E-05,2,1
lynch,10,1.84E-05,8,1.82E-05,1.89E-05,2,1
meant,10,1.84E-05,7,1.59E-05,2.84E-05,3,1
moral,10,1.84E-05,3,6.83E-06,6.63E-05,7,2
plays,10,1.84E-05,7,1.59E-05,2.84E-05,3,1
grace,10,1.84E-05,6,1.37E-05,3.79E-05,4,1
laden,10,1.84E-05,5,1.14E-05,4.74E-05,5,2
alive,10,1.84E-05,8,1.82E-05,1.89E-05,2,2
stops,10,1.84E-05,9,2.05E-05,9.47E-06,1,1
pearl,10,1.84E-05,9,2.05E-05,9.47E-06,1,1
floyd,10,1.84E-05,10,2.28E-05,0,0,1
newly,10,1.84E-05,10,2.28E-05,0,0,2
larry,10,1.84E-05,10,2.28E-05,0,0,2
empty,10,1.84E-05,10,2.28E-05,0,0,2
rinos,10,1.84E-05,10,2.28E-05,0,0,2
katie,10,1.84E-05,10,2.28E-05,0,0,2
hunts,10,1.84E-05,10,2.28E-05,0,0,1
rapid,10,1.84E-05,10,2.28E-05,0,0,2
heavy,10,1.84E-05,10,2.28E-05,0,0,2
davos,10,1.84E-05,10,2.28E-05,0,0,2
gregg,10,1.84E-05,10,2.28E-05,0,0,1
flight,10,1.84E-05,8,1.82E-05,1.89E-05,2,1
counts,10,1.84E-05,8,1.82E-05,1.89E-05,2,1
decent,10,1.84E-05,3,6.83E-06,6.63E-05,7,2
museum,10,1.84E-05,6,1.37E-05,3.79E-05,4,2
bought,10,1.84E-05,7,1.59E-05,2.84E-05,3,1
shared,10,1.84E-05,6,1.37E-05,3.79E-05,4,1
brutal,10,1.84E-05,9,2.05E-05,9.47E-06,1,2
magnet,10,1.84E-05,2,4.56E-06,7.58E-05,8,2
stance,10,1.84E-05,8,1.82E-05,1.89E-05,2,1
hiding,10,1.84E-05,7,1.59E-05,2.84E-05,3,2
stores,10,1.84E-05,8,1.82E-05,1.89E-05,2,1
chosen,10,1.84E-05,8,1.82E-05,1.89E-05,2,2
fulton,10,1.84E-05,10,2.28E-05,0,0,2
margin,10,1.84E-05,10,2.28E-05,0,0,2
flawed,10,1.84E-05,10,2.28E-05,0,0,1
unsafe,10,1.84E-05,10,2.28E-05,0,0,2
hacked,10,1.84E-05,10,2.28E-05,0,0,1
hawley,10,1.84E-05,10,2.28E-05,0,0,2
sweden,10,1.84E-05,10,2.28E-05,0,0,2
begged,10,1.84E-05,10,2.28E-05,0,0,1
assets,10,1.84E-05,10,2.28E-05,0,0,2
handed,10,1.84E-05,10,2.28E-05,0,0,1
richer,10,1.84E-05,10,2.28E-05,0,0,2
effects,10,1.84E-05,2,4.56E-06,7.58E-05,8,2
marines,10,1.84E-05,8,1.82E-05,1.89E-05,2,2
claimed,10,1.84E-05,7,1.59E-05,2.84E-05,3,1
inspire,10,1.84E-05,8,1.82E-05,1.89E-05,2,2
belongs,10,1.84E-05,5,1.14E-05,4.74E-05,5,2
hardest,10,1.84E-05,3,6.83E-06,6.63E-05,7,2
several,10,1.84E-05,7,1.59E-05,2.84E-05,3,3
prepare,10,1.84E-05,6,1.37E-05,3.79E-05,4,2
houston,10,1.84E-05,9,2.05E-05,9.47E-06,1,2
compete,10,1.84E-05,7,1.59E-05,2.84E-05,3,2
pledged,10,1.84E-05,6,1.37E-05,3.79E-05,4,1
worship,10,1.84E-05,9,2.05E-05,9.47E-06,1,2
enjoyed,10,1.84E-05,8,1.82E-05,1.89E-05,2,2
fashion,10,1.84E-05,9,2.05E-05,9.47E-06,1,2
outrage,10,1.84E-05,9,2.05E-05,9.47E-06,1,2
silence,10,1.84E-05,7,1.59E-05,2.84E-05,3,2
bahrain,10,1.84E-05,10,2.28E-05,0,0,2
recount,10,1.84E-05,10,2.28E-05,0,0,2
laughed,10,1.84E-05,10,2.28E-05,0,0,1
roaring,10,1.84E-05,10,2.28E-05,0,0,2
lowlife,10,1.84E-05,10,2.28E-05,0,0,2
engaged,10,1.84E-05,10,2.28E-05,0,0,2
kenosha,10,1.84E-05,10,2.28E-05,0,0,3
taliban,10,1.84E-05,10,2.28E-05,0,0,3
ripping,10,1.84E-05,10,2.28E-05,0,0,2
suggest,10,1.84E-05,10,2.28E-05,0,0,2
accused,10,1.84E-05,10,2.28E-05,0,0,2
brandon,10,1.84E-05,10,2.28E-05,0,0,2
outlets,10,1.84E-05,10,2.28E-05,0,0,2
bongino,10,1.84E-05,10,2.28E-05,0,0,3
inquiry,10,1.84E-05,10,2.28E-05,0,0,3
bahamas,10,1.84E-05,10,2.28E-05,0,0,3
donation,10,1.84E-05,1,2.28E-06,8.53E-05,9,3
momentum,10,1.84E-05,4,9.11E-06,5.68E-05,6,3
rejected,10,1.84E-05,9,2.05E-05,9.47E-06,1,2
pipeline,10,1.84E-05,3,6.83E-06,6.63E-05,7,3
graduate,10,1.84E-05,7,1.59E-05,2.84E-05,3,2
maintain,10,1.84E-05,7,1.59E-05,2.84E-05,3,2
entirely,10,1.84E-05,9,2.05E-05,9.47E-06,1,4
constant,10,1.84E-05,9,2.05E-05,9.47E-06,1,2
preserve,10,1.84E-05,9,2.05E-05,9.47E-06,1,2
speeches,10,1.84E-05,7,1.59E-05,2.84E-05,3,1
airports,10,1.84E-05,8,1.82E-05,1.89E-05,2,2
traveled,10,1.84E-05,3,6.83E-06,6.63E-05,7,2
ultimate,10,1.84E-05,8,1.82E-05,1.89E-05,2,3
sticking,10,1.84E-05,4,9.11E-06,5.68E-05,6,2
explains,10,1.84E-05,0,0,9.47E-05,10,2
earnings,10,1.84E-05,8,1.82E-05,1.89E-05,2,2
pictures,10,1.84E-05,9,2.05E-05,9.47E-06,1,2
analysis,10,1.84E-05,10,2.28E-05,0,0,4
kneeling,10,1.84E-05,10,2.28E-05,0,0,2
concerns,10,1.84E-05,10,2.28E-05,0,0,2
employed,10,1.84E-05,10,2.28E-05,0,0,2
directed,10,1.84E-05,10,2.28E-05,0,0,2
parkland,10,1.84E-05,10,2.28E-05,0,0,2
dialogue,10,1.84E-05,10,2.28E-05,0,0,3
subpoena,10,1.84E-05,10,2.28E-05,0,0,3
electric,10,1.84E-05,10,2.28E-05,0,0,3
backwards,10,1.84E-05,4,9.11E-06,5.68E-05,6,2
economies,10,1.84E-05,7,1.59E-05,2.84E-05,3,4
expansion,10,1.84E-05,2,4.56E-06,7.58E-05,8,3
spreading,10,1.84E-05,9,2.05E-05,9.47E-06,1,2
qualified,10,1.84E-05,8,1.82E-05,1.89E-05,2,3
unchecked,10,1.84E-05,9,2.05E-05,9.47E-06,1,2
overrated,10,1.84E-05,10,2.28E-05,0,0,3
presented,10,1.84E-05,10,2.28E-05,0,0,2
districts,10,1.84E-05,10,2.28E-05,0,0,2
abandoned,10,1.84E-05,10,2.28E-05,0,0,3
fashioned,10,1.84E-05,10,2.28E-05,0,0,2
guatemala,10,1.84E-05,10,2.28E-05,0,0,4
overturned,10,1.84E-05,9,2.05E-05,9.47E-06,1,3
recipients,10,1.84E-05,8,1.82E-05,1.89E-05,2,3
reductions,10,1.84E-05,10,2.28E-05,0,0,3
misconduct,10,1.84E-05,10,2.28E-05,0,0,3
sympathies,10,1.84E-05,10,2.28E-05,0,0,3
reciprocal,10,1.84E-05,10,2.28E-05,0,0,4
banning,10,1.84E-05,5,1.14E-05,4.74E-05,5,2
button,10,1.84E-05,6,1.37E-05,3.79E-05,4,2
battles,10,1.84E-05,9,2.05E-05,9.47E-06,1,2
barletta,10,1.84E-05,10,2.28E-05,0,0,3
killer,10,1.84E-05,9,2.05E-05,9.47E-06,1,2
enroll,10,1.84E-05,0,0,9.47E-05,10,2
collapse,10,1.84E-05,7,1.59E-05,2.84E-05,3,2
challenged,10,1.84E-05,7,1.59E-05,2.84E-05,3,2
sits,10,1.84E-05,6,1.37E-05,3.79E-05,4,1
editor,10,1.84E-05,9,2.05E-05,9.47E-06,1,3
monitor,10,1.84E-05,10,2.28E-05,0,0,3
thereby,10,1.84E-05,10,2.28E-05,0,0,3
necessity,10,1.84E-05,4,9.11E-06,5.68E-05,6,4
gratitude,10,1.84E-05,8,1.82E-05,1.89E-05,2,3
liability,10,1.84E-05,10,2.28E-05,0,0,4
criticize,10,1.84E-05,10,2.28E-05,0,0,3
submitted,10,1.84E-05,9,2.05E-05,9.47E-06,1,2
unsolicited,10,1.84E-05,10,2.28E-05,0,0,4
accountability,10,1.84E-05,10,2.28E-05,0,0,6
unthinkable,10,1.84E-05,9,2.05E-05,9.47E-06,1,4
philippines,10,1.84E-05,9,2.05E-05,9.47E-06,1,3
meaningless,10,1.84E-05,8,1.82E-05,1.89E-05,2,3
incorrectly,10,1.84E-05,10,2.28E-05,0,0,4
replacement,10,1.84E-05,10,2.28E-05,0,0,4
apprehended,10,1.84E-05,10,2.28E-05,0,0,3
command,10,1.84E-05,10,2.28E-05,0,0,2
recommended,10,1.84E-05,9,2.05E-05,9.47E-06,1,3
manufactured,10,1.84E-05,7,1.59E-05,2.84E-05,3,4
undocumented,10,1.84E-05,2,4.56E-06,7.58E-05,8,4
registration,10,1.84E-05,3,6.83E-06,6.63E-05,7,4
coordination,10,1.84E-05,10,2.28E-05,0,0,4
catastrophic,10,1.84E-05,10,2.28E-05,0,0,4
controversial,10,1.84E-05,4,9.11E-06,5.68E-05,6,4
determination,10,1.84E-05,9,2.05E-05,9.47E-06,1,5
obstructionists,10,1.84E-05,10,2.28E-05,0,0,4
epa,9,1.65E-05,8,1.82E-05,9.47E-06,1,1
vet,9,1.65E-05,8,1.82E-05,9.47E-06,1,1
map,9,1.65E-05,3,6.83E-06,5.68E-05,6,1
rnc,9,1.65E-05,8,1.82E-05,9.47E-06,1,1
art,9,1.65E-05,6,1.37E-05,2.84E-05,3,1
fda,9,1.65E-05,9,2.05E-05,0,0,1
wsj,9,1.65E-05,9,2.05E-05,0,0,1
lays,9,1.65E-05,0,0,8.53E-05,9,1
nine,9,1.65E-05,2,4.56E-06,6.63E-05,7,1
nasa,9,1.65E-05,5,1.14E-05,3.79E-05,4,2
cuba,9,1.65E-05,8,1.82E-05,9.47E-06,1,2
gina,9,1.65E-05,8,1.82E-05,9.47E-06,1,2
size,9,1.65E-05,8,1.82E-05,9.47E-06,1,1
ruin,9,1.65E-05,8,1.82E-05,9.47E-06,1,1
scum,9,1.65E-05,9,2.05E-05,0,0,1
regs,9,1.65E-05,9,2.05E-05,0,0,1
plot,9,1.65E-05,9,2.05E-05,0,0,1
sued,9,1.65E-05,9,2.05E-05,0,0,1
soul,9,1.65E-05,9,2.05E-05,0,0,1
guts,9,1.65E-05,9,2.05E-05,0,0,1
dept,9,1.65E-05,9,2.05E-05,0,0,1
acid,9,1.65E-05,9,2.05E-05,0,0,2
envy,9,1.65E-05,9,2.05E-05,0,0,2
sight,9,1.65E-05,6,1.37E-05,2.84E-05,3,1
clock,9,1.65E-05,4,9.11E-06,4.74E-05,5,1
prize,9,1.65E-05,7,1.59E-05,1.89E-05,2,1
movie,9,1.65E-05,5,1.14E-05,3.79E-05,4,2
hurts,9,1.65E-05,7,1.59E-05,1.89E-05,2,1
aware,9,1.65E-05,8,1.82E-05,9.47E-06,1,2
score,9,1.65E-05,5,1.14E-05,3.79E-05,4,1
fails,9,1.65E-05,8,1.82E-05,9.47E-06,1,1
tampa,9,1.65E-05,7,1.59E-05,1.89E-05,2,2
winds,9,1.65E-05,8,1.82E-05,9.47E-06,1,1
model,9,1.65E-05,7,1.59E-05,1.89E-05,2,2
block,9,1.65E-05,5,1.14E-05,3.79E-05,4,1
hopes,9,1.65E-05,7,1.59E-05,1.89E-05,2,1
mouth,9,1.65E-05,8,1.82E-05,9.47E-06,1,1
fauci,9,1.65E-05,9,2.05E-05,0,0,2
cheat,9,1.65E-05,9,2.05E-05,0,0,1
notes,9,1.65E-05,9,2.05E-05,0,0,1
flags,9,1.65E-05,9,2.05E-05,0,0,1
pilot,9,1.65E-05,9,2.05E-05,0,0,2
hater,9,1.65E-05,9,2.05E-05,0,0,2
hated,9,1.65E-05,9,2.05E-05,0,0,1
corey,9,1.65E-05,9,2.05E-05,0,0,2
admin,9,1.65E-05,9,2.05E-05,0,0,2
ralph,9,1.65E-05,9,2.05E-05,0,0,1
trick,9,1.65E-05,9,2.05E-05,0,0,1
hanoi,9,1.65E-05,9,2.05E-05,0,0,2
active,9,1.65E-05,5,1.14E-05,3.79E-05,4,2
streak,9,1.65E-05,3,6.83E-06,5.68E-05,6,1
salary,9,1.65E-05,8,1.82E-05,9.47E-06,1,3
stayed,9,1.65E-05,7,1.59E-05,1.89E-05,2,1
pursue,9,1.65E-05,5,1.14E-05,3.79E-05,4,2
thrive,9,1.65E-05,8,1.82E-05,9.47E-06,1,1
autism,9,1.65E-05,6,1.37E-05,2.84E-05,3,2
thomas,9,1.65E-05,7,1.59E-05,1.89E-05,2,2
borrow,9,1.65E-05,6,1.37E-05,2.84E-05,3,2
toledo,9,1.65E-05,4,9.11E-06,4.74E-05,5,3
boeing,9,1.65E-05,7,1.59E-05,1.89E-05,2,2
quotes,9,1.65E-05,8,1.82E-05,9.47E-06,1,1
harbor,9,1.65E-05,8,1.82E-05,9.47E-06,1,2
perdue,9,1.65E-05,9,2.05E-05,0,0,2
guests,9,1.65E-05,9,2.05E-05,0,0,1
anchor,9,1.65E-05,9,2.05E-05,0,0,2
detail,9,1.65E-05,9,2.05E-05,0,0,2
hardly,9,1.65E-05,9,2.05E-05,0,0,2
assume,9,1.65E-05,9,2.05E-05,0,0,2
normal,9,1.65E-05,9,2.05E-05,0,0,2
yearly,9,1.65E-05,9,2.05E-05,0,0,2
arrest,9,1.65E-05,9,2.05E-05,0,0,2
filthy,9,1.65E-05,9,2.05E-05,0,0,2
backed,9,1.65E-05,9,2.05E-05,0,0,1
leakin,9,1.65E-05,9,2.05E-05,0,0,2
tanked,9,1.65E-05,9,2.05E-05,0,0,1
lasting,9,1.65E-05,5,1.14E-05,3.79E-05,4,2
cheaper,9,1.65E-05,5,1.14E-05,3.79E-05,4,2
creates,9,1.65E-05,6,1.37E-05,2.84E-05,3,1
bridges,9,1.65E-05,5,1.14E-05,3.79E-05,4,1
earning,9,1.65E-05,0,0,8.53E-05,9,2
abandon,9,1.65E-05,6,1.37E-05,2.84E-05,3,3
soldier,9,1.65E-05,7,1.59E-05,1.89E-05,2,2
sharing,9,1.65E-05,3,6.83E-06,5.68E-05,6,2
newtown,9,1.65E-05,1,2.28E-06,7.58E-05,8,2
familys,9,1.65E-05,1,2.28E-06,7.58E-05,8,3
hashtag,9,1.65E-05,1,2.28E-06,7.58E-05,8,2
madison,9,1.65E-05,6,1.37E-05,2.84E-05,3,3
compare,9,1.65E-05,6,1.37E-05,2.84E-05,3,2
expense,9,1.65E-05,6,1.37E-05,2.84E-05,3,2
bonuses,9,1.65E-05,7,1.59E-05,1.89E-05,2,2
maximum,9,1.65E-05,8,1.82E-05,9.47E-06,1,3
imposed,9,1.65E-05,8,1.82E-05,9.47E-06,1,2
centers,9,1.65E-05,8,1.82E-05,9.47E-06,1,2
burning,9,1.65E-05,8,1.82E-05,9.47E-06,1,2
certify,9,1.65E-05,9,2.05E-05,0,0,3
atlanta,9,1.65E-05,9,2.05E-05,0,0,3
tainted,9,1.65E-05,9,2.05E-05,0,0,1
proceed,9,1.65E-05,9,2.05E-05,0,0,2
besides,9,1.65E-05,9,2.05E-05,0,0,2
flowing,9,1.65E-05,9,2.05E-05,0,0,2
funeral,9,1.65E-05,9,2.05E-05,0,0,3
proving,9,1.65E-05,9,2.05E-05,0,0,2
begging,9,1.65E-05,9,2.05E-05,0,0,2
managed,9,1.65E-05,9,2.05E-05,0,0,2
omarosa,9,1.65E-05,9,2.05E-05,0,0,4
jinping,9,1.65E-05,9,2.05E-05,0,0,2
broward,9,1.65E-05,9,2.05E-05,0,0,2
cartels,9,1.65E-05,9,2.05E-05,0,0,2
holidays,9,1.65E-05,3,6.83E-06,5.68E-05,6,3
eligible,9,1.65E-05,1,2.28E-06,7.58E-05,8,4
invested,9,1.65E-05,4,9.11E-06,4.74E-05,5,2
pentagon,9,1.65E-05,7,1.59E-05,1.89E-05,2,3
glorious,9,1.65E-05,8,1.82E-05,9.47E-06,1,3
focusing,9,1.65E-05,6,1.37E-05,2.84E-05,3,3
dreamers,9,1.65E-05,1,2.28E-06,7.58E-05,8,2
measures,9,1.65E-05,5,1.14E-05,3.79E-05,4,2
founding,9,1.65E-05,5,1.14E-05,3.79E-05,4,2
backward,9,1.65E-05,0,0,8.53E-05,9,2
wasteful,9,1.65E-05,6,1.37E-05,2.84E-05,3,3
whenever,9,1.65E-05,6,1.37E-05,2.84E-05,3,3
shopping,9,1.65E-05,3,6.83E-06,5.68E-05,6,2
purchase,9,1.65E-05,8,1.82E-05,9.47E-06,1,2
confront,9,1.65E-05,8,1.82E-05,9.47E-06,1,2
severely,9,1.65E-05,4,9.11E-06,4.74E-05,5,4
specific,9,1.65E-05,5,1.14E-05,3.79E-05,4,3
convince,9,1.65E-05,6,1.37E-05,2.84E-05,3,2
disagree,9,1.65E-05,7,1.59E-05,1.89E-05,2,3
platform,9,1.65E-05,8,1.82E-05,9.47E-06,1,2
impacted,9,1.65E-05,8,1.82E-05,9.47E-06,1,2
respects,9,1.65E-05,8,1.82E-05,9.47E-06,1,2
secretly,9,1.65E-05,8,1.82E-05,9.47E-06,1,3
cheating,9,1.65E-05,9,2.05E-05,0,0,2
crushing,9,1.65E-05,9,2.05E-05,0,0,2
counties,9,1.65E-05,9,2.05E-05,0,0,2
atlantic,9,1.65E-05,9,2.05E-05,0,0,3
vacation,9,1.65E-05,9,2.05E-05,0,0,3
blakeman,9,1.65E-05,9,2.05E-05,0,0,3
founders,9,1.65E-05,9,2.05E-05,0,0,2
zelensky,9,1.65E-05,9,2.05E-05,0,0,3
syndrome,9,1.65E-05,9,2.05E-05,0,0,2
pakistan,9,1.65E-05,9,2.05E-05,0,0,3
behavior,9,1.65E-05,9,2.05E-05,0,0,3
churches,9,1.65E-05,9,2.05E-05,0,0,1
internal,9,1.65E-05,9,2.05E-05,0,0,3
starving,9,1.65E-05,9,2.05E-05,0,0,2
opposing,9,1.65E-05,9,2.05E-05,0,0,3
opinions,9,1.65E-05,9,2.05E-05,0,0,3
permanent,9,1.65E-05,6,1.37E-05,2.84E-05,3,3
workplace,9,1.65E-05,2,4.56E-06,6.63E-05,7,2
childhood,9,1.65E-05,0,0,8.53E-05,9,2
awareness,9,1.65E-05,3,6.83E-06,5.68E-05,6,4
wildfires,9,1.65E-05,7,1.59E-05,1.89E-05,2,2
impressed,9,1.65E-05,8,1.82E-05,9.47E-06,1,2
principle,9,1.65E-05,5,1.14E-05,3.79E-05,4,3
developed,9,1.65E-05,8,1.82E-05,9.47E-06,1,3
holocaust,9,1.65E-05,8,1.82E-05,9.47E-06,1,3
extension,9,1.65E-05,7,1.59E-05,1.89E-05,2,3
penalties,9,1.65E-05,8,1.82E-05,9.47E-06,1,3
producing,9,1.65E-05,8,1.82E-05,9.47E-06,1,3
projected,9,1.65E-05,9,2.05E-05,0,0,2
elsewhere,9,1.65E-05,9,2.05E-05,0,0,3
interfere,9,1.65E-05,9,2.05E-05,0,0,3
replacing,9,1.65E-05,9,2.05E-05,0,0,3
australia,9,1.65E-05,9,2.05E-05,0,0,3
informant,9,1.65E-05,9,2.05E-05,0,0,3
manner,9,1.65E-05,9,2.05E-05,0,0,2
unnamed,9,1.65E-05,9,2.05E-05,0,0,2
homeowners,9,1.65E-05,1,2.28E-06,7.58E-05,8,3
regardless,9,1.65E-05,7,1.59E-05,1.89E-05,2,3
retirement,9,1.65E-05,4,9.11E-06,4.74E-05,5,4
patriotism,9,1.65E-05,5,1.14E-05,3.79E-05,4,3
christians,9,1.65E-05,6,1.37E-05,2.84E-05,3,2
represents,9,1.65E-05,7,1.59E-05,1.89E-05,2,3
resistance,9,1.65E-05,8,1.82E-05,9.47E-06,1,3
parenthood,9,1.65E-05,2,4.56E-06,6.63E-05,7,3
outrageous,9,1.65E-05,8,1.82E-05,9.47E-06,1,4
socialists,9,1.65E-05,9,2.05E-05,0,0,3
developing,9,1.65E-05,9,2.05E-05,0,0,4
directions,9,1.65E-05,9,2.05E-05,0,0,3
respectful,9,1.65E-05,9,2.05E-05,0,0,3
violations,9,1.65E-05,9,2.05E-05,0,0,3
annapolis,9,1.65E-05,9,2.05E-05,0,0,4
otto,9,1.65E-05,9,2.05E-05,0,0,2
letters,9,1.65E-05,5,1.14E-05,3.79E-05,4,2
barrett,9,1.65E-05,8,1.82E-05,9.47E-06,1,2
jarrett,9,1.65E-05,9,2.05E-05,0,0,2
attacked,9,1.65E-05,8,1.82E-05,9.47E-06,1,2
sally,9,1.65E-05,8,1.82E-05,9.47E-06,1,2
fulfill,9,1.65E-05,5,1.14E-05,3.79E-05,4,2
william,9,1.65E-05,8,1.82E-05,9.47E-06,1,2
darrell,9,1.65E-05,9,2.05E-05,0,0,2
mentally,9,1.65E-05,8,1.82E-05,9.47E-06,1,3
trillions,9,1.65E-05,9,2.05E-05,0,0,2
allegiance,9,1.65E-05,8,1.82E-05,9.47E-06,1,3
dramatically,9,1.65E-05,9,2.05E-05,0,0,5
limit,9,1.65E-05,2,4.56E-06,6.63E-05,7,2
profit,9,1.65E-05,5,1.14E-05,3.79E-05,4,2
writes,9,1.65E-05,7,1.59E-05,1.89E-05,2,1
visited,9,1.65E-05,6,1.37E-05,2.84E-05,3,2
minority,9,1.65E-05,6,1.37E-05,2.84E-05,3,4
activity,9,1.65E-05,9,2.05E-05,0,0,4
tradition,9,1.65E-05,9,2.05E-05,0,0,3
priorities,9,1.65E-05,6,1.37E-05,2.84E-05,3,3
university,9,1.65E-05,6,1.37E-05,2.84E-05,3,5
activities,9,1.65E-05,9,2.05E-05,0,0,4
facilities,9,1.65E-05,9,2.05E-05,0,0,4
committing,9,1.65E-05,8,1.82E-05,9.47E-06,1,3
irregularities,9,1.65E-05,9,2.05E-05,0,0,6
strengthens,9,1.65E-05,4,9.11E-06,4.74E-05,5,2
differences,9,1.65E-05,2,4.56E-06,6.63E-05,7,3
departments,9,1.65E-05,8,1.82E-05,9.47E-06,1,3
participate,9,1.65E-05,7,1.59E-05,1.89E-05,2,4
termination,9,1.65E-05,9,2.05E-05,0,0,4
catastrophe,9,1.65E-05,9,2.05E-05,0,0,3
perpetrated,9,1.65E-05,9,2.05E-05,0,0,3
accusations,9,1.65E-05,9,2.05E-05,0,0,4
exoneration,9,1.65E-05,9,2.05E-05,0,0,5
acknowledge,9,1.65E-05,9,2.05E-05,0,0,3
commander,9,1.65E-05,1,2.28E-06,7.58E-05,8,3
disadvantage,9,1.65E-05,8,1.82E-05,9.47E-06,1,4
neighborhood,9,1.65E-05,7,1.59E-05,1.89E-05,2,3
circumstances,9,1.65E-05,6,1.37E-05,2.84E-05,3,3
overwhelmingly,9,1.65E-05,8,1.82E-05,9.47E-06,1,5
cap,8,1.47E-05,3,6.83E-06,4.74E-05,5,1
gay,8,1.47E-05,0,0,7.58E-05,8,1
net,8,1.47E-05,5,1.14E-05,2.84E-05,3,1
lay,8,1.47E-05,3,6.83E-06,4.74E-05,5,1
hey,8,1.47E-05,1,2.28E-06,6.63E-05,7,1
row,8,1.47E-05,4,9.11E-06,3.79E-05,4,1
fly,8,1.47E-05,7,1.59E-05,9.47E-06,1,1
liz,8,1.47E-05,8,1.82E-05,0,0,1
amy,8,1.47E-05,8,1.82E-05,0,0,1
sgt,8,1.47E-05,8,1.82E-05,0,0,1
rex,8,1.47E-05,8,1.82E-05,0,0,1
dave,8,1.47E-05,6,1.37E-05,1.89E-05,2,1
sake,8,1.47E-05,5,1.14E-05,2.84E-05,3,1
youd,8,1.47E-05,3,6.83E-06,4.74E-05,5,1
grab,8,1.47E-05,4,9.11E-06,3.79E-05,4,1
cute,8,1.47E-05,7,1.59E-05,9.47E-06,1,1
cory,8,1.47E-05,7,1.59E-05,9.47E-06,1,2
tree,8,1.47E-05,5,1.14E-05,2.84E-05,3,1
epic,8,1.47E-05,6,1.37E-05,1.89E-05,2,2
adds,8,1.47E-05,5,1.14E-05,2.84E-05,3,1
ride,8,1.47E-05,6,1.37E-05,1.89E-05,2,1
sums,8,1.47E-05,7,1.59E-05,9.47E-06,1,1
bowl,8,1.47E-05,7,1.59E-05,9.47E-06,1,1
ceos,8,1.47E-05,7,1.59E-05,9.47E-06,1,1
dare,8,1.47E-05,7,1.59E-05,9.47E-06,1,1
redo,8,1.47E-05,8,1.82E-05,0,0,2
uses,8,1.47E-05,8,1.82E-05,0,0,1
type,8,1.47E-05,8,1.82E-05,0,0,1
dean,8,1.47E-05,8,1.82E-05,0,0,1
sham,8,1.47E-05,8,1.82E-05,0,0,1
club,8,1.47E-05,8,1.82E-05,0,0,1
tied,8,1.47E-05,8,1.82E-05,0,0,1
self,8,1.47E-05,8,1.82E-05,0,0,1
buys,8,1.47E-05,8,1.82E-05,0,0,1
bust,8,1.47E-05,8,1.82E-05,0,0,1
cheer,8,1.47E-05,2,4.56E-06,5.68E-05,6,1
seize,8,1.47E-05,2,4.56E-06,5.68E-05,6,1
fifth,8,1.47E-05,6,1.37E-05,1.89E-05,2,1
saint,8,1.47E-05,7,1.59E-05,9.47E-06,1,1
smile,8,1.47E-05,1,2.28E-06,6.63E-05,7,2
tight,8,1.47E-05,6,1.37E-05,1.89E-05,2,1
floor,8,1.47E-05,3,6.83E-06,4.74E-05,5,1
rural,8,1.47E-05,6,1.37E-05,1.89E-05,2,2
chose,8,1.47E-05,4,9.11E-06,3.79E-05,4,1
blood,8,1.47E-05,7,1.59E-05,9.47E-06,1,1
booth,8,1.47E-05,5,1.14E-05,2.84E-05,3,1
cross,8,1.47E-05,6,1.37E-05,1.89E-05,2,1
bunch,8,1.47E-05,5,1.14E-05,2.84E-05,3,1
solid,8,1.47E-05,7,1.59E-05,9.47E-06,1,2
sends,8,1.47E-05,7,1.59E-05,9.47E-06,1,1
davis,8,1.47E-05,7,1.59E-05,9.47E-06,1,2
plate,8,1.47E-05,7,1.59E-05,9.47E-06,1,1
boxes,8,1.47E-05,8,1.82E-05,0,0,1
stole,8,1.47E-05,8,1.82E-05,0,0,2
masks,8,1.47E-05,8,1.82E-05,0,0,1
jesse,8,1.47E-05,8,1.82E-05,0,0,1
hired,8,1.47E-05,8,1.82E-05,0,0,1
filed,8,1.47E-05,8,1.82E-05,0,0,1
gross,8,1.47E-05,8,1.82E-05,0,0,1
riots,8,1.47E-05,8,1.82E-05,0,0,1
tapes,8,1.47E-05,8,1.82E-05,0,0,1
frank,8,1.47E-05,8,1.82E-05,0,0,1
noble,8,1.47E-05,8,1.82E-05,0,0,2
shots,8,1.47E-05,8,1.82E-05,0,0,1
yates,8,1.47E-05,8,1.82E-05,0,0,1
bases,8,1.47E-05,8,1.82E-05,0,0,1
cuban,8,1.47E-05,8,1.82E-05,0,0,2
loses,8,1.47E-05,8,1.82E-05,0,0,1
hence,8,1.47E-05,8,1.82E-05,0,0,1
index,8,1.47E-05,8,1.82E-05,0,0,2
kanye,8,1.47E-05,8,1.82E-05,0,0,2
megan,8,1.47E-05,8,1.82E-05,0,0,2
locked,8,1.47E-05,7,1.59E-05,9.47E-06,1,1
houses,8,1.47E-05,2,4.56E-06,5.68E-05,6,1
walked,8,1.47E-05,5,1.14E-05,2.84E-05,3,1
austin,8,1.47E-05,6,1.37E-05,1.89E-05,2,2
suffer,8,1.47E-05,6,1.37E-05,1.89E-05,2,2
golden,8,1.47E-05,5,1.14E-05,2.84E-05,3,2
fiscal,8,1.47E-05,3,6.83E-06,4.74E-05,5,2
recess,8,1.47E-05,1,2.28E-06,6.63E-05,7,2
impose,8,1.47E-05,7,1.59E-05,9.47E-06,1,2
parade,8,1.47E-05,7,1.59E-05,9.47E-06,1,2
partys,8,1.47E-05,6,1.37E-05,1.89E-05,2,2
facing,8,1.47E-05,5,1.14E-05,2.84E-05,3,2
oppose,8,1.47E-05,7,1.59E-05,9.47E-06,1,2
donate,8,1.47E-05,5,1.14E-05,2.84E-05,3,2
listed,8,1.47E-05,7,1.59E-05,9.47E-06,1,1
passes,8,1.47E-05,2,4.56E-06,5.68E-05,6,1
stable,8,1.47E-05,6,1.37E-05,1.89E-05,2,2
mining,8,1.47E-05,6,1.37E-05,1.89E-05,2,2
phrase,8,1.47E-05,7,1.59E-05,9.47E-06,1,1
driven,8,1.47E-05,7,1.59E-05,9.47E-06,1,2
avenue,8,1.47E-05,7,1.59E-05,9.47E-06,1,3
pfizer,8,1.47E-05,8,1.82E-05,0,0,2
miners,8,1.47E-05,8,1.82E-05,0,0,2
abused,8,1.47E-05,8,1.82E-05,0,0,2
drudge,8,1.47E-05,8,1.82E-05,0,0,1
taylor,8,1.47E-05,8,1.82E-05,0,0,2
sports,8,1.47E-05,8,1.82E-05,0,0,1
unions,8,1.47E-05,8,1.82E-05,0,0,2
kamala,8,1.47E-05,8,1.82E-05,0,0,3
bosses,8,1.47E-05,8,1.82E-05,0,0,1
jerome,8,1.47E-05,8,1.82E-05,0,0,2
animal,8,1.47E-05,8,1.82E-05,0,0,3
accord,8,1.47E-05,8,1.82E-05,0,0,2
scream,8,1.47E-05,8,1.82E-05,0,0,1
intent,8,1.47E-05,8,1.82E-05,0,0,2
sloppy,8,1.47E-05,8,1.82E-05,0,0,2
angela,8,1.47E-05,8,1.82E-05,0,0,3
untrue,8,1.47E-05,8,1.82E-05,0,0,2
forest,8,1.47E-05,8,1.82E-05,0,0,2
trophy,8,1.47E-05,8,1.82E-05,0,0,2
lawful,8,1.47E-05,8,1.82E-05,0,0,2
fronts,8,1.47E-05,8,1.82E-05,0,0,1
french,8,1.47E-05,8,1.82E-05,0,0,1
applaud,8,1.47E-05,4,9.11E-06,3.79E-05,4,2
cleaner,8,1.47E-05,1,2.28E-06,6.63E-05,7,2
educate,8,1.47E-05,0,0,7.58E-05,8,3
ignored,8,1.47E-05,6,1.37E-05,1.89E-05,2,2
delayed,8,1.47E-05,7,1.59E-05,9.47E-06,1,2
measure,8,1.47E-05,3,6.83E-06,4.74E-05,5,2
slowest,8,1.47E-05,4,9.11E-06,3.79E-05,4,2
tactics,8,1.47E-05,6,1.37E-05,1.89E-05,2,2
seekers,8,1.47E-05,0,0,7.58E-05,8,2
chapter,8,1.47E-05,4,9.11E-06,3.79E-05,4,2
capable,8,1.47E-05,5,1.14E-05,2.84E-05,3,3
worried,8,1.47E-05,7,1.59E-05,9.47E-06,1,2
honesty,8,1.47E-05,7,1.59E-05,9.47E-06,1,3
removal,8,1.47E-05,7,1.59E-05,9.47E-06,1,3
awarded,8,1.47E-05,7,1.59E-05,9.47E-06,1,2
sailors,8,1.47E-05,8,1.82E-05,0,0,2
appeals,8,1.47E-05,8,1.82E-05,0,0,2
cheated,8,1.47E-05,8,1.82E-05,0,0,1
conduct,8,1.47E-05,8,1.82E-05,0,0,2
systems,8,1.47E-05,8,1.82E-05,0,0,2
carried,8,1.47E-05,8,1.82E-05,0,0,2
shipped,8,1.47E-05,8,1.82E-05,0,0,1
nursing,8,1.47E-05,8,1.82E-05,0,0,2
goodbye,8,1.47E-05,8,1.82E-05,0,0,2
frankly,8,1.47E-05,8,1.82E-05,0,0,2
manchin,8,1.47E-05,8,1.82E-05,0,0,2
trained,8,1.47E-05,8,1.82E-05,0,0,1
highway,8,1.47E-05,8,1.82E-05,0,0,2
praying,8,1.47E-05,8,1.82E-05,0,0,2
goodwin,8,1.47E-05,8,1.82E-05,0,0,2
arrests,8,1.47E-05,8,1.82E-05,0,0,2
spygate,8,1.47E-05,8,1.82E-05,0,0,2
loophole,8,1.47E-05,4,9.11E-06,3.79E-05,4,3
treating,8,1.47E-05,5,1.14E-05,2.84E-05,3,2
detained,8,1.47E-05,7,1.59E-05,9.47E-06,1,2
patricks,8,1.47E-05,2,4.56E-06,5.68E-05,6,2
rewarded,8,1.47E-05,4,9.11E-06,3.79E-05,4,2
offering,8,1.47E-05,5,1.14E-05,2.84E-05,3,3
required,8,1.47E-05,6,1.37E-05,1.89E-05,2,2
hanukkah,8,1.47E-05,4,9.11E-06,3.79E-05,4,3
intended,8,1.47E-05,6,1.37E-05,1.89E-05,2,2
accepted,8,1.47E-05,7,1.59E-05,9.47E-06,1,2
organize,8,1.47E-05,0,0,7.58E-05,8,3
marching,8,1.47E-05,7,1.59E-05,9.47E-06,1,2
employee,8,1.47E-05,7,1.59E-05,9.47E-06,1,3
incoming,8,1.47E-05,7,1.59E-05,9.47E-06,1,3
accounts,8,1.47E-05,7,1.59E-05,9.47E-06,1,2
assembly,8,1.47E-05,7,1.59E-05,9.47E-06,1,3
civilian,8,1.47E-05,6,1.37E-05,1.89E-05,2,3
meltdown,8,1.47E-05,7,1.59E-05,9.47E-06,1,2
travesty,8,1.47E-05,8,1.82E-05,0,0,3
computer,8,1.47E-05,8,1.82E-05,0,0,3
giuliani,8,1.47E-05,8,1.82E-05,0,0,3
handlers,8,1.47E-05,8,1.82E-05,0,0,2
radicals,8,1.47E-05,8,1.82E-05,0,0,3
pleasure,8,1.47E-05,8,1.82E-05,0,0,2
refugees,8,1.47E-05,8,1.82E-05,0,0,3
producer,8,1.47E-05,8,1.82E-05,0,0,3
findings,8,1.47E-05,8,1.82E-05,0,0,2
horribly,8,1.47E-05,8,1.82E-05,0,0,3
magazine,8,1.47E-05,8,1.82E-05,0,0,3
vladimir,8,1.47E-05,8,1.82E-05,0,0,3
aircraft,8,1.47E-05,8,1.82E-05,0,0,2
division,8,1.47E-05,8,1.82E-05,0,0,3
entering,8,1.47E-05,8,1.82E-05,0,0,3
sinister,8,1.47E-05,8,1.82E-05,0,0,3
kimberly,8,1.47E-05,8,1.82E-05,0,0,3
document,8,1.47E-05,8,1.82E-05,0,0,3
fentanyl,8,1.47E-05,8,1.82E-05,0,0,3
unlawful,8,1.47E-05,8,1.82E-05,0,0,3
delusion,8,1.47E-05,8,1.82E-05,0,0,3
arlington,8,1.47E-05,6,1.37E-05,1.89E-05,2,3
emissions,8,1.47E-05,4,9.11E-06,3.79E-05,4,3
renewable,8,1.47E-05,0,0,7.58E-05,8,4
everyones,8,1.47E-05,3,6.83E-06,4.74E-05,5,3
blessings,8,1.47E-05,6,1.37E-05,1.89E-05,2,2
preparing,8,1.47E-05,5,1.14E-05,2.84E-05,3,3
confident,8,1.47E-05,4,9.11E-06,3.79E-05,4,3
essential,8,1.47E-05,6,1.37E-05,1.89E-05,2,3
tornadoes,8,1.47E-05,7,1.59E-05,9.47E-06,1,3
practices,8,1.47E-05,5,1.14E-05,2.84E-05,3,2
breakfast,8,1.47E-05,6,1.37E-05,1.89E-05,2,2
dedicated,8,1.47E-05,6,1.37E-05,1.89E-05,2,3
dismissed,8,1.47E-05,7,1.59E-05,9.47E-06,1,2
revealing,8,1.47E-05,7,1.59E-05,9.47E-06,1,3
honorable,8,1.47E-05,6,1.37E-05,1.89E-05,2,4
inspiring,8,1.47E-05,5,1.14E-05,2.84E-05,3,3
buildings,8,1.47E-05,7,1.59E-05,9.47E-06,1,2
customers,8,1.47E-05,7,1.59E-05,9.47E-06,1,3
nightmare,8,1.47E-05,7,1.59E-05,9.47E-06,1,2
economist,8,1.47E-05,7,1.59E-05,9.47E-06,1,4
lockdowns,8,1.47E-05,8,1.82E-05,0,0,2
complaint,8,1.47E-05,8,1.82E-05,0,0,2
satisfied,8,1.47E-05,8,1.82E-05,0,0,3
approvals,8,1.47E-05,8,1.82E-05,0,0,3
screaming,8,1.47E-05,8,1.82E-05,0,0,2
deception,8,1.47E-05,8,1.82E-05,0,0,3
heartfelt,8,1.47E-05,8,1.82E-05,0,0,2
existence,8,1.47E-05,8,1.82E-05,0,0,3
crossings,8,1.47E-05,8,1.82E-05,0,0,2
proclaims,8,1.47E-05,8,1.82E-05,0,0,2
strategic,8,1.47E-05,8,1.82E-05,0,0,3
targeting,8,1.47E-05,8,1.82E-05,0,0,3
telephone,8,1.47E-05,8,1.82E-05,0,0,3
donna,8,1.47E-05,8,1.82E-05,0,0,2
jennifer,8,1.47E-05,6,1.37E-05,1.89E-05,2,3
attacking,8,1.47E-05,6,1.37E-05,1.89E-05,2,3
charlotte,8,1.47E-05,6,1.37E-05,1.89E-05,2,2
attention,8,1.47E-05,8,1.82E-05,0,0,3
prosperous,8,1.47E-05,7,1.59E-05,9.47E-06,1,3
highlights,8,1.47E-05,0,0,7.58E-05,8,2
historical,8,1.47E-05,7,1.59E-05,9.47E-06,1,4
extremists,8,1.47E-05,3,6.83E-06,4.74E-05,5,3
efficiency,8,1.47E-05,1,2.28E-06,6.63E-05,7,4
imperative,8,1.47E-05,4,9.11E-06,3.79E-05,4,4
dependence,8,1.47E-05,0,0,7.58E-05,8,3
misleading,8,1.47E-05,6,1.37E-05,1.89E-05,2,3
acceptance,8,1.47E-05,3,6.83E-06,4.74E-05,5,3
reasonable,8,1.47E-05,7,1.59E-05,9.47E-06,1,4
organizing,8,1.47E-05,1,2.28E-06,6.63E-05,7,4
guidelines,8,1.47E-05,7,1.59E-05,9.47E-06,1,3
complaints,8,1.47E-05,8,1.82E-05,0,0,2
whatsoever,8,1.47E-05,8,1.82E-05,0,0,3
currencies,8,1.47E-05,8,1.82E-05,0,0,3
prosecuted,8,1.47E-05,8,1.82E-05,0,0,3
despicable,8,1.47E-05,8,1.82E-05,0,0,4
roundtable,8,1.47E-05,8,1.82E-05,0,0,3
comparison,8,1.47E-05,8,1.82E-05,0,0,4
conclusion,8,1.47E-05,8,1.82E-05,0,0,3
attending,8,1.47E-05,8,1.82E-05,0,0,3
tall,8,1.47E-05,6,1.37E-05,1.89E-05,2,1
skill,8,1.47E-05,7,1.59E-05,9.47E-06,1,1
pulled,8,1.47E-05,8,1.82E-05,0,0,1
equally,8,1.47E-05,4,9.11E-06,3.79E-05,4,3
parnell,8,1.47E-05,8,1.82E-05,0,0,2
killers,8,1.47E-05,8,1.82E-05,0,0,2
colleges,8,1.47E-05,2,4.56E-06,5.68E-05,6,2
carefully,8,1.47E-05,7,1.59E-05,9.47E-06,1,4
fit,8,1.47E-05,7,1.59E-05,9.47E-06,1,1
gillespie,8,1.47E-05,8,1.82E-05,0,0,3
tillerson,8,1.47E-05,8,1.82E-05,0,0,3
eventually,8,1.47E-05,8,1.82E-05,0,0,4
practically,8,1.47E-05,8,1.82E-05,0,0,4
billionaires,8,1.47E-05,0,0,7.58E-05,8,3
economically,8,1.47E-05,8,1.82E-05,0,0,6
title,8,1.47E-05,3,6.83E-06,4.74E-05,5,2
sites,8,1.47E-05,8,1.82E-05,0,0,1
automatically,8,1.47E-05,3,6.83E-06,4.74E-05,5,6
ability,8,1.47E-05,5,1.14E-05,2.84E-05,3,4
humanity,8,1.47E-05,5,1.14E-05,2.84E-05,3,4
facility,8,1.47E-05,7,1.59E-05,9.47E-06,1,4
definitely,8,1.47E-05,7,1.59E-05,9.47E-06,1,5
hypocrites,8,1.47E-05,8,1.82E-05,0,0,3
solidarity,8,1.47E-05,8,1.82E-05,0,0,5
napolitano,8,1.47E-05,8,1.82E-05,0,0,5
admitting,8,1.47E-05,8,1.82E-05,0,0,3
literally,8,1.47E-05,3,6.83E-06,4.74E-05,5,4
competitors,8,1.47E-05,8,1.82E-05,0,0,4
theory,8,1.47E-05,5,1.14E-05,2.84E-05,3,2
heather,8,1.47E-05,8,1.82E-05,0,0,2
brothers,8,1.47E-05,3,6.83E-06,4.74E-05,5,2
therapeutics,8,1.47E-05,8,1.82E-05,0,0,4
fundamental,8,1.47E-05,1,2.28E-06,6.63E-05,7,4
firefighter,8,1.47E-05,5,1.14E-05,2.84E-05,3,4
advertising,8,1.47E-05,7,1.59E-05,9.47E-06,1,4
obligations,8,1.47E-05,7,1.59E-05,9.47E-06,1,4
conjunction,8,1.47E-05,8,1.82E-05,0,0,3
restaurants,8,1.47E-05,8,1.82E-05,0,0,3
conferences,8,1.47E-05,8,1.82E-05,0,0,3
californias,8,1.47E-05,8,1.82E-05,0,0,4
resignation,8,1.47E-05,8,1.82E-05,0,0,4
destructive,8,1.47E-05,8,1.82E-05,0,0,3
immediate,8,1.47E-05,7,1.59E-05,9.47E-06,1,3
achievements,8,1.47E-05,7,1.59E-05,9.47E-06,1,4
surprisingly,8,1.47E-05,8,1.82E-05,0,0,4
expectations,8,1.47E-05,8,1.82E-05,0,0,4
interviewing,8,1.47E-05,8,1.82E-05,0,0,4
confirmation,8,1.47E-05,8,1.82E-05,0,0,4
entrepreneurs,8,1.47E-05,1,2.28E-06,6.63E-05,7,4
beneficiaries,8,1.47E-05,6,1.37E-05,1.89E-05,2,5
consideration,8,1.47E-05,8,1.82E-05,0,0,5
distinguished,8,1.47E-05,8,1.82E-05,0,0,3
relationships,8,1.47E-05,8,1.82E-05,0,0,4
disrespecting,8,1.47E-05,8,1.82E-05,0,0,4
dyk,7,1.29E-05,0,0,6.63E-05,7,1
sat,7,1.29E-05,4,9.11E-06,2.84E-05,3,1
ray,7,1.29E-05,6,1.37E-05,9.47E-06,1,1
ups,7,1.29E-05,6,1.37E-05,9.47E-06,1,1
sec,7,1.29E-05,5,1.14E-05,1.89E-05,2,1
eye,7,1.29E-05,5,1.14E-05,1.89E-05,2,1
dry,7,1.29E-05,7,1.59E-05,0,0,1
wto,7,1.29E-05,7,1.59E-05,0,0,1
boy,7,1.29E-05,7,1.59E-05,0,0,1
mac,7,1.29E-05,7,1.59E-05,0,0,1
gear,7,1.29E-05,4,9.11E-06,2.84E-05,3,1
mile,7,1.29E-05,6,1.37E-05,9.47E-06,1,2
nows,7,1.29E-05,0,0,6.63E-05,7,1
pope,7,1.29E-05,4,9.11E-06,2.84E-05,3,1
rely,7,1.29E-05,4,9.11E-06,2.84E-05,3,2
pain,7,1.29E-05,6,1.37E-05,9.47E-06,1,1
reid,7,1.29E-05,6,1.37E-05,9.47E-06,1,1
sees,7,1.29E-05,5,1.14E-05,1.89E-05,2,1
rain,7,1.29E-05,3,6.83E-06,3.79E-05,4,1
fees,7,1.29E-05,4,9.11E-06,2.84E-05,3,1
core,7,1.29E-05,5,1.14E-05,1.89E-05,2,1
hair,7,1.29E-05,5,1.14E-05,1.89E-05,2,1
judy,7,1.29E-05,4,9.11E-06,2.84E-05,3,2
sand,7,1.29E-05,7,1.59E-05,0,0,1
marc,7,1.29E-05,7,1.59E-05,0,0,1
dues,7,1.29E-05,7,1.59E-05,0,0,1
thus,7,1.29E-05,7,1.59E-05,0,0,1
vile,7,1.29E-05,7,1.59E-05,0,0,2
ease,7,1.29E-05,7,1.59E-05,0,0,1
bomb,7,1.29E-05,7,1.59E-05,0,0,1
mika,7,1.29E-05,7,1.59E-05,0,0,2
icig,7,1.29E-05,7,1.59E-05,0,0,2
hong,7,1.29E-05,7,1.59E-05,0,0,1
kong,7,1.29E-05,7,1.59E-05,0,0,1
mick,7,1.29E-05,7,1.59E-05,0,0,1
judd,7,1.29E-05,7,1.59E-05,0,0,1
ross,7,1.29E-05,7,1.59E-05,0,0,1
cave,7,1.29E-05,7,1.59E-05,0,0,1
bump,7,1.29E-05,7,1.59E-05,0,0,1
glory,7,1.29E-05,5,1.14E-05,1.89E-05,2,2
kings,7,1.29E-05,2,4.56E-06,4.74E-05,5,1
vowed,7,1.29E-05,6,1.37E-05,9.47E-06,1,1
corps,7,1.29E-05,4,9.11E-06,2.84E-05,3,1
bacon,7,1.29E-05,5,1.14E-05,1.89E-05,2,2
osama,7,1.29E-05,3,6.83E-06,3.79E-05,4,3
knock,7,1.29E-05,2,4.56E-06,4.74E-05,5,1
bears,7,1.29E-05,5,1.14E-05,1.89E-05,2,1
touch,7,1.29E-05,5,1.14E-05,1.89E-05,2,1
mixed,7,1.29E-05,6,1.37E-05,9.47E-06,1,1
forms,7,1.29E-05,4,9.11E-06,2.84E-05,3,1
urges,7,1.29E-05,1,2.28E-06,5.68E-05,6,1
picks,7,1.29E-05,3,6.83E-06,3.79E-05,4,1
fence,7,1.29E-05,6,1.37E-05,9.47E-06,1,1
finds,7,1.29E-05,7,1.59E-05,0,0,1
wayne,7,1.29E-05,7,1.59E-05,0,0,1
randy,7,1.29E-05,7,1.59E-05,0,0,2
cyber,7,1.29E-05,7,1.59E-05,0,0,2
queen,7,1.29E-05,7,1.59E-05,0,0,2
naval,7,1.29E-05,7,1.59E-05,0,0,2
tulsa,7,1.29E-05,7,1.59E-05,0,0,2
pirro,7,1.29E-05,7,1.59E-05,0,0,2
stuck,7,1.29E-05,7,1.59E-05,0,0,1
lewis,7,1.29E-05,7,1.59E-05,0,0,2
dairy,7,1.29E-05,7,1.59E-05,0,0,2
sorts,7,1.29E-05,7,1.59E-05,0,0,1
bonds,7,1.29E-05,7,1.59E-05,0,0,1
dealt,7,1.29E-05,7,1.59E-05,0,0,1
rocky,7,1.29E-05,7,1.59E-05,0,0,2
minor,7,1.29E-05,7,1.59E-05,0,0,2
panel,7,1.29E-05,7,1.59E-05,0,0,2
hiden,7,1.29E-05,7,1.59E-05,0,0,2
spies,7,1.29E-05,7,1.59E-05,0,0,1
devin,7,1.29E-05,7,1.59E-05,0,0,2
tlaib,7,1.29E-05,7,1.59E-05,0,0,1
newest,7,1.29E-05,5,1.14E-05,1.89E-05,2,2
belief,7,1.29E-05,4,9.11E-06,2.84E-05,3,2
leaves,7,1.29E-05,2,4.56E-06,4.74E-05,5,1
blacks,7,1.29E-05,6,1.37E-05,9.47E-06,1,1
fields,7,1.29E-05,5,1.14E-05,1.89E-05,2,1
abroad,7,1.29E-05,3,6.83E-06,3.79E-05,4,2
breast,7,1.29E-05,2,4.56E-06,4.74E-05,5,1
babies,7,1.29E-05,4,9.11E-06,2.84E-05,3,2
worthy,7,1.29E-05,5,1.14E-05,1.89E-05,2,2
aurora,7,1.29E-05,1,2.28E-06,5.68E-05,6,3
spring,7,1.29E-05,3,6.83E-06,3.79E-05,4,1
steven,7,1.29E-05,6,1.37E-05,9.47E-06,1,2
denver,7,1.29E-05,1,2.28E-06,5.68E-05,6,2
resort,7,1.29E-05,4,9.11E-06,2.84E-05,3,2
solemn,7,1.29E-05,6,1.37E-05,9.47E-06,1,2
female,7,1.29E-05,5,1.14E-05,1.89E-05,2,3
buyout,7,1.29E-05,0,0,6.63E-05,7,2
rapids,7,1.29E-05,6,1.37E-05,9.47E-06,1,2
laptop,7,1.29E-05,5,1.14E-05,1.89E-05,2,2
harass,7,1.29E-05,7,1.59E-05,0,0,2
indian,7,1.29E-05,7,1.59E-05,0,0,2
joseph,7,1.29E-05,7,1.59E-05,0,0,2
brooks,7,1.29E-05,7,1.59E-05,0,0,1
insane,7,1.29E-05,7,1.59E-05,0,0,2
formed,7,1.29E-05,7,1.59E-05,0,0,1
native,7,1.29E-05,7,1.59E-05,0,0,2
oregon,7,1.29E-05,7,1.59E-05,0,0,3
genius,7,1.29E-05,7,1.59E-05,0,0,2
hereby,7,1.29E-05,7,1.59E-05,0,0,3
wilson,7,1.29E-05,7,1.59E-05,0,0,2
league,7,1.29E-05,7,1.59E-05,0,0,2
prince,7,1.29E-05,7,1.59E-05,0,0,1
sudden,7,1.29E-05,7,1.59E-05,0,0,2
upside,7,1.29E-05,7,1.59E-05,0,0,2
factor,7,1.29E-05,7,1.59E-05,0,0,2
awards,7,1.29E-05,7,1.59E-05,0,0,2
maduro,7,1.29E-05,7,1.59E-05,0,0,3
blasio,7,1.29E-05,7,1.59E-05,0,0,2
solved,7,1.29E-05,7,1.59E-05,0,0,1
parlor,7,1.29E-05,7,1.59E-05,0,0,2
harvey,7,1.29E-05,7,1.59E-05,0,0,2
expert,7,1.29E-05,7,1.59E-05,0,0,2
eating,7,1.29E-05,7,1.59E-05,0,0,2
syrian,7,1.29E-05,7,1.59E-05,0,0,2
merkel,7,1.29E-05,7,1.59E-05,0,0,2
scheme,7,1.29E-05,7,1.59E-05,0,0,1
warner,7,1.29E-05,7,1.59E-05,0,0,2
volume,7,1.29E-05,7,1.59E-05,0,0,2
nearby,7,1.29E-05,7,1.59E-05,0,0,2
warming,7,1.29E-05,4,9.11E-06,2.84E-05,3,2
solving,7,1.29E-05,3,6.83E-06,3.79E-05,4,2
disease,7,1.29E-05,5,1.14E-05,1.89E-05,2,2
decline,7,1.29E-05,3,6.83E-06,3.79E-05,4,2
stretch,7,1.29E-05,1,2.28E-06,5.68E-05,6,1
hateful,7,1.29E-05,6,1.37E-05,9.47E-06,1,3
degrees,7,1.29E-05,3,6.83E-06,3.79E-05,4,2
chances,7,1.29E-05,6,1.37E-05,9.47E-06,1,1
savings,7,1.29E-05,2,4.56E-06,4.74E-05,5,2
denying,7,1.29E-05,2,4.56E-06,4.74E-05,5,2
retired,7,1.29E-05,5,1.14E-05,1.89E-05,2,2
develop,7,1.29E-05,5,1.14E-05,1.89E-05,2,3
appoint,7,1.29E-05,5,1.14E-05,1.89E-05,2,2
blowing,7,1.29E-05,6,1.37E-05,9.47E-06,1,2
imports,7,1.29E-05,4,9.11E-06,2.84E-05,3,2
distant,7,1.29E-05,6,1.37E-05,9.47E-06,1,2
manager,7,1.29E-05,6,1.37E-05,9.47E-06,1,3
monthly,7,1.29E-05,3,6.83E-06,3.79E-05,4,2
updated,7,1.29E-05,5,1.14E-05,1.89E-05,2,2
senates,7,1.29E-05,4,9.11E-06,2.84E-05,3,2
seasons,7,1.29E-05,6,1.37E-05,9.47E-06,1,2
figures,7,1.29E-05,7,1.59E-05,0,0,2
burgess,7,1.29E-05,7,1.59E-05,0,0,2
promote,7,1.29E-05,7,1.59E-05,0,0,2
looting,7,1.29E-05,7,1.59E-05,0,0,2
favored,7,1.29E-05,7,1.59E-05,0,0,2
amnesty,7,1.29E-05,7,1.59E-05,0,0,3
hundred,7,1.29E-05,7,1.59E-05,0,0,1
portion,7,1.29E-05,7,1.59E-05,0,0,2
simpson,7,1.29E-05,7,1.59E-05,0,0,2
monster,7,1.29E-05,7,1.59E-05,0,0,2
ethanol,7,1.29E-05,7,1.59E-05,0,0,3
denmark,7,1.29E-05,7,1.59E-05,0,0,2
blatant,7,1.29E-05,7,1.59E-05,0,0,2
lebanon,7,1.29E-05,7,1.59E-05,0,0,3
anytime,7,1.29E-05,7,1.59E-05,0,0,3
dealers,7,1.29E-05,7,1.59E-05,0,0,2
happily,7,1.29E-05,7,1.59E-05,0,0,3
statues,7,1.29E-05,7,1.59E-05,0,0,2
lindsey,7,1.29E-05,7,1.59E-05,0,0,2
divided,7,1.29E-05,7,1.59E-05,0,0,2
anchors,7,1.29E-05,7,1.59E-05,0,0,2
suspect,7,1.29E-05,7,1.59E-05,0,0,2
sanford,7,1.29E-05,7,1.59E-05,0,0,2
england,7,1.29E-05,7,1.59E-05,0,0,2
barbara,7,1.29E-05,7,1.59E-05,0,0,3
improved,7,1.29E-05,3,6.83E-06,3.79E-05,4,2
ordinary,7,1.29E-05,0,0,6.63E-05,7,4
ensuring,7,1.29E-05,3,6.83E-06,3.79E-05,4,3
medicine,7,1.29E-05,5,1.14E-05,1.89E-05,2,3
insurers,7,1.29E-05,0,0,6.63E-05,7,3
wherever,7,1.29E-05,3,6.83E-06,3.79E-05,4,3
athletes,7,1.29E-05,3,6.83E-06,3.79E-05,4,2
physical,7,1.29E-05,6,1.37E-05,9.47E-06,1,3
domestic,7,1.29E-05,6,1.37E-05,9.47E-06,1,3
occasion,7,1.29E-05,5,1.14E-05,1.89E-05,2,3
smartest,7,1.29E-05,6,1.37E-05,9.47E-06,1,2
designed,7,1.29E-05,4,9.11E-06,2.84E-05,3,2
familiar,7,1.29E-05,2,4.56E-06,4.74E-05,5,3
toughest,7,1.29E-05,4,9.11E-06,2.84E-05,3,2
endorses,7,1.29E-05,3,6.83E-06,3.79E-05,4,2
tireless,7,1.29E-05,4,9.11E-06,2.84E-05,3,3
goodness,7,1.29E-05,5,1.14E-05,1.89E-05,2,2
delivery,7,1.29E-05,6,1.37E-05,9.47E-06,1,4
reaction,7,1.29E-05,6,1.37E-05,9.47E-06,1,2
everyday,7,1.29E-05,5,1.14E-05,1.89E-05,2,4
publicly,7,1.29E-05,6,1.37E-05,9.47E-06,1,3
reminded,7,1.29E-05,4,9.11E-06,2.84E-05,3,2
arriving,7,1.29E-05,6,1.37E-05,9.47E-06,1,3
keystone,7,1.29E-05,4,9.11E-06,2.84E-05,3,2
contrary,7,1.29E-05,6,1.37E-05,9.47E-06,1,3
stepping,7,1.29E-05,7,1.59E-05,0,0,2
harassed,7,1.29E-05,7,1.59E-05,0,0,2
obtained,7,1.29E-05,7,1.59E-05,0,0,2
lockdown,7,1.29E-05,7,1.59E-05,0,0,2
digenova,7,1.29E-05,7,1.59E-05,0,0,4
salaries,7,1.29E-05,7,1.59E-05,0,0,3
lowlifes,7,1.29E-05,7,1.59E-05,0,0,2
lawrence,7,1.29E-05,7,1.59E-05,0,0,2
approves,7,1.29E-05,7,1.59E-05,0,0,2
gasoline,7,1.29E-05,7,1.59E-05,0,0,3
departed,7,1.29E-05,7,1.59E-05,0,0,2
crossing,7,1.29E-05,7,1.59E-05,0,0,2
deserved,7,1.29E-05,7,1.59E-05,0,0,2
awarding,7,1.29E-05,7,1.59E-05,0,0,3
believed,7,1.29E-05,7,1.59E-05,0,0,2
airlines,7,1.29E-05,7,1.59E-05,0,0,2
flourish,7,1.29E-05,7,1.59E-05,0,0,2
demanded,7,1.29E-05,7,1.59E-05,0,0,2
invasion,7,1.29E-05,7,1.59E-05,0,0,3
examiner,7,1.29E-05,7,1.59E-05,0,0,4
rejecting,7,1.29E-05,2,4.56E-06,4.74E-05,5,3
character,7,1.29E-05,5,1.14E-05,1.89E-05,2,3
judgement,7,1.29E-05,6,1.37E-05,9.47E-06,1,3
answering,7,1.29E-05,3,6.83E-06,3.79E-05,4,3
employers,7,1.29E-05,2,4.56E-06,4.74E-05,5,3
promising,7,1.29E-05,4,9.11E-06,2.84E-05,3,3
substance,7,1.29E-05,6,1.37E-05,9.47E-06,1,2
believing,7,1.29E-05,3,6.83E-06,3.79E-05,4,3
efficient,7,1.29E-05,4,9.11E-06,2.84E-05,3,3
sotomayor,7,1.29E-05,1,2.28E-06,5.68E-05,6,4
reception,7,1.29E-05,6,1.37E-05,9.47E-06,1,3
undermine,7,1.29E-05,6,1.37E-05,9.47E-06,1,3
arsonists,7,1.29E-05,7,1.59E-05,0,0,3
disappear,7,1.29E-05,7,1.59E-05,0,0,3
ratcliffe,7,1.29E-05,7,1.59E-05,0,0,2
apprehend,7,1.29E-05,7,1.59E-05,0,0,3
rosendale,7,1.29E-05,7,1.59E-05,0,0,4
unmasking,7,1.29E-05,7,1.59E-05,0,0,3
cooperate,7,1.29E-05,7,1.59E-05,0,0,3
convicted,7,1.29E-05,7,1.59E-05,0,0,2
approving,7,1.29E-05,7,1.59E-05,0,0,3
professor,7,1.29E-05,7,1.59E-05,0,0,3
balderson,7,1.29E-05,7,1.59E-05,0,0,3
cutter,7,1.29E-05,6,1.37E-05,9.47E-06,1,2
inner,7,1.29E-05,7,1.59E-05,0,0,2
settled,7,1.29E-05,3,6.83E-06,3.79E-05,4,1
shutting,7,1.29E-05,4,9.11E-06,2.84E-05,3,2
foxconn,7,1.29E-05,7,1.59E-05,0,0,2
shattered,7,1.29E-05,6,1.37E-05,9.47E-06,1,2
charlottesville,7,1.29E-05,7,1.59E-05,0,0,4
guaranteed,7,1.29E-05,3,6.83E-06,3.79E-05,4,3
resilience,7,1.29E-05,3,6.83E-06,3.79E-05,4,3
repeatedly,7,1.29E-05,5,1.14E-05,1.89E-05,2,4
graduation,7,1.29E-05,3,6.83E-06,3.79E-05,4,3
tirelessly,7,1.29E-05,5,1.14E-05,1.89E-05,2,4
everybodys,7,1.29E-05,3,6.83E-06,3.79E-05,4,5
revolution,7,1.29E-05,6,1.37E-05,9.47E-06,1,4
sacrificed,7,1.29E-05,2,4.56E-06,4.74E-05,5,3
unwavering,7,1.29E-05,6,1.37E-05,9.47E-06,1,4
agreements,7,1.29E-05,6,1.37E-05,9.47E-06,1,3
remembered,7,1.29E-05,6,1.37E-05,9.47E-06,1,3
intentions,7,1.29E-05,7,1.59E-05,0,0,3
testifying,7,1.29E-05,7,1.59E-05,0,0,3
protestors,7,1.29E-05,7,1.59E-05,0,0,3
exonerated,7,1.29E-05,7,1.59E-05,0,0,4
unverified,7,1.29E-05,7,1.59E-05,0,0,4
permission,7,1.29E-05,7,1.59E-05,0,0,3
renovation,7,1.29E-05,7,1.59E-05,0,0,4
jill,7,1.29E-05,6,1.37E-05,9.47E-06,1,1
spill,7,1.29E-05,0,0,6.63E-05,7,1
sells,7,1.29E-05,7,1.59E-05,0,0,1
miller,7,1.29E-05,7,1.59E-05,0,0,2
smaller,7,1.29E-05,6,1.37E-05,9.47E-06,1,2
polluters,7,1.29E-05,2,4.56E-06,4.74E-05,5,3
nashville,7,1.29E-05,6,1.37E-05,9.47E-06,1,2
brilliantly,7,1.29E-05,7,1.59E-05,0,0,3
historically,7,1.29E-05,7,1.59E-05,0,0,5
fundamentally,7,1.29E-05,1,2.28E-06,5.68E-05,6,5
suit,7,1.29E-05,5,1.14E-05,1.89E-05,2,1
bite,7,1.29E-05,7,1.59E-05,0,0,1
writer,7,1.29E-05,7,1.59E-05,0,0,2
brexit,7,1.29E-05,7,1.59E-05,0,0,2
tuition,7,1.29E-05,1,2.28E-06,5.68E-05,6,2
writers,7,1.29E-05,6,1.37E-05,9.47E-06,1,2
withdraw,7,1.29E-05,5,1.14E-05,1.89E-05,2,2
whitaker,7,1.29E-05,7,1.59E-05,0,0,3
pulitzer,7,1.29E-05,7,1.59E-05,0,0,3
breitbart,7,1.29E-05,7,1.59E-05,0,0,2
invitation,7,1.29E-05,6,1.37E-05,9.47E-06,1,4
legitimate,7,1.29E-05,7,1.59E-05,0,0,4
flexibility,7,1.29E-05,5,1.14E-05,1.89E-05,2,5
immunity,7,1.29E-05,7,1.59E-05,0,0,4
theme,7,1.29E-05,7,1.59E-05,0,0,1
theresa,7,1.29E-05,7,1.59E-05,0,0,3
northern,7,1.29E-05,7,1.59E-05,0,0,2
imagination,7,1.29E-05,4,9.11E-06,2.84E-05,3,5
legislature,7,1.29E-05,4,9.11E-06,2.84E-05,3,4
experienced,7,1.29E-05,6,1.37E-05,9.47E-06,1,3
disgruntled,7,1.29E-05,7,1.59E-05,0,0,2
derangement,7,1.29E-05,7,1.59E-05,0,0,4
designating,7,1.29E-05,7,1.59E-05,0,0,4
devastation,7,1.29E-05,7,1.59E-05,0,0,4
transaction,7,1.29E-05,7,1.59E-05,0,0,3
substantial,7,1.29E-05,7,1.59E-05,0,0,3
obstructing,7,1.29E-05,7,1.59E-05,0,0,3
immigrant,7,1.29E-05,4,9.11E-06,2.84E-05,3,3
commencement,7,1.29E-05,6,1.37E-05,9.47E-06,1,4
corporations,7,1.29E-05,4,9.11E-06,2.84E-05,3,4
manipulation,7,1.29E-05,6,1.37E-05,9.47E-06,1,5
particularly,7,1.29E-05,5,1.14E-05,1.89E-05,2,5
interference,7,1.29E-05,7,1.59E-05,0,0,4
disrespected,7,1.29E-05,7,1.59E-05,0,0,3
inaccurately,7,1.29E-05,7,1.59E-05,0,0,6
indianapolis,7,1.29E-05,7,1.59E-05,0,0,5
underestimate,7,1.29E-05,5,1.14E-05,1.89E-05,2,5
transportation,7,1.29E-05,5,1.14E-05,1.89E-05,2,4
hydroxychloroquine,7,1.29E-05,7,1.59E-05,0,0,6
arm,6,1.10E-05,5,1.14E-05,9.47E-06,1,1
hiv,6,1.10E-05,3,6.83E-06,2.84E-05,3,1
sea,6,1.10E-05,4,9.11E-06,1.89E-05,2,1
joy,6,1.10E-05,5,1.14E-05,9.47E-06,1,1
pat,6,1.10E-05,6,1.37E-05,0,0,1
rip,6,1.10E-05,6,1.37E-05,0,0,1
los,6,1.10E-05,6,1.37E-05,0,0,1
rig,6,1.10E-05,6,1.37E-05,0,0,1
cdc,6,1.10E-05,6,1.37E-05,0,0,1
pol,6,1.10E-05,6,1.37E-05,0,0,1
nut,6,1.10E-05,6,1.37E-05,0,0,1
djt,6,1.10E-05,6,1.37E-05,0,0,1
bid,6,1.10E-05,6,1.37E-05,0,0,1
sam,6,1.10E-05,6,1.37E-05,0,0,1
cox,6,1.10E-05,6,1.37E-05,0,0,1
rosa,6,1.10E-05,0,0,5.68E-05,6,2
body,6,1.10E-05,4,9.11E-06,1.89E-05,2,2
girl,6,1.10E-05,2,4.56E-06,3.79E-05,4,1
soar,6,1.10E-05,5,1.14E-05,9.47E-06,1,1
hugs,6,1.10E-05,0,0,5.68E-05,6,1
male,6,1.10E-05,1,2.28E-06,4.74E-05,5,2
rent,6,1.10E-05,5,1.14E-05,9.47E-06,1,1
foot,6,1.10E-05,4,9.11E-06,1.89E-05,2,1
bans,6,1.10E-05,2,4.56E-06,3.79E-05,4,1
rank,6,1.10E-05,5,1.14E-05,9.47E-06,1,1
fame,6,1.10E-05,5,1.14E-05,9.47E-06,1,1
feet,6,1.10E-05,3,6.83E-06,2.84E-05,3,1
flat,6,1.10E-05,3,6.83E-06,2.84E-05,3,1
hook,6,1.10E-05,5,1.14E-05,9.47E-06,1,1
snow,6,1.10E-05,3,6.83E-06,2.84E-05,3,1
sets,6,1.10E-05,3,6.83E-06,2.84E-05,3,1
bear,6,1.10E-05,3,6.83E-06,2.84E-05,3,1
raid,6,1.10E-05,5,1.14E-05,9.47E-06,1,1
laid,6,1.10E-05,3,6.83E-06,2.84E-05,3,1
spot,6,1.10E-05,5,1.14E-05,9.47E-06,1,1
tank,6,1.10E-05,5,1.14E-05,9.47E-06,1,1
baby,6,1.10E-05,4,9.11E-06,1.89E-05,2,2
heat,6,1.10E-05,4,9.11E-06,1.89E-05,2,1
pump,6,1.10E-05,3,6.83E-06,2.84E-05,3,1
chat,6,1.10E-05,1,2.28E-06,4.74E-05,5,1
rail,6,1.10E-05,5,1.14E-05,9.47E-06,1,1
gods,6,1.10E-05,5,1.14E-05,9.47E-06,1,1
lock,6,1.10E-05,6,1.37E-05,0,0,1
dump,6,1.10E-05,6,1.37E-05,0,0,1
heal,6,1.10E-05,6,1.37E-05,0,0,1
hack,6,1.10E-05,6,1.37E-05,0,0,1
thom,6,1.10E-05,6,1.37E-05,0,0,1
joni,6,1.10E-05,6,1.37E-05,0,0,2
edge,6,1.10E-05,6,1.37E-05,0,0,1
wray,6,1.10E-05,6,1.37E-05,0,0,1
band,6,1.10E-05,6,1.37E-05,0,0,1
nypd,6,1.10E-05,6,1.37E-05,0,0,1
feds,6,1.10E-05,6,1.37E-05,0,0,1
grid,6,1.10E-05,6,1.37E-05,0,0,1
file,6,1.10E-05,6,1.37E-05,0,0,2
kate,6,1.10E-05,6,1.37E-05,0,0,1
dale,6,1.10E-05,6,1.37E-05,0,0,2
cruz,6,1.10E-05,6,1.37E-05,0,0,1
irma,6,1.10E-05,6,1.37E-05,0,0,2
beto,6,1.10E-05,6,1.37E-05,0,0,2
burr,6,1.10E-05,6,1.37E-05,0,0,1
cook,6,1.10E-05,6,1.37E-05,0,0,1
sleep,6,1.10E-05,4,9.11E-06,1.89E-05,2,1
globe,6,1.10E-05,4,9.11E-06,1.89E-05,2,1
sweet,6,1.10E-05,1,2.28E-06,4.74E-05,5,1
mount,6,1.10E-05,5,1.14E-05,9.47E-06,1,1
drops,6,1.10E-05,4,9.11E-06,1.89E-05,2,1
quiet,6,1.10E-05,4,9.11E-06,1.89E-05,2,2
brady,6,1.10E-05,5,1.14E-05,9.47E-06,1,2
scare,6,1.10E-05,3,6.83E-06,2.84E-05,3,1
hurry,6,1.10E-05,5,1.14E-05,9.47E-06,1,2
reads,6,1.10E-05,4,9.11E-06,1.89E-05,2,1
hears,6,1.10E-05,2,4.56E-06,3.79E-05,4,1
rough,6,1.10E-05,5,1.14E-05,9.47E-06,1,1
sizes,6,1.10E-05,3,6.83E-06,2.84E-05,3,1
slash,6,1.10E-05,5,1.14E-05,9.47E-06,1,1
emily,6,1.10E-05,5,1.14E-05,9.47E-06,1,3
music,6,1.10E-05,4,9.11E-06,1.89E-05,2,2
asian,6,1.10E-05,5,1.14E-05,9.47E-06,1,2
cards,6,1.10E-05,4,9.11E-06,1.89E-05,2,1
buddy,6,1.10E-05,5,1.14E-05,9.47E-06,1,2
sudan,6,1.10E-05,6,1.37E-05,0,0,2
threw,6,1.10E-05,6,1.37E-05,0,0,1
topic,6,1.10E-05,6,1.37E-05,0,0,2
owned,6,1.10E-05,6,1.37E-05,0,0,1
grave,6,1.10E-05,6,1.37E-05,0,0,1
idlib,6,1.10E-05,6,1.37E-05,0,0,2
spain,6,1.10E-05,6,1.37E-05,0,0,1
valor,6,1.10E-05,6,1.37E-05,0,0,2
wiped,6,1.10E-05,6,1.37E-05,0,0,1
wifes,6,1.10E-05,6,1.37E-05,0,0,1
stein,6,1.10E-05,6,1.37E-05,0,0,1
towns,6,1.10E-05,6,1.37E-05,0,0,1
diego,6,1.10E-05,6,1.37E-05,0,0,2
idaho,6,1.10E-05,6,1.37E-05,0,0,3
surge,6,1.10E-05,6,1.37E-05,0,0,1
lemon,6,1.10E-05,6,1.37E-05,0,0,2
laugh,6,1.10E-05,6,1.37E-05,0,0,1
crown,6,1.10E-05,6,1.37E-05,0,0,1
liars,6,1.10E-05,6,1.37E-05,0,0,1
envoy,6,1.10E-05,6,1.37E-05,0,0,2
ships,6,1.10E-05,6,1.37E-05,0,0,1
blows,6,1.10E-05,6,1.37E-05,0,0,1
suing,6,1.10E-05,6,1.37E-05,0,0,1
grief,6,1.10E-05,6,1.37E-05,0,0,1
assad,6,1.10E-05,6,1.37E-05,0,0,2
ninth,6,1.10E-05,6,1.37E-05,0,0,1
libel,6,1.10E-05,6,1.37E-05,0,0,2
cages,6,1.10E-05,6,1.37E-05,0,0,1
setup,6,1.10E-05,6,1.37E-05,0,0,2
drone,6,1.10E-05,6,1.37E-05,0,0,1
repeat,6,1.10E-05,5,1.14E-05,9.47E-06,1,2
tackle,6,1.10E-05,0,0,5.68E-05,6,2
coffee,6,1.10E-05,0,0,5.68E-05,6,2
ignore,6,1.10E-05,4,9.11E-06,1.89E-05,2,2
remind,6,1.10E-05,2,4.56E-06,3.79E-05,4,2
heaven,6,1.10E-05,3,6.83E-06,2.84E-05,3,2
degree,6,1.10E-05,2,4.56E-06,3.79E-05,4,2
stuart,6,1.10E-05,5,1.14E-05,9.47E-06,1,1
reject,6,1.10E-05,3,6.83E-06,2.84E-05,3,2
prefer,6,1.10E-05,5,1.14E-05,9.47E-06,1,2
struck,6,1.10E-05,5,1.14E-05,9.47E-06,1,1
childs,6,1.10E-05,0,0,5.68E-05,6,1
reopen,6,1.10E-05,4,9.11E-06,1.89E-05,2,2
urgent,6,1.10E-05,3,6.83E-06,2.84E-05,3,2
exists,6,1.10E-05,4,9.11E-06,1.89E-05,2,2
retire,6,1.10E-05,5,1.14E-05,9.47E-06,1,2
pieces,6,1.10E-05,5,1.14E-05,9.47E-06,1,1
grieve,6,1.10E-05,5,1.14E-05,9.47E-06,1,1
bridge,6,1.10E-05,5,1.14E-05,9.47E-06,1,1
justin,6,1.10E-05,6,1.37E-05,0,0,2
beirut,6,1.10E-05,6,1.37E-05,0,0,2
lethal,6,1.10E-05,6,1.37E-05,0,0,2
agency,6,1.10E-05,6,1.37E-05,0,0,3
spends,6,1.10E-05,6,1.37E-05,0,0,1
lesley,6,1.10E-05,6,1.37E-05,0,0,2
regard,6,1.10E-05,6,1.37E-05,0,0,2
column,6,1.10E-05,6,1.37E-05,0,0,2
nicole,6,1.10E-05,6,1.37E-05,0,0,3
clause,6,1.10E-05,6,1.37E-05,0,0,1
abuses,6,1.10E-05,6,1.37E-05,0,0,2
snyder,6,1.10E-05,6,1.37E-05,0,0,2
jordan,6,1.10E-05,6,1.37E-05,0,0,2
timing,6,1.10E-05,6,1.37E-05,0,0,2
finale,6,1.10E-05,6,1.37E-05,0,0,3
smooth,6,1.10E-05,6,1.37E-05,0,0,1
lately,6,1.10E-05,6,1.37E-05,0,0,3
tigers,6,1.10E-05,6,1.37E-05,0,0,2
garcia,6,1.10E-05,6,1.37E-05,0,0,2
deface,6,1.10E-05,6,1.37E-05,0,0,2
obiden,6,1.10E-05,6,1.37E-05,0,0,3
legend,6,1.10E-05,6,1.37E-05,0,0,2
signal,6,1.10E-05,6,1.37E-05,0,0,2
delays,6,1.10E-05,6,1.37E-05,0,0,2
arnold,6,1.10E-05,6,1.37E-05,0,0,2
clowns,6,1.10E-05,6,1.37E-05,0,0,1
mocked,6,1.10E-05,6,1.37E-05,0,0,1
misled,6,1.10E-05,6,1.37E-05,0,0,1
poured,6,1.10E-05,6,1.37E-05,0,0,1
cooper,6,1.10E-05,6,1.37E-05,0,0,2
upward,6,1.10E-05,6,1.37E-05,0,0,2
flunky,6,1.10E-05,6,1.37E-05,0,0,2
topics,6,1.10E-05,6,1.37E-05,0,0,2
duluth,6,1.10E-05,6,1.37E-05,0,0,2
bombed,6,1.10E-05,6,1.37E-05,0,0,1
herman,6,1.10E-05,6,1.37E-05,0,0,2
manuel,6,1.10E-05,6,1.37E-05,0,0,2
length,6,1.10E-05,6,1.37E-05,0,0,1
lovely,6,1.10E-05,6,1.37E-05,0,0,3
walker,6,1.10E-05,6,1.37E-05,0,0,2
proves,6,1.10E-05,6,1.37E-05,0,0,1
haspel,6,1.10E-05,6,1.37E-05,0,0,2
heroism,6,1.10E-05,2,4.56E-06,3.79E-05,4,2
crucial,6,1.10E-05,2,4.56E-06,3.79E-05,4,2
drivers,6,1.10E-05,3,6.83E-06,2.84E-05,3,2
pathway,6,1.10E-05,2,4.56E-06,3.79E-05,4,2
stewart,6,1.10E-05,4,9.11E-06,1.89E-05,2,2
rooting,6,1.10E-05,2,4.56E-06,3.79E-05,4,2
dangers,6,1.10E-05,3,6.83E-06,2.84E-05,3,2
balance,6,1.10E-05,5,1.14E-05,9.47E-06,1,2
awesome,6,1.10E-05,4,9.11E-06,1.89E-05,2,3
surging,6,1.10E-05,5,1.14E-05,9.47E-06,1,2
mandela,6,1.10E-05,0,0,5.68E-05,6,3
stanley,6,1.10E-05,4,9.11E-06,1.89E-05,2,2
ceiling,6,1.10E-05,3,6.83E-06,2.84E-05,3,2
forcing,6,1.10E-05,4,9.11E-06,1.89E-05,2,2
bargain,6,1.10E-05,3,6.83E-06,2.84E-05,3,2
default,6,1.10E-05,4,9.11E-06,1.89E-05,2,2
enacted,6,1.10E-05,4,9.11E-06,1.89E-05,2,2
revenue,6,1.10E-05,3,6.83E-06,2.84E-05,3,3
propose,6,1.10E-05,4,9.11E-06,1.89E-05,2,2
extends,6,1.10E-05,0,0,5.68E-05,6,2
talents,6,1.10E-05,4,9.11E-06,1.89E-05,2,2
sounded,6,1.10E-05,5,1.14E-05,9.47E-06,1,1
explode,6,1.10E-05,3,6.83E-06,2.84E-05,3,2
donated,6,1.10E-05,2,4.56E-06,3.79E-05,4,2
layoffs,6,1.10E-05,1,2.28E-06,4.74E-05,5,2
gateway,6,1.10E-05,3,6.83E-06,2.84E-05,3,3
hopeful,6,1.10E-05,1,2.28E-06,4.74E-05,5,3
olympic,6,1.10E-05,3,6.83E-06,2.84E-05,3,3
prosper,6,1.10E-05,5,1.14E-05,9.47E-06,1,2
printed,6,1.10E-05,4,9.11E-06,1.89E-05,2,1
insider,6,1.10E-05,2,4.56E-06,3.79E-05,4,3
academy,6,1.10E-05,5,1.14E-05,9.47E-06,1,4
spouses,6,1.10E-05,5,1.14E-05,9.47E-06,1,1
contest,6,1.10E-05,4,9.11E-06,1.89E-05,2,2
incomes,6,1.10E-05,5,1.14E-05,9.47E-06,1,2
empower,6,1.10E-05,5,1.14E-05,9.47E-06,1,3
weakest,6,1.10E-05,6,1.37E-05,0,0,2
bailing,6,1.10E-05,6,1.37E-05,0,0,2
miracle,6,1.10E-05,6,1.37E-05,0,0,3
loyalty,6,1.10E-05,6,1.37E-05,0,0,3
assured,6,1.10E-05,6,1.37E-05,0,0,2
western,6,1.10E-05,6,1.37E-05,0,0,2
packing,6,1.10E-05,6,1.37E-05,0,0,2
turmoil,6,1.10E-05,6,1.37E-05,0,0,2
rockets,6,1.10E-05,6,1.37E-05,0,0,2
lawless,6,1.10E-05,6,1.37E-05,0,0,2
dispute,6,1.10E-05,6,1.37E-05,0,0,2
suspend,6,1.10E-05,6,1.37E-05,0,0,2
grounds,6,1.10E-05,6,1.37E-05,0,0,1
quoting,6,1.10E-05,6,1.37E-05,0,0,2
grossly,6,1.10E-05,6,1.37E-05,0,0,2
warrant,6,1.10E-05,6,1.37E-05,0,0,2
figured,6,1.10E-05,6,1.37E-05,0,0,2
offense,6,1.10E-05,6,1.37E-05,0,0,2
similar,6,1.10E-05,6,1.37E-05,0,0,3
origins,6,1.10E-05,6,1.37E-05,0,0,3
scorned,6,1.10E-05,6,1.37E-05,0,0,1
stating,6,1.10E-05,6,1.37E-05,0,0,2
concept,6,1.10E-05,6,1.37E-05,0,0,2
ireland,6,1.10E-05,6,1.37E-05,0,0,3
spewing,6,1.10E-05,6,1.37E-05,0,0,2
clients,6,1.10E-05,6,1.37E-05,0,0,1
comfort,6,1.10E-05,6,1.37E-05,0,0,2
heights,6,1.10E-05,6,1.37E-05,0,0,1
eternal,6,1.10E-05,6,1.37E-05,0,0,3
dumping,6,1.10E-05,6,1.37E-05,0,0,2
pumping,6,1.10E-05,6,1.37E-05,0,0,2
andrews,6,1.10E-05,6,1.37E-05,0,0,2
accuser,6,1.10E-05,6,1.37E-05,0,0,3
mexicos,6,1.10E-05,6,1.37E-05,0,0,3
surplus,6,1.10E-05,6,1.37E-05,0,0,2
cameron,6,1.10E-05,6,1.37E-05,0,0,3
zealand,6,1.10E-05,6,1.37E-05,0,0,2
mountain,6,1.10E-05,4,9.11E-06,1.89E-05,2,2
presence,6,1.10E-05,4,9.11E-06,1.89E-05,2,2
repealed,6,1.10E-05,1,2.28E-06,4.74E-05,5,2
outdoors,6,1.10E-05,4,9.11E-06,1.89E-05,2,2
earliest,6,1.10E-05,3,6.83E-06,2.84E-05,3,2
jeopardy,6,1.10E-05,4,9.11E-06,1.89E-05,2,3
reaffirm,6,1.10E-05,3,6.83E-06,2.84E-05,3,3
defended,6,1.10E-05,5,1.14E-05,9.47E-06,1,2
answered,6,1.10E-05,3,6.83E-06,2.84E-05,3,2
passover,6,1.10E-05,3,6.83E-06,2.84E-05,3,3
margaret,6,1.10E-05,1,2.28E-06,4.74E-05,5,3
sergeant,6,1.10E-05,5,1.14E-05,9.47E-06,1,2
exchange,6,1.10E-05,3,6.83E-06,2.84E-05,3,2
argument,6,1.10E-05,5,1.14E-05,9.47E-06,1,3
liberate,6,1.10E-05,5,1.14E-05,9.47E-06,1,3
practice,6,1.10E-05,5,1.14E-05,9.47E-06,1,2
olympics,6,1.10E-05,4,9.11E-06,1.89E-05,2,3
sometime,6,1.10E-05,5,1.14E-05,9.47E-06,1,3
normandy,6,1.10E-05,5,1.14E-05,9.47E-06,1,3
landmark,6,1.10E-05,5,1.14E-05,9.47E-06,1,2
takeover,6,1.10E-05,3,6.83E-06,2.84E-05,3,3
emirates,6,1.10E-05,6,1.37E-05,0,0,3
shocking,6,1.10E-05,6,1.37E-05,0,0,2
suppress,6,1.10E-05,6,1.37E-05,0,0,2
betrayal,6,1.10E-05,6,1.37E-05,0,0,3
reversed,6,1.10E-05,6,1.37E-05,0,0,2
carrying,6,1.10E-05,6,1.37E-05,0,0,2
stealing,6,1.10E-05,6,1.37E-05,0,0,2
separate,6,1.10E-05,6,1.37E-05,0,0,3
prisoner,6,1.10E-05,6,1.37E-05,0,0,3
province,6,1.10E-05,6,1.37E-05,0,0,2
notified,6,1.10E-05,6,1.37E-05,0,0,3
contempt,6,1.10E-05,6,1.37E-05,0,0,2
supplies,6,1.10E-05,6,1.37E-05,0,0,2
relative,6,1.10E-05,6,1.37E-05,0,0,3
elements,6,1.10E-05,6,1.37E-05,0,0,3
produces,6,1.10E-05,6,1.37E-05,0,0,2
infected,6,1.10E-05,6,1.37E-05,0,0,2
infested,6,1.10E-05,6,1.37E-05,0,0,2
decisive,6,1.10E-05,6,1.37E-05,0,0,3
draining,6,1.10E-05,6,1.37E-05,0,0,2
agreeing,6,1.10E-05,6,1.37E-05,0,0,3
category,6,1.10E-05,6,1.37E-05,0,0,4
brussels,6,1.10E-05,6,1.37E-05,0,0,2
strassel,6,1.10E-05,6,1.37E-05,0,0,2
resolved,6,1.10E-05,6,1.37E-05,0,0,2
helsinki,6,1.10E-05,6,1.37E-05,0,0,3
launches,6,1.10E-05,6,1.37E-05,0,0,1
tragedies,6,1.10E-05,3,6.83E-06,2.84E-05,3,3
arguments,6,1.10E-05,4,9.11E-06,1.89E-05,2,3
organizer,6,1.10E-05,0,0,5.68E-05,6,4
launching,6,1.10E-05,3,6.83E-06,2.84E-05,3,2
estimated,6,1.10E-05,3,6.83E-06,2.84E-05,3,3
guarantee,6,1.10E-05,3,6.83E-06,2.84E-05,3,3
achieving,6,1.10E-05,5,1.14E-05,9.47E-06,1,3
deadlines,6,1.10E-05,0,0,5.68E-05,6,2
defunding,6,1.10E-05,4,9.11E-06,1.89E-05,2,3
unmatched,6,1.10E-05,5,1.14E-05,9.47E-06,1,2
delighted,6,1.10E-05,2,4.56E-06,3.79E-05,4,2
prominent,6,1.10E-05,5,1.14E-05,9.47E-06,1,3
depending,6,1.10E-05,5,1.14E-05,9.47E-06,1,3
purchases,6,1.10E-05,5,1.14E-05,9.47E-06,1,2
decimated,6,1.10E-05,6,1.37E-05,0,0,3
disgusted,6,1.10E-05,6,1.37E-05,0,0,2
provision,6,1.10E-05,6,1.37E-05,0,0,3
eradicate,6,1.10E-05,6,1.37E-05,0,0,4
demeaning,6,1.10E-05,6,1.37E-05,0,0,3
endorsing,6,1.10E-05,6,1.37E-05,0,0,3
deterrent,6,1.10E-05,6,1.37E-05,0,0,3
seemingly,6,1.10E-05,6,1.37E-05,0,0,3
accepting,6,1.10E-05,6,1.37E-05,0,0,3
responded,6,1.10E-05,6,1.37E-05,0,0,2
competing,6,1.10E-05,6,1.37E-05,0,0,3
lordstown,6,1.10E-05,6,1.37E-05,0,0,2
imploding,6,1.10E-05,6,1.37E-05,0,0,3
involving,6,1.10E-05,6,1.37E-05,0,0,3
christian,6,1.10E-05,6,1.37E-05,0,0,2
sleazebag,6,1.10E-05,6,1.37E-05,0,0,3
legislate,6,1.10E-05,6,1.37E-05,0,0,3
concluded,6,1.10E-05,6,1.37E-05,0,0,2
feinstein,6,1.10E-05,6,1.37E-05,0,0,2
operative,6,1.10E-05,6,1.37E-05,0,0,4
oversight,6,1.10E-05,6,1.37E-05,0,0,3
pressured,6,1.10E-05,6,1.37E-05,0,0,2
congenial,6,1.10E-05,6,1.37E-05,0,0,3
detention,6,1.10E-05,6,1.37E-05,0,0,3
connect,6,1.10E-05,6,1.37E-05,0,0,2
vetting,6,1.10E-05,6,1.37E-05,0,0,2
stunning,6,1.10E-05,5,1.14E-05,9.47E-06,1,2
mill,6,1.10E-05,2,4.56E-06,3.79E-05,4,1
falls,6,1.10E-05,5,1.14E-05,9.47E-06,1,1
hills,6,1.10E-05,6,1.37E-05,0,0,1
nelly,6,1.10E-05,6,1.37E-05,0,0,2
mollie,6,1.10E-05,6,1.37E-05,0,0,2
pulling,6,1.10E-05,3,6.83E-06,2.84E-05,3,2
collude,6,1.10E-05,6,1.37E-05,0,0,2
villages,6,1.10E-05,6,1.37E-05,0,0,2
killings,6,1.10E-05,6,1.37E-05,0,0,2
cancelled,6,1.10E-05,6,1.37E-05,0,0,2
ballistic,6,1.10E-05,6,1.37E-05,0,0,3
gallagher,6,1.10E-05,6,1.37E-05,0,0,3
enrollment,6,1.10E-05,1,2.28E-06,4.74E-05,5,3
wrongfully,6,1.10E-05,5,1.14E-05,9.47E-06,1,3
colleagues,6,1.10E-05,5,1.14E-05,9.47E-06,1,3
fulfilling,6,1.10E-05,6,1.37E-05,0,0,3
optimistic,6,1.10E-05,3,6.83E-06,2.84E-05,3,4
celebrates,6,1.10E-05,3,6.83E-06,2.84E-05,3,3
guarantees,6,1.10E-05,4,9.11E-06,1.89E-05,2,3
chancellor,6,1.10E-05,6,1.37E-05,0,0,3
designated,6,1.10E-05,5,1.14E-05,9.47E-06,1,3
households,6,1.10E-05,0,0,5.68E-05,6,3
struggling,6,1.10E-05,0,0,5.68E-05,6,2
disappoint,6,1.10E-05,5,1.14E-05,9.47E-06,1,3
beautifully,6,1.10E-05,6,1.37E-05,0,0,5
unemployed,6,1.10E-05,1,2.28E-06,4.74E-05,5,3
celebrated,6,1.10E-05,5,1.14E-05,9.47E-06,1,3
discovered,6,1.10E-05,6,1.37E-05,0,0,3
confirming,6,1.10E-05,6,1.37E-05,0,0,3
documented,6,1.10E-05,6,1.37E-05,0,0,3
powerhouse,6,1.10E-05,6,1.37E-05,0,0,3
automobile,6,1.10E-05,6,1.37E-05,0,0,5
courthouse,6,1.10E-05,6,1.37E-05,0,0,2
manchester,6,1.10E-05,6,1.37E-05,0,0,3
professionally,6,1.10E-05,6,1.37E-05,0,0,5
journalist,6,1.10E-05,6,1.37E-05,0,0,3
foreperson,6,1.10E-05,6,1.37E-05,0,0,4
federalist,6,1.10E-05,6,1.37E-05,0,0,4
disruption,6,1.10E-05,6,1.37E-05,0,0,3
unsuccessfully,6,1.10E-05,6,1.37E-05,0,0,5
rosenstein,6,1.10E-05,6,1.37E-05,0,0,3
underlying,6,1.10E-05,6,1.37E-05,0,0,3
membership,6,1.10E-05,6,1.37E-05,0,0,3
elite,6,1.10E-05,6,1.37E-05,0,0,2
critics,6,1.10E-05,5,1.14E-05,9.47E-06,1,2
inviting,6,1.10E-05,4,9.11E-06,1.89E-05,2,3
coalition,6,1.10E-05,5,1.14E-05,9.47E-06,1,3
expedited,6,1.10E-05,5,1.14E-05,9.47E-06,1,3
withdrawn,6,1.10E-05,6,1.37E-05,0,0,2
fitton,6,1.10E-05,6,1.37E-05,0,0,2
belittle,6,1.10E-05,6,1.37E-05,0,0,3
illegitimate,6,1.10E-05,6,1.37E-05,0,0,5
traditional,6,1.10E-05,6,1.37E-05,0,0,4
universities,6,1.10E-05,6,1.37E-05,0,0,5
gather,6,1.10E-05,5,1.14E-05,9.47E-06,1,2
slammed,6,1.10E-05,6,1.37E-05,0,0,1
appreciated,6,1.10E-05,5,1.14E-05,9.47E-06,1,3
outsourcing,6,1.10E-05,4,9.11E-06,1.89E-05,2,3
consolidate,6,1.10E-05,0,0,5.68E-05,6,4
appreciates,6,1.10E-05,5,1.14E-05,9.47E-06,1,3
infographic,6,1.10E-05,0,0,5.68E-05,6,4
sacrificing,6,1.10E-05,4,9.11E-06,1.89E-05,2,4
coordinated,6,1.10E-05,5,1.14E-05,9.47E-06,1,3
nominations,6,1.10E-05,5,1.14E-05,9.47E-06,1,4
compromised,6,1.10E-05,6,1.37E-05,0,0,3
fabrication,6,1.10E-05,6,1.37E-05,0,0,4
sovereignty,6,1.10E-05,6,1.37E-05,0,0,4
prosecution,6,1.10E-05,6,1.37E-05,0,0,4
improvement,6,1.10E-05,6,1.37E-05,0,0,4
consultants,6,1.10E-05,6,1.37E-05,0,0,3
interfering,6,1.10E-05,6,1.37E-05,0,0,4
restoration,6,1.10E-05,6,1.37E-05,0,0,4
communist,6,1.10E-05,6,1.37E-05,0,0,3
recommend,6,1.10E-05,6,1.37E-05,0,0,3
recommending,6,1.10E-05,6,1.37E-05,0,0,4
contribution,6,1.10E-05,3,6.83E-06,2.84E-05,3,4
temperatures,6,1.10E-05,3,6.83E-06,2.84E-05,3,4
alternatives,6,1.10E-05,6,1.37E-05,0,0,4
legislatures,6,1.10E-05,6,1.37E-05,0,0,4
distribution,6,1.10E-05,6,1.37E-05,0,0,4
conclusively,6,1.10E-05,6,1.37E-05,0,0,5
civilization,6,1.10E-05,6,1.37E-05,0,0,5
unbelievably,6,1.10E-05,6,1.37E-05,0,0,5
championship,6,1.10E-05,6,1.37E-05,0,0,3
schneiderman,6,1.10E-05,6,1.37E-05,0,0,3
requirements,6,1.10E-05,6,1.37E-05,0,0,4
apprehending,6,1.10E-05,6,1.37E-05,0,0,4
prosecutorial,6,1.10E-05,6,1.37E-05,0,0,5
groundbreaking,6,1.10E-05,4,9.11E-06,1.89E-05,2,3
sun,5,9.18E-06,1,2.28E-06,3.79E-05,4,1
ofa,5,9.18E-06,0,0,4.74E-05,5,1
eve,5,9.18E-06,4,9.11E-06,9.47E-06,1,1
dec,5,9.18E-06,3,6.83E-06,1.89E-05,2,1
hug,5,9.18E-06,0,0,4.74E-05,5,1
uaw,5,9.18E-06,4,9.11E-06,9.47E-06,1,1
sir,5,9.18E-06,4,9.11E-06,9.47E-06,1,1
gsa,5,9.18E-06,5,1.14E-05,0,0,1
tap,5,9.18E-06,5,1.14E-05,0,0,1
non,5,9.18E-06,5,1.14E-05,0,0,1
max,5,9.18E-06,5,1.14E-05,0,0,1
reg,5,9.18E-06,5,1.14E-05,0,0,1
sky,5,9.18E-06,5,1.14E-05,0,0,1
uss,5,9.18E-06,5,1.14E-05,0,0,1
sri,5,9.18E-06,5,1.14E-05,0,0,1
bars,5,9.18E-06,4,9.11E-06,9.47E-06,1,1
aids,5,9.18E-06,3,6.83E-06,1.89E-05,2,1
ears,5,9.18E-06,3,6.83E-06,1.89E-05,2,1
yard,5,9.18E-06,4,9.11E-06,9.47E-06,1,1
holy,5,9.18E-06,3,6.83E-06,1.89E-05,2,2
nate,5,9.18E-06,4,9.11E-06,9.47E-06,1,1
aint,5,9.18E-06,1,2.28E-06,3.79E-05,4,1
gays,5,9.18E-06,1,2.28E-06,3.79E-05,4,1
mars,5,9.18E-06,2,4.56E-06,2.84E-05,3,1
bain,5,9.18E-06,0,0,4.74E-05,5,1
neil,5,9.18E-06,3,6.83E-06,1.89E-05,2,1
dear,5,9.18E-06,3,6.83E-06,1.89E-05,2,1
bret,5,9.18E-06,5,1.14E-05,0,0,1
thin,5,9.18E-06,5,1.14E-05,0,0,1
clip,5,9.18E-06,5,1.14E-05,0,0,1
lows,5,9.18E-06,5,1.14E-05,0,0,1
jake,5,9.18E-06,5,1.14E-05,0,0,1
mobs,5,9.18E-06,5,1.14E-05,0,0,1
pork,5,9.18E-06,5,1.14E-05,0,0,1
ugly,5,9.18E-06,5,1.14E-05,0,0,2
Ø¯Ø±,5,9.18E-06,5,1.14E-05,0,0,#ERROR!
pigs,5,9.18E-06,5,1.14E-05,0,0,1
beds,5,9.18E-06,5,1.14E-05,0,0,1
lacy,5,9.18E-06,5,1.14E-05,0,0,2
phil,5,9.18E-06,5,1.14E-05,0,0,1
salt,5,9.18E-06,5,1.14E-05,0,0,1
fbis,5,9.18E-06,5,1.14E-05,0,0,1
dowd,5,9.18E-06,5,1.14E-05,0,0,1
rage,5,9.18E-06,5,1.14E-05,0,0,1
duly,5,9.18E-06,5,1.14E-05,0,0,2
wead,5,9.18E-06,5,1.14E-05,0,0,1
erie,5,9.18E-06,5,1.14E-05,0,0,2
lamb,5,9.18E-06,5,1.14E-05,0,0,1
trap,5,9.18E-06,5,1.14E-05,0,0,1
mans,5,9.18E-06,5,1.14E-05,0,0,1
vain,5,9.18E-06,5,1.14E-05,0,0,1
dogs,5,9.18E-06,5,1.14E-05,0,0,1
dick,5,9.18E-06,5,1.14E-05,0,0,1
rude,5,9.18E-06,5,1.14E-05,0,0,1
shep,5,9.18E-06,5,1.14E-05,0,0,1
nang,5,9.18E-06,5,1.14E-05,0,0,1
boys,5,9.18E-06,5,1.14E-05,0,0,1
cpac,5,9.18E-06,5,1.14E-05,0,0,1
fiat,5,9.18E-06,5,1.14E-05,0,0,1
spin,5,9.18E-06,5,1.14E-05,0,0,1
ohrs,5,9.18E-06,5,1.14E-05,0,0,1
dole,5,9.18E-06,5,1.14E-05,0,0,2
euro,5,9.18E-06,5,1.14E-05,0,0,2
foul,5,9.18E-06,5,1.14E-05,0,0,1
dance,5,9.18E-06,0,0,4.74E-05,5,1
grown,5,9.18E-06,2,4.56E-06,2.84E-05,3,1
hosts,5,9.18E-06,3,6.83E-06,1.89E-05,2,1
risks,5,9.18E-06,1,2.28E-06,3.79E-05,4,1
holds,5,9.18E-06,3,6.83E-06,1.89E-05,2,1
ports,5,9.18E-06,4,9.11E-06,9.47E-06,1,1
lanes,5,9.18E-06,4,9.11E-06,9.47E-06,1,1
earns,5,9.18E-06,1,2.28E-06,3.79E-05,4,1
elses,5,9.18E-06,3,6.83E-06,1.89E-05,2,1
kicks,5,9.18E-06,0,0,4.74E-05,5,1
pause,5,9.18E-06,3,6.83E-06,1.89E-05,2,1
chart,5,9.18E-06,2,4.56E-06,2.84E-05,3,1
sandy,5,9.18E-06,1,2.28E-06,3.79E-05,4,2
carol,5,9.18E-06,4,9.11E-06,9.47E-06,1,2
faces,5,9.18E-06,2,4.56E-06,2.84E-05,3,1
madam,5,9.18E-06,3,6.83E-06,1.89E-05,2,2
flood,5,9.18E-06,4,9.11E-06,9.47E-06,1,1
teach,5,9.18E-06,3,6.83E-06,1.89E-05,2,1
roots,5,9.18E-06,4,9.11E-06,9.47E-06,1,1
cared,5,9.18E-06,2,4.56E-06,2.84E-05,3,1
cliff,5,9.18E-06,2,4.56E-06,2.84E-05,3,1
trend,5,9.18E-06,4,9.11E-06,9.47E-06,1,1
colin,5,9.18E-06,3,6.83E-06,1.89E-05,2,2
pizza,5,9.18E-06,2,4.56E-06,2.84E-05,3,2
click,5,9.18E-06,4,9.11E-06,9.47E-06,1,1
ryans,5,9.18E-06,0,0,4.74E-05,5,1
guide,5,9.18E-06,3,6.83E-06,1.89E-05,2,1
freed,5,9.18E-06,2,4.56E-06,2.84E-05,3,1
shoot,5,9.18E-06,4,9.11E-06,9.47E-06,1,1
image,5,9.18E-06,1,2.28E-06,3.79E-05,4,2
firms,5,9.18E-06,3,6.83E-06,1.89E-05,2,1
derby,5,9.18E-06,4,9.11E-06,9.47E-06,1,2
posts,5,9.18E-06,4,9.11E-06,9.47E-06,1,1
shirt,5,9.18E-06,0,0,4.74E-05,5,1
shred,5,9.18E-06,4,9.11E-06,9.47E-06,1,#ERROR!
trips,5,9.18E-06,4,9.11E-06,9.47E-06,1,1
store,5,9.18E-06,3,6.83E-06,1.89E-05,2,1
bench,5,9.18E-06,4,9.11E-06,9.47E-06,1,1
midst,5,9.18E-06,4,9.11E-06,9.47E-06,1,1
goals,5,9.18E-06,2,4.56E-06,2.84E-05,3,1
ailes,5,9.18E-06,5,1.14E-05,0,0,2
stahl,5,9.18E-06,5,1.14E-05,0,0,1
truck,5,9.18E-06,5,1.14E-05,0,0,1
sasse,5,9.18E-06,5,1.14E-05,0,0,1
macon,5,9.18E-06,5,1.14E-05,0,0,2
rumor,5,9.18E-06,5,1.14E-05,0,0,2
flint,5,9.18E-06,5,1.14E-05,0,0,1
creed,5,9.18E-06,5,1.14E-05,0,0,1
blind,5,9.18E-06,5,1.14E-05,0,0,1
occur,5,9.18E-06,5,1.14E-05,0,0,2
souls,5,9.18E-06,5,1.14E-05,0,0,1
lefts,5,9.18E-06,5,1.14E-05,0,0,1
inept,5,9.18E-06,5,1.14E-05,0,0,2
cures,5,9.18E-06,5,1.14E-05,0,0,1
irans,5,9.18E-06,5,1.14E-05,0,0,2
perry,5,9.18E-06,5,1.14E-05,0,0,2
motor,5,9.18E-06,5,1.14E-05,0,0,2
forth,5,9.18E-06,5,1.14E-05,0,0,1
spare,5,9.18E-06,5,1.14E-05,0,0,1
types,5,9.18E-06,5,1.14E-05,0,0,1
venue,5,9.18E-06,5,1.14E-05,0,0,2
print,5,9.18E-06,5,1.14E-05,0,0,1
nunes,5,9.18E-06,5,1.14E-05,0,0,1
paint,5,9.18E-06,5,1.14E-05,0,0,1
files,5,9.18E-06,5,1.14E-05,0,0,2
rival,5,9.18E-06,5,1.14E-05,0,0,2
louis,5,9.18E-06,5,1.14E-05,0,0,2
susan,5,9.18E-06,5,1.14E-05,0,0,2
woods,5,9.18E-06,5,1.14E-05,0,0,1
lavar,5,9.18E-06,5,1.14E-05,0,0,2
jared,5,9.18E-06,5,1.14E-05,0,0,1
lopez,5,9.18E-06,5,1.14E-05,0,0,2
quest,5,9.18E-06,5,1.14E-05,0,0,1
piggy,5,9.18E-06,5,1.14E-05,0,0,2
nicer,5,9.18E-06,5,1.14E-05,0,0,2
adept,5,9.18E-06,5,1.14E-05,0,0,2
lanka,5,9.18E-06,5,1.14E-05,0,0,2
closes,5,9.18E-06,4,9.11E-06,9.47E-06,1,1
cruise,5,9.18E-06,3,6.83E-06,1.89E-05,2,1
denial,5,9.18E-06,0,0,4.74E-05,5,2
invade,5,9.18E-06,4,9.11E-06,9.47E-06,1,2
laying,5,9.18E-06,1,2.28E-06,3.79E-05,4,2
enrich,5,9.18E-06,4,9.11E-06,9.47E-06,1,2
builds,5,9.18E-06,2,4.56E-06,2.84E-05,3,1
latino,5,9.18E-06,1,2.28E-06,3.79E-05,4,3
jackie,5,9.18E-06,3,6.83E-06,1.89E-05,2,2
ideals,5,9.18E-06,1,2.28E-06,3.79E-05,4,2
gender,5,9.18E-06,0,0,4.74E-05,5,2
claire,5,9.18E-06,4,9.11E-06,9.47E-06,1,1
trucks,5,9.18E-06,4,9.11E-06,9.47E-06,1,1
expire,5,9.18E-06,1,2.28E-06,3.79E-05,4,2
corner,5,9.18E-06,3,6.83E-06,1.89E-05,2,2
africa,5,9.18E-06,3,6.83E-06,1.89E-05,2,3
diwali,5,9.18E-06,4,9.11E-06,9.47E-06,1,3
betray,5,9.18E-06,3,6.83E-06,1.89E-05,2,2
movies,5,9.18E-06,4,9.11E-06,9.47E-06,1,2
drives,5,9.18E-06,3,6.83E-06,1.89E-05,2,1
define,5,9.18E-06,4,9.11E-06,9.47E-06,1,2
fooled,5,9.18E-06,4,9.11E-06,9.47E-06,1,1
lesson,5,9.18E-06,2,4.56E-06,2.84E-05,3,2
shadow,5,9.18E-06,3,6.83E-06,1.89E-05,2,2
wisely,5,9.18E-06,4,9.11E-06,9.47E-06,1,3
norway,5,9.18E-06,4,9.11E-06,9.47E-06,1,2
uphold,5,9.18E-06,4,9.11E-06,9.47E-06,1,2
tucson,5,9.18E-06,3,6.83E-06,1.89E-05,2,2
treaty,5,9.18E-06,4,9.11E-06,9.47E-06,1,2
export,5,9.18E-06,4,9.11E-06,9.47E-06,1,2
height,5,9.18E-06,4,9.11E-06,9.47E-06,1,1
survey,5,9.18E-06,4,9.11E-06,9.47E-06,1,2
arrive,5,9.18E-06,5,1.14E-05,0,0,2
denies,5,9.18E-06,5,1.14E-05,0,0,2
equals,5,9.18E-06,5,1.14E-05,0,0,2
castro,5,9.18E-06,5,1.14E-05,0,0,2
verify,5,9.18E-06,5,1.14E-05,0,0,3
hotels,5,9.18E-06,5,1.14E-05,0,0,2
lifted,5,9.18E-06,5,1.14E-05,0,0,1
obrien,5,9.18E-06,5,1.14E-05,0,0,2
ashley,5,9.18E-06,5,1.14E-05,0,0,2
motion,5,9.18E-06,5,1.14E-05,0,0,2
speedy,5,9.18E-06,5,1.14E-05,0,0,2
choked,5,9.18E-06,5,1.14E-05,0,0,1
planes,5,9.18E-06,5,1.14E-05,0,0,1
marsha,5,9.18E-06,5,1.14E-05,0,0,2
fredos,5,9.18E-06,5,1.14E-05,0,0,2
tuning,5,9.18E-06,5,1.14E-05,0,0,2
occupy,5,9.18E-06,5,1.14E-05,0,0,3
prizes,5,9.18E-06,5,1.14E-05,0,0,1
raging,5,9.18E-06,5,1.14E-05,0,0,2
hidden,5,9.18E-06,5,1.14E-05,0,0,2
wished,5,9.18E-06,5,1.14E-05,0,0,1
crying,5,9.18E-06,5,1.14E-05,0,0,1
marcus,5,9.18E-06,5,1.14E-05,0,0,2
tenure,5,9.18E-06,5,1.14E-05,0,0,2
hourly,5,9.18E-06,5,1.14E-05,0,0,2
frozen,5,9.18E-06,5,1.14E-05,0,0,2
racism,5,9.18E-06,5,1.14E-05,0,0,2
deeper,5,9.18E-06,5,1.14E-05,0,0,2
kudlow,5,9.18E-06,5,1.14E-05,0,0,2
gordon,5,9.18E-06,5,1.14E-05,0,0,2
dustin,5,9.18E-06,5,1.14E-05,0,0,2
greats,5,9.18E-06,5,1.14E-05,0,0,1
lesser,5,9.18E-06,5,1.14E-05,0,0,2
twelve,5,9.18E-06,5,1.14E-05,0,0,1
heroic,5,9.18E-06,5,1.14E-05,0,0,2
ripoff,5,9.18E-06,5,1.14E-05,0,0,2
toyota,5,9.18E-06,5,1.14E-05,0,0,3
spicer,5,9.18E-06,5,1.14E-05,0,0,2
panama,5,9.18E-06,5,1.14E-05,0,0,3
conway,5,9.18E-06,5,1.14E-05,0,0,2
inflow,5,9.18E-06,5,1.14E-05,0,0,2
knight,5,9.18E-06,5,1.14E-05,0,0,1
staged,5,9.18E-06,5,1.14E-05,0,0,1
poison,5,9.18E-06,5,1.14E-05,0,0,2
cohens,5,9.18E-06,5,1.14E-05,0,0,2
harley,5,9.18E-06,5,1.14E-05,0,0,2
hating,5,9.18E-06,5,1.14E-05,0,0,2
maggie,5,9.18E-06,5,1.14E-05,0,0,2
aspect,5,9.18E-06,5,1.14E-05,0,0,2
tripled,5,9.18E-06,1,2.28E-06,3.79E-05,4,1
lowered,5,9.18E-06,4,9.11E-06,9.47E-06,1,2
justify,5,9.18E-06,4,9.11E-06,9.47E-06,1,3
warning,5,9.18E-06,4,9.11E-06,9.47E-06,1,2
patient,5,9.18E-06,3,6.83E-06,1.89E-05,2,2
bracket,5,9.18E-06,0,0,4.74E-05,5,2
picking,5,9.18E-06,2,4.56E-06,2.84E-05,3,2
shining,5,9.18E-06,3,6.83E-06,1.89E-05,2,2
privacy,5,9.18E-06,2,4.56E-06,2.84E-05,3,3
thrives,5,9.18E-06,1,2.28E-06,3.79E-05,4,1
decides,5,9.18E-06,3,6.83E-06,1.89E-05,2,2
marking,5,9.18E-06,2,4.56E-06,2.84E-05,3,2
trailer,5,9.18E-06,0,0,4.74E-05,5,2
marched,5,9.18E-06,0,0,4.74E-05,5,1
noticed,5,9.18E-06,4,9.11E-06,9.47E-06,1,2
ladders,5,9.18E-06,0,0,4.74E-05,5,2
opposes,5,9.18E-06,1,2.28E-06,3.79E-05,4,2
touched,5,9.18E-06,3,6.83E-06,1.89E-05,2,1
ensures,5,9.18E-06,2,4.56E-06,2.84E-05,3,2
premium,5,9.18E-06,2,4.56E-06,2.84E-05,3,2
rebates,5,9.18E-06,3,6.83E-06,1.89E-05,2,2
setback,5,9.18E-06,4,9.11E-06,9.47E-06,1,2
founded,5,9.18E-06,3,6.83E-06,1.89E-05,2,1
knocked,5,9.18E-06,1,2.28E-06,3.79E-05,4,1
schultz,5,9.18E-06,4,9.11E-06,9.47E-06,1,1
pretend,5,9.18E-06,4,9.11E-06,9.47E-06,1,2
adviser,5,9.18E-06,4,9.11E-06,9.47E-06,1,3
engines,5,9.18E-06,4,9.11E-06,9.47E-06,1,2
freeman,5,9.18E-06,4,9.11E-06,9.47E-06,1,2
turnout,5,9.18E-06,3,6.83E-06,1.89E-05,2,2
creator,5,9.18E-06,4,9.11E-06,9.47E-06,1,2
welfare,5,9.18E-06,3,6.83E-06,1.89E-05,2,2
crowded,5,9.18E-06,4,9.11E-06,9.47E-06,1,1
costing,5,9.18E-06,4,9.11E-06,9.47E-06,1,2
islands,5,9.18E-06,3,6.83E-06,1.89E-05,2,2
beaches,5,9.18E-06,4,9.11E-06,9.47E-06,1,1
avoided,5,9.18E-06,4,9.11E-06,9.47E-06,1,2
unusual,5,9.18E-06,4,9.11E-06,9.47E-06,1,3
stepped,5,9.18E-06,4,9.11E-06,9.47E-06,1,1
barrels,5,9.18E-06,4,9.11E-06,9.47E-06,1,2
payment,5,9.18E-06,4,9.11E-06,9.47E-06,1,2
checked,5,9.18E-06,4,9.11E-06,9.47E-06,1,1
chamber,5,9.18E-06,4,9.11E-06,9.47E-06,1,2
greeted,5,9.18E-06,4,9.11E-06,9.47E-06,1,1
unleash,5,9.18E-06,4,9.11E-06,9.47E-06,1,2
damages,5,9.18E-06,4,9.11E-06,9.47E-06,1,2
devoted,5,9.18E-06,4,9.11E-06,9.47E-06,1,2
smoking,5,9.18E-06,4,9.11E-06,9.47E-06,1,2
moderna,5,9.18E-06,5,1.14E-05,0,0,3
viewers,5,9.18E-06,5,1.14E-05,0,0,2
located,5,9.18E-06,5,1.14E-05,0,0,2
airtime,5,9.18E-06,5,1.14E-05,0,0,2
concede,5,9.18E-06,5,1.14E-05,0,0,2
drawing,5,9.18E-06,5,1.14E-05,0,0,2
reaches,5,9.18E-06,5,1.14E-05,0,0,1
bombing,5,9.18E-06,5,1.14E-05,0,0,2
rigging,5,9.18E-06,5,1.14E-05,0,0,2
midwest,5,9.18E-06,5,1.14E-05,0,0,2
animals,5,9.18E-06,5,1.14E-05,0,0,3
roughly,5,9.18E-06,5,1.14E-05,0,0,2
angeles,5,9.18E-06,5,1.14E-05,0,0,3
blowout,5,9.18E-06,5,1.14E-05,0,0,2
classic,5,9.18E-06,5,1.14E-05,0,0,2
carnage,5,9.18E-06,5,1.14E-05,0,0,2
furious,5,9.18E-06,5,1.14E-05,0,0,3
satisfy,5,9.18E-06,5,1.14E-05,0,0,3
flights,5,9.18E-06,5,1.14E-05,0,0,1
stephen,5,9.18E-06,5,1.14E-05,0,0,2
krugman,5,9.18E-06,5,1.14E-05,0,0,2
wheeler,5,9.18E-06,5,1.14E-05,0,0,2
daytona,5,9.18E-06,5,1.14E-05,0,0,3
damaged,5,9.18E-06,5,1.14E-05,0,0,2
natalie,5,9.18E-06,5,1.14E-05,0,0,3
intense,5,9.18E-06,5,1.14E-05,0,0,2
scourge,5,9.18E-06,5,1.14E-05,0,0,1
kremlin,5,9.18E-06,5,1.14E-05,0,0,2
griffin,5,9.18E-06,5,1.14E-05,0,0,2
boarder,5,9.18E-06,5,1.14E-05,0,0,2
aspects,5,9.18E-06,5,1.14E-05,0,0,2
gorsuch,5,9.18E-06,5,1.14E-05,0,0,2
whereas,5,9.18E-06,5,1.14E-05,0,0,2
charade,5,9.18E-06,5,1.14E-05,0,0,2
trudeau,5,9.18E-06,5,1.14E-05,0,0,3
servers,5,9.18E-06,5,1.14E-05,0,0,2
omnibus,5,9.18E-06,5,1.14E-05,0,0,3
coffers,5,9.18E-06,5,1.14E-05,0,0,2
midterm,5,9.18E-06,5,1.14E-05,0,0,2
turkish,5,9.18E-06,5,1.14E-05,0,0,2
obrador,5,9.18E-06,5,1.14E-05,0,0,3
barrack,5,9.18E-06,5,1.14E-05,0,0,2
existed,5,9.18E-06,5,1.14E-05,0,0,2
readily,5,9.18E-06,5,1.14E-05,0,0,3
bribery,5,9.18E-06,5,1.14E-05,0,0,3
feeding,5,9.18E-06,5,1.14E-05,0,0,2
clemson,5,9.18E-06,5,1.14E-05,0,0,2
cowards,5,9.18E-06,5,1.14E-05,0,0,2
dancing,5,9.18E-06,5,1.14E-05,0,0,2
coyotes,5,9.18E-06,5,1.14E-05,0,0,2
shipping,5,9.18E-06,3,6.83E-06,1.89E-05,2,2
boosting,5,9.18E-06,2,4.56E-06,2.84E-05,3,2
reliable,5,9.18E-06,3,6.83E-06,1.89E-05,2,3
lifeline,5,9.18E-06,1,2.28E-06,3.79E-05,4,3
provides,5,9.18E-06,3,6.83E-06,1.89E-05,2,2
rendered,5,9.18E-06,2,4.56E-06,2.84E-05,3,2
requires,5,9.18E-06,0,0,4.74E-05,5,2
chicagos,5,9.18E-06,4,9.11E-06,9.47E-06,1,3
overcome,5,9.18E-06,4,9.11E-06,9.47E-06,1,3
cheering,5,9.18E-06,2,4.56E-06,2.84E-05,3,2
enduring,5,9.18E-06,3,6.83E-06,1.89E-05,2,3
educated,5,9.18E-06,4,9.11E-06,9.47E-06,1,3
suddenly,5,9.18E-06,1,2.28E-06,3.79E-05,4,3
distance,5,9.18E-06,4,9.11E-06,9.47E-06,1,2
struggle,5,9.18E-06,2,4.56E-06,2.84E-05,3,2
canceled,5,9.18E-06,4,9.11E-06,9.47E-06,1,2
sabotage,5,9.18E-06,4,9.11E-06,9.47E-06,1,3
bailouts,5,9.18E-06,2,4.56E-06,2.84E-05,3,2
monopoly,5,9.18E-06,4,9.11E-06,9.47E-06,1,4
patience,5,9.18E-06,3,6.83E-06,1.89E-05,2,2
ignoring,5,9.18E-06,2,4.56E-06,2.84E-05,3,3
shameful,5,9.18E-06,4,9.11E-06,9.47E-06,1,3
insulted,5,9.18E-06,1,2.28E-06,3.79E-05,4,2
handouts,5,9.18E-06,1,2.28E-06,3.79E-05,4,2
projects,5,9.18E-06,4,9.11E-06,9.47E-06,1,2
expenses,5,9.18E-06,4,9.11E-06,9.47E-06,1,2
selected,5,9.18E-06,3,6.83E-06,1.89E-05,2,2
premiere,5,9.18E-06,0,0,4.74E-05,5,2
japanese,5,9.18E-06,4,9.11E-06,9.47E-06,1,3
mornings,5,9.18E-06,4,9.11E-06,9.47E-06,1,2
resource,5,9.18E-06,3,6.83E-06,1.89E-05,2,2
debating,5,9.18E-06,4,9.11E-06,9.47E-06,1,3
nominees,5,9.18E-06,4,9.11E-06,9.47E-06,1,3
tuesdays,5,9.18E-06,3,6.83E-06,1.89E-05,2,2
realized,5,9.18E-06,5,1.14E-05,0,0,2
bleeding,5,9.18E-06,5,1.14E-05,0,0,2
engineer,5,9.18E-06,5,1.14E-05,0,0,3
morrisey,5,9.18E-06,5,1.14E-05,0,0,3
scranton,5,9.18E-06,5,1.14E-05,0,0,2
smoothly,5,9.18E-06,5,1.14E-05,0,0,2
hagedorn,5,9.18E-06,5,1.14E-05,0,0,3
slippery,5,9.18E-06,5,1.14E-05,0,0,3
downward,5,9.18E-06,5,1.14E-05,0,0,2
mentions,5,9.18E-06,5,1.14E-05,0,0,2
superior,5,9.18E-06,5,1.14E-05,0,0,3
bachelor,5,9.18E-06,5,1.14E-05,0,0,3
aviation,5,9.18E-06,5,1.14E-05,0,0,3
informer,5,9.18E-06,5,1.14E-05,0,0,3
airwaves,5,9.18E-06,5,1.14E-05,0,0,2
warrants,5,9.18E-06,5,1.14E-05,0,0,2
geniuses,5,9.18E-06,5,1.14E-05,0,0,2
suggests,5,9.18E-06,5,1.14E-05,0,0,2
terrence,5,9.18E-06,5,1.14E-05,0,0,2
dealings,5,9.18E-06,5,1.14E-05,0,0,2
mulvaney,5,9.18E-06,5,1.14E-05,0,0,3
insisted,5,9.18E-06,5,1.14E-05,0,0,2
clueless,5,9.18E-06,5,1.14E-05,0,0,2
examples,5,9.18E-06,5,1.14E-05,0,0,3
vigilant,5,9.18E-06,5,1.14E-05,0,0,3
cleaning,5,9.18E-06,5,1.14E-05,0,0,2
corridor,5,9.18E-06,5,1.14E-05,0,0,3
perished,5,9.18E-06,5,1.14E-05,0,0,2
emphasis,5,9.18E-06,5,1.14E-05,0,0,3
highways,5,9.18E-06,5,1.14E-05,0,0,2
catholic,5,9.18E-06,5,1.14E-05,0,0,3
resigned,5,9.18E-06,5,1.14E-05,0,0,2
distract,5,9.18E-06,5,1.14E-05,0,0,2
confirms,5,9.18E-06,5,1.14E-05,0,0,2
demented,5,9.18E-06,5,1.14E-05,0,0,2
warmbier,5,9.18E-06,5,1.14E-05,0,0,2
herridge,5,9.18E-06,5,1.14E-05,0,0,2
buzzfeed,5,9.18E-06,5,1.14E-05,0,0,2
smocking,5,9.18E-06,5,1.14E-05,0,0,2
comedian,5,9.18E-06,5,1.14E-05,0,0,3
overflow,5,9.18E-06,5,1.14E-05,0,0,3
hardened,5,9.18E-06,5,1.14E-05,0,0,2
iranians,5,9.18E-06,5,1.14E-05,0,0,3
deblasio,5,9.18E-06,5,1.14E-05,0,0,3
township,5,9.18E-06,5,1.14E-05,0,0,2
sinclair,5,9.18E-06,5,1.14E-05,0,0,2
penn,5,9.18E-06,5,1.14E-05,0,0,1
stunned,5,9.18E-06,5,1.14E-05,0,0,1
personnel,5,9.18E-06,4,9.11E-06,9.47E-06,1,3
surrender,5,9.18E-06,4,9.11E-06,9.47E-06,1,3
organized,5,9.18E-06,4,9.11E-06,9.47E-06,1,3
preschool,5,9.18E-06,0,0,4.74E-05,5,2
addressed,5,9.18E-06,3,6.83E-06,1.89E-05,2,2
conspired,5,9.18E-06,4,9.11E-06,9.47E-06,1,2
dismantle,5,9.18E-06,4,9.11E-06,9.47E-06,1,3
backstage,5,9.18E-06,0,0,4.74E-05,5,2
shutdowns,5,9.18E-06,4,9.11E-06,9.47E-06,1,2
magazines,5,9.18E-06,4,9.11E-06,9.47E-06,1,3
dependent,5,9.18E-06,1,2.28E-06,3.79E-05,4,3
lobbyists,5,9.18E-06,4,9.11E-06,9.47E-06,1,2
delegates,5,9.18E-06,4,9.11E-06,9.47E-06,1,3
expressed,5,9.18E-06,4,9.11E-06,9.47E-06,1,2
precedent,5,9.18E-06,4,9.11E-06,9.47E-06,1,3
implement,5,9.18E-06,2,4.56E-06,2.84E-05,3,3
recovered,5,9.18E-06,4,9.11E-06,9.47E-06,1,3
reviewing,5,9.18E-06,4,9.11E-06,9.47E-06,1,3
kellyanne,5,9.18E-06,5,1.14E-05,0,0,2
conducted,5,9.18E-06,4,9.11E-06,9.47E-06,1,2
instances,5,9.18E-06,5,1.14E-05,0,0,2
activists,5,9.18E-06,5,1.14E-05,0,0,3
promoting,5,9.18E-06,5,1.14E-05,0,0,3
egregious,5,9.18E-06,5,1.14E-05,0,0,4
successes,5,9.18E-06,5,1.14E-05,0,0,2
obnoxious,5,9.18E-06,5,1.14E-05,0,0,4
assaulted,5,9.18E-06,5,1.14E-05,0,0,2
christina,5,9.18E-06,5,1.14E-05,0,0,3
watchable,5,9.18E-06,5,1.14E-05,0,0,3
violating,5,9.18E-06,5,1.14E-05,0,0,3
subsidize,5,9.18E-06,5,1.14E-05,0,0,3
apparatus,5,9.18E-06,5,1.14E-05,0,0,4
cowardice,5,9.18E-06,5,1.14E-05,0,0,3
atrocious,5,9.18E-06,5,1.14E-05,0,0,4
onslaught,5,9.18E-06,5,1.14E-05,0,0,2
fraternal,5,9.18E-06,5,1.14E-05,0,0,3
pipelines,5,9.18E-06,5,1.14E-05,0,0,3
worldwide,5,9.18E-06,5,1.14E-05,0,0,2
kimberley,5,9.18E-06,5,1.14E-05,0,0,3
triggered,5,9.18E-06,5,1.14E-05,0,0,2
dominated,5,9.18E-06,5,1.14E-05,0,0,3
historian,5,9.18E-06,5,1.14E-05,0,0,3
declaring,5,9.18E-06,5,1.14E-05,0,0,3
embarrass,5,9.18E-06,5,1.14E-05,0,0,3
endlessly,5,9.18E-06,5,1.14E-05,0,0,3
incapable,5,9.18E-06,5,1.14E-05,0,0,4
gentleman,5,9.18E-06,5,1.14E-05,0,0,3
selection,5,9.18E-06,5,1.14E-05,0,0,3
roosevelt,5,9.18E-06,5,1.14E-05,0,0,3
extremist,5,9.18E-06,5,1.14E-05,0,0,3
fabricate,5,9.18E-06,5,1.14E-05,0,0,3
retailers,5,9.18E-06,5,1.14E-05,0,0,3
renovated,5,9.18E-06,5,1.14E-05,0,0,3
survivors,5,9.18E-06,5,1.14E-05,0,0,3
clearance,5,9.18E-06,5,1.14E-05,0,0,2
occasions,5,9.18E-06,5,1.14E-05,0,0,3
imbalance,5,9.18E-06,5,1.14E-05,0,0,3
testified,5,9.18E-06,5,1.14E-05,0,0,3
innovative,5,9.18E-06,3,6.83E-06,1.89E-05,2,4
cincinnati,5,9.18E-06,5,1.14E-05,0,0,4
settle,5,9.18E-06,3,6.83E-06,1.89E-05,2,2
betting,5,9.18E-06,1,2.28E-06,3.79E-05,4,2
attempts,5,9.18E-06,3,6.83E-06,1.89E-05,2,2
attendance,5,9.18E-06,5,1.14E-05,0,0,3
cell,5,9.18E-06,5,1.14E-05,0,0,1
chattanooga,5,9.18E-06,4,9.11E-06,9.47E-06,1,4
pills,5,9.18E-06,3,6.83E-06,1.89E-05,2,1
scully,5,9.18E-06,5,1.14E-05,0,0,2
keller,5,9.18E-06,5,1.14E-05,0,0,2
gillum,5,9.18E-06,5,1.14E-05,0,0,2
nellie,5,9.18E-06,5,1.14E-05,0,0,2
filling,5,9.18E-06,5,1.14E-05,0,0,2
mcsally,5,9.18E-06,5,1.14E-05,0,0,2
dingell,5,9.18E-06,5,1.14E-05,0,0,2
softball,5,9.18E-06,5,1.14E-05,0,0,2
caldwell,5,9.18E-06,5,1.14E-05,0,0,2
halloween,5,9.18E-06,1,2.28E-06,3.79E-05,4,3
pollsters,5,9.18E-06,5,1.14E-05,0,0,2
louisville,5,9.18E-06,4,9.11E-06,9.47E-06,1,3
greenville,5,9.18E-06,5,1.14E-05,0,0,2
powerfully,5,9.18E-06,5,1.14E-05,0,0,4
rightfully,5,9.18E-06,5,1.14E-05,0,0,3
challenging,5,9.18E-06,3,6.83E-06,1.89E-05,2,3
essentially,5,9.18E-06,5,1.14E-05,0,0,4
successfully,5,9.18E-06,5,1.14E-05,0,0,4
unparalleled,5,9.18E-06,5,1.14E-05,0,0,4
multimillionaires,5,9.18E-06,0,0,4.74E-05,5,5
lit,5,9.18E-06,1,2.28E-06,3.79E-05,4,1
grit,5,9.18E-06,4,9.11E-06,9.47E-06,1,1
diplomatic,5,9.18E-06,4,9.11E-06,9.47E-06,1,4
accomplish,5,9.18E-06,3,6.83E-06,1.89E-05,2,3
unit,5,9.18E-06,4,9.11E-06,9.47E-06,1,2
screenings,5,9.18E-06,1,2.28E-06,3.79E-05,4,2
frustrated,5,9.18E-06,3,6.83E-06,1.89E-05,2,2
principles,5,9.18E-06,3,6.83E-06,1.89E-05,2,3
preventing,5,9.18E-06,1,2.28E-06,3.79E-05,4,3
pretending,5,9.18E-06,4,9.11E-06,9.47E-06,1,3
petersburg,5,9.18E-06,4,9.11E-06,9.47E-06,1,3
explaining,5,9.18E-06,4,9.11E-06,9.47E-06,1,3
presenting,5,9.18E-06,3,6.83E-06,1.89E-05,2,3
judgeships,5,9.18E-06,4,9.11E-06,9.47E-06,1,3
unyielding,5,9.18E-06,4,9.11E-06,9.47E-06,1,4
vulnerable,5,9.18E-06,5,1.14E-05,0,0,4
conclusive,5,9.18E-06,5,1.14E-05,0,0,3
invaluable,5,9.18E-06,5,1.14E-05,0,0,4
await,5,9.18E-06,4,9.11E-06,9.47E-06,1,2
chinavirus,5,9.18E-06,5,1.14E-05,0,0,4
assessment,5,9.18E-06,5,1.14E-05,0,0,3
procedures,5,9.18E-06,5,1.14E-05,0,0,3
purchasing,5,9.18E-06,5,1.14E-05,0,0,3
persecuted,5,9.18E-06,5,1.14E-05,0,0,3
impressive,5,9.18E-06,5,1.14E-05,0,0,3
completion,5,9.18E-06,5,1.14E-05,0,0,3
supportive,5,9.18E-06,5,1.14E-05,0,0,3
thoroughly,5,9.18E-06,5,1.14E-05,0,0,3
bloombergs,5,9.18E-06,5,1.14E-05,0,0,2
untruthful,5,9.18E-06,5,1.14E-05,0,0,3
visits,5,9.18E-06,2,4.56E-06,2.84E-05,3,2
associates,5,9.18E-06,5,1.14E-05,0,0,3
treatments,5,9.18E-06,5,1.14E-05,0,0,2
mclaughlin,5,9.18E-06,5,1.14E-05,0,0,2
separately,5,9.18E-06,5,1.14E-05,0,0,5
permit,5,9.18E-06,4,9.11E-06,9.47E-06,1,2
unredacted,5,9.18E-06,5,1.14E-05,0,0,3
submit,5,9.18E-06,2,4.56E-06,2.84E-05,3,2
manuscript,5,9.18E-06,5,1.14E-05,0,0,3
venezuelan,5,9.18E-06,5,1.14E-05,0,0,4
pursuit,5,9.18E-06,4,9.11E-06,9.47E-06,1,2
spirits,5,9.18E-06,5,1.14E-05,0,0,2
invited,5,9.18E-06,5,1.14E-05,0,0,2
limited,5,9.18E-06,5,1.14E-05,0,0,2
horowitz,5,9.18E-06,5,1.14E-05,0,0,3
biarritz,5,9.18E-06,5,1.14E-05,0,0,2
witnessed,5,9.18E-06,4,9.11E-06,9.47E-06,1,2
stability,5,9.18E-06,4,9.11E-06,9.47E-06,1,4
publicity,5,9.18E-06,5,1.14E-05,0,0,4
discredit,5,9.18E-06,5,1.14E-05,0,0,3
inherited,5,9.18E-06,5,1.14E-05,0,0,3
illicit,5,9.18E-06,5,1.14E-05,0,0,3
creativity,5,9.18E-06,0,0,4.74E-05,5,4
competitor,5,9.18E-06,5,1.14E-05,0,0,4
excitement,5,9.18E-06,5,1.14E-05,0,0,4
witnessing,5,9.18E-06,5,1.14E-05,0,0,3
expedition,5,9.18E-06,5,1.14E-05,0,0,4
recognition,5,9.18E-06,5,1.14E-05,0,0,4
indefinitely,5,9.18E-06,5,1.14E-05,0,0,6
responsibilities,5,9.18E-06,0,0,4.74E-05,5,6
theories,5,9.18E-06,5,1.14E-05,0,0,2
gathering,5,9.18E-06,4,9.11E-06,9.47E-06,1,3
catherine,5,9.18E-06,5,1.14E-05,0,0,3
dummy,5,9.18E-06,5,1.14E-05,0,0,2
commend,5,9.18E-06,4,9.11E-06,9.47E-06,1,2
emmanuel,5,9.18E-06,5,1.14E-05,0,0,3
mammograms,5,9.18E-06,0,0,4.74E-05,5,3
recommendation,5,9.18E-06,5,1.14E-05,0,0,5
communications,5,9.18E-06,5,1.14E-05,0,0,5
recommendations,5,9.18E-06,4,9.11E-06,9.47E-06,1,5
dangerously,5,9.18E-06,1,2.28E-06,3.79E-05,4,4
contributor,5,9.18E-06,4,9.11E-06,9.47E-06,1,4
complicated,5,9.18E-06,4,9.11E-06,9.47E-06,1,3
eliminating,5,9.18E-06,2,4.56E-06,2.84E-05,3,5
registering,5,9.18E-06,3,6.83E-06,1.89E-05,2,4
deportation,5,9.18E-06,2,4.56E-06,2.84E-05,3,4
subsidizing,5,9.18E-06,3,6.83E-06,1.89E-05,2,4
introducing,5,9.18E-06,2,4.56E-06,2.84E-05,3,4
persecution,5,9.18E-06,4,9.11E-06,9.47E-06,1,4
recognizing,5,9.18E-06,5,1.14E-05,0,0,4
miscarriage,5,9.18E-06,5,1.14E-05,0,0,3
unanimously,5,9.18E-06,5,1.14E-05,0,0,5
temporarily,5,9.18E-06,5,1.14E-05,0,0,5
distinction,5,9.18E-06,5,1.14E-05,0,0,3
involvement,5,9.18E-06,5,1.14E-05,0,0,4
devaluation,5,9.18E-06,5,1.14E-05,0,0,4
confinement,5,9.18E-06,5,1.14E-05,0,0,4
fortunately,5,9.18E-06,5,1.14E-05,0,0,5
subscribers,5,9.18E-06,5,1.14E-05,0,0,3
deplorables,5,9.18E-06,5,1.14E-05,0,0,4
transparent,5,9.18E-06,5,1.14E-05,0,0,3
renegotiate,5,9.18E-06,5,1.14E-05,0,0,4
inexpensive,5,9.18E-06,5,1.14E-05,0,0,4
scholarships,5,9.18E-06,0,0,4.74E-05,5,3
appointments,5,9.18E-06,4,9.11E-06,9.47E-06,1,3
headquarters,5,9.18E-06,3,6.83E-06,1.89E-05,2,3
performances,5,9.18E-06,4,9.11E-06,9.47E-06,1,3
developments,5,9.18E-06,5,1.14E-05,0,0,4
consultation,5,9.18E-06,5,1.14E-05,0,0,4
independents,5,9.18E-06,5,1.14E-05,0,0,4
presentation,5,9.18E-06,5,1.14E-05,0,0,4
declassified,5,9.18E-06,5,1.14E-05,0,0,4
journalistic,5,9.18E-06,5,1.14E-05,0,0,4
heartbreaking,5,9.18E-06,3,6.83E-06,1.89E-05,2,3
contraception,5,9.18E-06,0,0,4.74E-05,5,4
participating,5,9.18E-06,4,9.11E-06,9.47E-06,1,5
appropriately,5,9.18E-06,5,1.14E-05,0,0,5
sophisticated,5,9.18E-06,5,1.14E-05,0,0,4
significantly,5,9.18E-06,5,1.14E-05,0,0,5
accomplishing,5,9.18E-06,5,1.14E-05,0,0,4
teleconference,5,9.18E-06,5,1.14E-05,0,0,5
kid,4,7.35E-06,0,0,3.79E-05,4,1
yom,4,7.35E-06,2,4.56E-06,1.89E-05,2,1
zip,4,7.35E-06,1,2.28E-06,2.84E-05,3,1
oct,4,7.35E-06,0,0,3.79E-05,4,1
tie,4,7.35E-06,3,6.83E-06,9.47E-06,1,1
web,4,7.35E-06,3,6.83E-06,9.47E-06,1,1
bye,4,7.35E-06,3,6.83E-06,9.47E-06,1,1
mlk,4,7.35E-06,1,2.28E-06,2.84E-05,3,1
cos,4,7.35E-06,3,6.83E-06,9.47E-06,1,1
dig,4,7.35E-06,3,6.83E-06,9.47E-06,1,1
ari,4,7.35E-06,4,9.11E-06,0,0,1
nba,4,7.35E-06,4,9.11E-06,0,0,1
fmr,4,7.35E-06,4,9.11E-06,0,0,1
cow,4,7.35E-06,4,9.11E-06,0,0,1
fat,4,7.35E-06,4,9.11E-06,0,0,1
kay,4,7.35E-06,4,9.11E-06,0,0,1
dni,4,7.35E-06,4,9.11E-06,0,0,1
mtg,4,7.35E-06,4,9.11E-06,0,0,1
msm,4,7.35E-06,4,9.11E-06,0,0,1
tpp,4,7.35E-06,4,9.11E-06,0,0,1
nsa,4,7.35E-06,4,9.11E-06,0,0,1
els,4,7.35E-06,4,9.11E-06,0,0,1
zte,4,7.35E-06,4,9.11E-06,0,0,1
beg,4,7.35E-06,4,9.11E-06,0,0,1
deck,4,7.35E-06,2,4.56E-06,1.89E-05,2,1
chag,4,7.35E-06,0,0,3.79E-05,4,1
shed,4,7.35E-06,2,4.56E-06,1.89E-05,2,#ERROR!
draw,4,7.35E-06,2,4.56E-06,1.89E-05,2,1
ages,4,7.35E-06,1,2.28E-06,2.84E-05,3,1
mens,4,7.35E-06,0,0,3.79E-05,4,1
torn,4,7.35E-06,3,6.83E-06,9.47E-06,1,1
mate,4,7.35E-06,1,2.28E-06,2.84E-05,3,1
usas,4,7.35E-06,3,6.83E-06,9.47E-06,1,2
song,4,7.35E-06,2,4.56E-06,1.89E-05,2,1
hood,4,7.35E-06,3,6.83E-06,9.47E-06,1,1
koch,4,7.35E-06,3,6.83E-06,9.47E-06,1,1
meal,4,7.35E-06,0,0,3.79E-05,4,1
stem,4,7.35E-06,3,6.83E-06,9.47E-06,1,1
beer,4,7.35E-06,3,6.83E-06,9.47E-06,1,1
erin,4,7.35E-06,3,6.83E-06,9.47E-06,1,2
haul,4,7.35E-06,2,4.56E-06,1.89E-05,2,1
dope,4,7.35E-06,4,9.11E-06,0,0,1
hahn,4,7.35E-06,4,9.11E-06,0,0,1
wolf,4,7.35E-06,4,9.11E-06,0,0,1
kirk,4,7.35E-06,4,9.11E-06,0,0,1
rare,4,7.35E-06,4,9.11E-06,0,0,1
undo,4,7.35E-06,4,9.11E-06,0,0,2
kris,4,7.35E-06,4,9.11E-06,0,0,1
jump,4,7.35E-06,4,9.11E-06,0,0,1
wack,4,7.35E-06,4,9.11E-06,0,0,1
tone,4,7.35E-06,4,9.11E-06,0,0,1
sane,4,7.35E-06,4,9.11E-06,0,0,1
hang,4,7.35E-06,4,9.11E-06,0,0,1
mood,4,7.35E-06,4,9.11E-06,0,0,1
port,4,7.35E-06,4,9.11E-06,0,0,1
modi,4,7.35E-06,4,9.11E-06,0,0,2
knee,4,7.35E-06,4,9.11E-06,0,0,1
span,4,7.35E-06,4,9.11E-06,0,0,1
frey,4,7.35E-06,4,9.11E-06,0,0,1
hats,4,7.35E-06,4,9.11E-06,0,0,1
nazi,4,7.35E-06,4,9.11E-06,0,0,2
sole,4,7.35E-06,4,9.11E-06,0,0,2
gary,4,7.35E-06,4,9.11E-06,0,0,2
yale,4,7.35E-06,4,9.11E-06,0,0,2
holt,4,7.35E-06,4,9.11E-06,0,0,1
peng,4,7.35E-06,4,9.11E-06,0,0,1
lara,4,7.35E-06,4,9.11E-06,0,0,2
yuma,4,7.35E-06,4,9.11E-06,0,0,2
beef,4,7.35E-06,4,9.11E-06,0,0,1
khan,4,7.35E-06,4,9.11E-06,0,0,1
rice,4,7.35E-06,4,9.11E-06,0,0,1
halt,4,7.35E-06,4,9.11E-06,0,0,1
flew,4,7.35E-06,4,9.11E-06,0,0,1
wine,4,7.35E-06,4,9.11E-06,0,0,1
mesa,4,7.35E-06,4,9.11E-06,0,0,2
soil,4,7.35E-06,4,9.11E-06,0,0,1
bore,4,7.35E-06,4,9.11E-06,0,0,1
hole,4,7.35E-06,4,9.11E-06,0,0,2
kahn,4,7.35E-06,4,9.11E-06,0,0,1
bibi,4,7.35E-06,4,9.11E-06,0,0,2
dame,4,7.35E-06,4,9.11E-06,0,0,1
donor,4,7.35E-06,1,2.28E-06,2.84E-05,3,2
poses,4,7.35E-06,0,0,3.79E-05,4,1
acres,4,7.35E-06,3,6.83E-06,9.47E-06,1,1
marry,4,7.35E-06,0,0,3.79E-05,4,2
hotel,4,7.35E-06,2,4.56E-06,1.89E-05,2,2
aired,4,7.35E-06,3,6.83E-06,9.47E-06,1,1
fresh,4,7.35E-06,3,6.83E-06,9.47E-06,1,1
wheel,4,7.35E-06,3,6.83E-06,9.47E-06,1,1
nobel,4,7.35E-06,3,6.83E-06,9.47E-06,1,2
tools,4,7.35E-06,1,2.28E-06,2.84E-05,3,1
cents,4,7.35E-06,1,2.28E-06,2.84E-05,3,1
hoops,4,7.35E-06,0,0,3.79E-05,4,1
adult,4,7.35E-06,2,4.56E-06,1.89E-05,2,2
grade,4,7.35E-06,2,4.56E-06,1.89E-05,2,1
lived,4,7.35E-06,3,6.83E-06,9.47E-06,1,1
scope,4,7.35E-06,3,6.83E-06,9.47E-06,1,1
whove,4,7.35E-06,1,2.28E-06,2.84E-05,3,1
johns,4,7.35E-06,2,4.56E-06,1.89E-05,2,1
cried,4,7.35E-06,3,6.83E-06,9.47E-06,1,1
saves,4,7.35E-06,1,2.28E-06,2.84E-05,3,1
malia,4,7.35E-06,0,0,3.79E-05,4,2
sasha,4,7.35E-06,0,0,3.79E-05,4,2
harms,4,7.35E-06,1,2.28E-06,2.84E-05,3,1
alike,4,7.35E-06,3,6.83E-06,9.47E-06,1,2
aimed,4,7.35E-06,2,4.56E-06,1.89E-05,2,1
libya,4,7.35E-06,1,2.28E-06,2.84E-05,3,2
qaeda,4,7.35E-06,1,2.28E-06,2.84E-05,3,2
spots,4,7.35E-06,3,6.83E-06,9.47E-06,1,1
kagan,4,7.35E-06,0,0,3.79E-05,4,2
champ,4,7.35E-06,3,6.83E-06,9.47E-06,1,1
sheet,4,7.35E-06,2,4.56E-06,1.89E-05,2,1
brink,4,7.35E-06,1,2.28E-06,2.84E-05,3,1
swiss,4,7.35E-06,2,4.56E-06,1.89E-05,2,1
sonia,4,7.35E-06,0,0,3.79E-05,4,2
erase,4,7.35E-06,3,6.83E-06,9.47E-06,1,2
drove,4,7.35E-06,2,4.56E-06,1.89E-05,2,1
lauer,4,7.35E-06,3,6.83E-06,9.47E-06,1,2
hires,4,7.35E-06,3,6.83E-06,9.47E-06,1,1
casey,4,7.35E-06,3,6.83E-06,9.47E-06,1,2
metro,4,7.35E-06,3,6.83E-06,9.47E-06,1,2
cease,4,7.35E-06,4,9.11E-06,0,0,1
owens,4,7.35E-06,4,9.11E-06,0,0,2
dumps,4,7.35E-06,4,9.11E-06,0,0,1
hadnt,4,7.35E-06,4,9.11E-06,0,0,1
clown,4,7.35E-06,4,9.11E-06,0,0,1
shake,4,7.35E-06,4,9.11E-06,0,0,1
esper,4,7.35E-06,4,9.11E-06,0,0,2
bryan,4,7.35E-06,4,9.11E-06,0,0,1
slime,4,7.35E-06,4,9.11E-06,0,0,1
linda,4,7.35E-06,4,9.11E-06,0,0,2
duped,4,7.35E-06,4,9.11E-06,0,0,1
homan,4,7.35E-06,4,9.11E-06,0,0,2
sharp,4,7.35E-06,4,9.11E-06,0,0,1
adams,4,7.35E-06,4,9.11E-06,0,0,2
curve,4,7.35E-06,4,9.11E-06,0,0,1
jamie,4,7.35E-06,4,9.11E-06,0,0,2
river,4,7.35E-06,4,9.11E-06,0,0,2
bombs,4,7.35E-06,4,9.11E-06,0,0,1
jacob,4,7.35E-06,4,9.11E-06,0,0,2
depot,4,7.35E-06,4,9.11E-06,0,0,2
bible,4,7.35E-06,4,9.11E-06,0,0,2
flare,4,7.35E-06,4,9.11E-06,0,0,1
kneel,4,7.35E-06,4,9.11E-06,0,0,1
lousy,4,7.35E-06,4,9.11E-06,0,0,2
style,4,7.35E-06,4,9.11E-06,0,0,2
refer,4,7.35E-06,4,9.11E-06,0,0,2
cycle,4,7.35E-06,4,9.11E-06,0,0,2
payne,4,7.35E-06,4,9.11E-06,0,0,1
weird,4,7.35E-06,4,9.11E-06,0,0,1
peggy,4,7.35E-06,4,9.11E-06,0,0,2
rises,4,7.35E-06,4,9.11E-06,0,0,1
stain,4,7.35E-06,4,9.11E-06,0,0,1
naive,4,7.35E-06,4,9.11E-06,0,0,1
reset,4,7.35E-06,4,9.11E-06,0,0,2
soars,4,7.35E-06,4,9.11E-06,0,0,1
knees,4,7.35E-06,4,9.11E-06,0,0,1
kraft,4,7.35E-06,4,9.11E-06,0,0,1
barra,4,7.35E-06,4,9.11E-06,0,0,2
tries,4,7.35E-06,4,9.11E-06,0,0,1
corsi,4,7.35E-06,4,9.11E-06,0,0,2
craft,4,7.35E-06,4,9.11E-06,0,0,1
terry,4,7.35E-06,4,9.11E-06,0,0,2
agony,4,7.35E-06,4,9.11E-06,0,0,3
blown,4,7.35E-06,4,9.11E-06,0,0,1
bevin,4,7.35E-06,4,9.11E-06,0,0,2
notre,4,7.35E-06,4,9.11E-06,0,0,1
warmer,4,7.35E-06,2,4.56E-06,1.89E-05,2,2
taught,4,7.35E-06,2,4.56E-06,1.89E-05,2,1
crises,4,7.35E-06,1,2.28E-06,2.84E-05,3,1
twenty,4,7.35E-06,1,2.28E-06,2.84E-05,3,2
treats,4,7.35E-06,2,4.56E-06,1.89E-05,2,1
scared,4,7.35E-06,3,6.83E-06,9.47E-06,1,1
campus,4,7.35E-06,3,6.83E-06,9.47E-06,1,2
sister,4,7.35E-06,3,6.83E-06,9.47E-06,1,2
smiles,4,7.35E-06,1,2.28E-06,2.84E-05,3,2
punish,4,7.35E-06,3,6.83E-06,9.47E-06,1,2
firmly,4,7.35E-06,3,6.83E-06,9.47E-06,1,2
formal,4,7.35E-06,3,6.83E-06,9.47E-06,1,2
solves,4,7.35E-06,3,6.83E-06,9.47E-06,1,1
shores,4,7.35E-06,3,6.83E-06,9.47E-06,1,1
beside,4,7.35E-06,3,6.83E-06,9.47E-06,1,2
buyers,4,7.35E-06,3,6.83E-06,9.47E-06,1,2
reward,4,7.35E-06,0,0,3.79E-05,4,2
kicked,4,7.35E-06,1,2.28E-06,2.84E-05,3,1
insult,4,7.35E-06,3,6.83E-06,9.47E-06,1,2
famous,4,7.35E-06,2,4.56E-06,1.89E-05,2,2
incest,4,7.35E-06,1,2.28E-06,2.84E-05,3,2
podium,4,7.35E-06,2,4.56E-06,1.89E-05,2,2
relied,4,7.35E-06,3,6.83E-06,9.47E-06,1,2
driver,4,7.35E-06,2,4.56E-06,1.89E-05,2,2
videos,4,7.35E-06,2,4.56E-06,1.89E-05,2,2
rounds,4,7.35E-06,3,6.83E-06,9.47E-06,1,1
circus,4,7.35E-06,3,6.83E-06,9.47E-06,1,2
legion,4,7.35E-06,3,6.83E-06,9.47E-06,1,2
giants,4,7.35E-06,3,6.83E-06,9.47E-06,1,1
lauren,4,7.35E-06,3,6.83E-06,9.47E-06,1,2
manage,4,7.35E-06,3,6.83E-06,9.47E-06,1,2
advise,4,7.35E-06,3,6.83E-06,9.47E-06,1,2
steady,4,7.35E-06,3,6.83E-06,9.47E-06,1,2
sights,4,7.35E-06,3,6.83E-06,9.47E-06,1,1
moscow,4,7.35E-06,3,6.83E-06,9.47E-06,1,2
postal,4,7.35E-06,4,9.11E-06,0,0,2
appeal,4,7.35E-06,4,9.11E-06,0,0,2
victor,4,7.35E-06,4,9.11E-06,0,0,2
alfred,4,7.35E-06,4,9.11E-06,0,0,1
newman,4,7.35E-06,4,9.11E-06,0,0,2
scotus,4,7.35E-06,4,9.11E-06,0,0,2
surges,4,7.35E-06,4,9.11E-06,0,0,1
duties,4,7.35E-06,4,9.11E-06,0,0,2
estate,4,7.35E-06,4,9.11E-06,0,0,2
acosta,4,7.35E-06,4,9.11E-06,0,0,3
fabled,4,7.35E-06,4,9.11E-06,0,0,1
raided,4,7.35E-06,4,9.11E-06,0,0,1
hoaxes,4,7.35E-06,4,9.11E-06,0,0,1
errors,4,7.35E-06,4,9.11E-06,0,0,2
rachel,4,7.35E-06,4,9.11E-06,0,0,2
backup,4,7.35E-06,4,9.11E-06,0,0,2
retail,4,7.35E-06,4,9.11E-06,0,0,2
hockey,4,7.35E-06,4,9.11E-06,0,0,2
serves,4,7.35E-06,4,9.11E-06,0,0,1
weaker,4,7.35E-06,4,9.11E-06,0,0,2
meadow,4,7.35E-06,4,9.11E-06,0,0,2
daines,4,7.35E-06,4,9.11E-06,0,0,1
breath,4,7.35E-06,4,9.11E-06,0,0,1
locker,4,7.35E-06,4,9.11E-06,0,0,2
mutual,4,7.35E-06,4,9.11E-06,0,0,2
branch,4,7.35E-06,4,9.11E-06,0,0,1
sailor,4,7.35E-06,4,9.11E-06,0,0,2
salman,4,7.35E-06,4,9.11E-06,0,0,2
shinzo,4,7.35E-06,4,9.11E-06,0,0,2
doubts,4,7.35E-06,4,9.11E-06,0,0,1
bryant,4,7.35E-06,4,9.11E-06,0,0,1
devote,4,7.35E-06,4,9.11E-06,0,0,2
stages,4,7.35E-06,4,9.11E-06,0,0,1
bossie,4,7.35E-06,4,9.11E-06,0,0,2
ethics,4,7.35E-06,4,9.11E-06,0,0,2
golfer,4,7.35E-06,4,9.11E-06,0,0,2
dozens,4,7.35E-06,4,9.11E-06,0,0,2
slogan,4,7.35E-06,4,9.11E-06,0,0,2
aboard,4,7.35E-06,4,9.11E-06,0,0,2
madame,4,7.35E-06,4,9.11E-06,0,0,2
liyuan,4,7.35E-06,4,9.11E-06,0,0,2
praise,4,7.35E-06,4,9.11E-06,0,0,1
warmth,4,7.35E-06,4,9.11E-06,0,0,1
floods,4,7.35E-06,4,9.11E-06,0,0,1
varney,4,7.35E-06,4,9.11E-06,0,0,2
spiral,4,7.35E-06,4,9.11E-06,0,0,2
frauds,4,7.35E-06,4,9.11E-06,0,0,1
offers,4,7.35E-06,4,9.11E-06,0,0,2
crimea,4,7.35E-06,4,9.11E-06,0,0,2
detain,4,7.35E-06,4,9.11E-06,0,0,2
andres,4,7.35E-06,4,9.11E-06,0,0,1
client,4,7.35E-06,4,9.11E-06,0,0,1
guards,4,7.35E-06,4,9.11E-06,0,0,1
vaping,4,7.35E-06,4,9.11E-06,0,0,2
reeves,4,7.35E-06,4,9.11E-06,0,0,1
studies,4,7.35E-06,3,6.83E-06,9.47E-06,1,2
examine,4,7.35E-06,3,6.83E-06,9.47E-06,1,3
latinos,4,7.35E-06,2,4.56E-06,1.89E-05,2,3
inmates,4,7.35E-06,2,4.56E-06,1.89E-05,2,2
singing,4,7.35E-06,0,0,3.79E-05,4,2
sameach,4,7.35E-06,0,0,3.79E-05,4,2
strides,4,7.35E-06,2,4.56E-06,1.89E-05,2,1
charter,4,7.35E-06,3,6.83E-06,9.47E-06,1,2
defined,4,7.35E-06,2,4.56E-06,1.89E-05,2,2
episode,4,7.35E-06,0,0,3.79E-05,4,3
focuses,4,7.35E-06,2,4.56E-06,1.89E-05,2,2
prouder,4,7.35E-06,0,0,3.79E-05,4,2
essence,4,7.35E-06,2,4.56E-06,1.89E-05,2,2
drought,4,7.35E-06,2,4.56E-06,1.89E-05,2,1
predict,4,7.35E-06,3,6.83E-06,9.47E-06,1,2
cameras,4,7.35E-06,3,6.83E-06,9.47E-06,1,3
antonio,4,7.35E-06,2,4.56E-06,1.89E-05,2,3
content,4,7.35E-06,2,4.56E-06,1.89E-05,2,2
francis,4,7.35E-06,3,6.83E-06,9.47E-06,1,2
visions,4,7.35E-06,1,2.28E-06,2.84E-05,3,2
messina,4,7.35E-06,0,0,3.79E-05,4,3
married,4,7.35E-06,2,4.56E-06,1.89E-05,2,2
springs,4,7.35E-06,3,6.83E-06,9.47E-06,1,1
posting,4,7.35E-06,3,6.83E-06,9.47E-06,1,2
reclaim,4,7.35E-06,3,6.83E-06,9.47E-06,1,2
qualify,4,7.35E-06,3,6.83E-06,9.47E-06,1,3
filings,4,7.35E-06,3,6.83E-06,9.47E-06,1,2
arguing,4,7.35E-06,2,4.56E-06,1.89E-05,2,2
stormed,4,7.35E-06,3,6.83E-06,9.47E-06,1,1
license,4,7.35E-06,3,6.83E-06,9.47E-06,1,2
jessica,4,7.35E-06,2,4.56E-06,1.89E-05,2,3
shocked,4,7.35E-06,3,6.83E-06,9.47E-06,1,1
israels,4,7.35E-06,3,6.83E-06,9.47E-06,1,2
offices,4,7.35E-06,3,6.83E-06,9.47E-06,1,2
stamped,4,7.35E-06,2,4.56E-06,1.89E-05,2,1
warfare,4,7.35E-06,2,4.56E-06,1.89E-05,2,2
pardons,4,7.35E-06,3,6.83E-06,9.47E-06,1,2
pledges,4,7.35E-06,3,6.83E-06,9.47E-06,1,1
captain,4,7.35E-06,3,6.83E-06,9.47E-06,1,2
hivaids,4,7.35E-06,2,4.56E-06,1.89E-05,2,2
observe,4,7.35E-06,3,6.83E-06,9.47E-06,1,2
backing,4,7.35E-06,3,6.83E-06,9.47E-06,1,2
wearing,4,7.35E-06,4,9.11E-06,0,0,2
coaches,4,7.35E-06,4,9.11E-06,0,0,1
rushing,4,7.35E-06,4,9.11E-06,0,0,2
upholds,4,7.35E-06,4,9.11E-06,0,0,2
claudia,4,7.35E-06,4,9.11E-06,0,0,2
happier,4,7.35E-06,4,9.11E-06,0,0,2
revenge,4,7.35E-06,4,9.11E-06,0,0,2
somalia,4,7.35E-06,4,9.11E-06,0,0,3
overrun,4,7.35E-06,4,9.11E-06,0,0,3
forging,4,7.35E-06,4,9.11E-06,0,0,2
unheard,4,7.35E-06,4,9.11E-06,0,0,2
sincere,4,7.35E-06,4,9.11E-06,0,0,2
sheriff,4,7.35E-06,4,9.11E-06,0,0,2
indians,4,7.35E-06,4,9.11E-06,0,0,2
ruining,4,7.35E-06,4,9.11E-06,0,0,2
walmart,4,7.35E-06,4,9.11E-06,0,0,2
forrest,4,7.35E-06,4,9.11E-06,0,0,2
finland,4,7.35E-06,4,9.11E-06,0,0,2
vindman,4,7.35E-06,4,9.11E-06,0,0,2
boaters,4,7.35E-06,4,9.11E-06,0,0,2
overdue,4,7.35E-06,4,9.11E-06,0,0,3
dismiss,4,7.35E-06,4,9.11E-06,0,0,2
chelsea,4,7.35E-06,4,9.11E-06,0,0,2
rocking,4,7.35E-06,4,9.11E-06,0,0,2
studied,4,7.35E-06,4,9.11E-06,0,0,2
signals,4,7.35E-06,4,9.11E-06,0,0,2
wyoming,4,7.35E-06,4,9.11E-06,0,0,2
bernies,4,7.35E-06,4,9.11E-06,0,0,2
closure,4,7.35E-06,4,9.11E-06,0,0,2
thunder,4,7.35E-06,4,9.11E-06,0,0,2
emerson,4,7.35E-06,4,9.11E-06,0,0,3
rioting,4,7.35E-06,4,9.11E-06,0,0,2
rulings,4,7.35E-06,4,9.11E-06,0,0,2
survive,4,7.35E-06,4,9.11E-06,0,0,2
retreat,4,7.35E-06,4,9.11E-06,0,0,2
revoked,4,7.35E-06,4,9.11E-06,0,0,2
anarchy,4,7.35E-06,4,9.11E-06,0,0,3
tenfold,4,7.35E-06,4,9.11E-06,0,0,2
custody,4,7.35E-06,4,9.11E-06,0,0,3
nytimes,4,7.35E-06,4,9.11E-06,0,0,2
latrobe,4,7.35E-06,4,9.11E-06,0,0,2
slanted,4,7.35E-06,4,9.11E-06,0,0,1
jealous,4,7.35E-06,4,9.11E-06,0,0,2
refuted,4,7.35E-06,4,9.11E-06,0,0,2
deborah,4,7.35E-06,4,9.11E-06,0,0,3
praised,4,7.35E-06,4,9.11E-06,0,0,1
portray,4,7.35E-06,4,9.11E-06,0,0,2
knights,4,7.35E-06,4,9.11E-06,0,0,1
scholar,4,7.35E-06,4,9.11E-06,0,0,2
masters,4,7.35E-06,4,9.11E-06,0,0,2
regimes,4,7.35E-06,4,9.11E-06,0,0,2
coldest,4,7.35E-06,4,9.11E-06,0,0,2
stacked,4,7.35E-06,4,9.11E-06,0,0,1
mystery,4,7.35E-06,4,9.11E-06,0,0,3
northam,4,7.35E-06,4,9.11E-06,0,0,2
europes,4,7.35E-06,4,9.11E-06,0,0,2
stadium,4,7.35E-06,4,9.11E-06,0,0,2
regards,4,7.35E-06,4,9.11E-06,0,0,2
hamburg,4,7.35E-06,4,9.11E-06,0,0,2
bravest,4,7.35E-06,4,9.11E-06,0,0,2
mnuchin,4,7.35E-06,4,9.11E-06,0,0,2
statute,4,7.35E-06,4,9.11E-06,0,0,2
murders,4,7.35E-06,4,9.11E-06,0,0,2
roberts,4,7.35E-06,4,9.11E-06,0,0,2
rothfus,4,7.35E-06,4,9.11E-06,0,0,2
unknown,4,7.35E-06,4,9.11E-06,0,0,2
orourke,4,7.35E-06,4,9.11E-06,0,0,2
placing,4,7.35E-06,4,9.11E-06,0,0,2
premier,4,7.35E-06,4,9.11E-06,0,0,2
bravely,4,7.35E-06,4,9.11E-06,0,0,3
generic,4,7.35E-06,4,9.11E-06,0,0,3
solomon,4,7.35E-06,4,9.11E-06,0,0,3
quicker,4,7.35E-06,4,9.11E-06,0,0,2
waivers,4,7.35E-06,4,9.11E-06,0,0,2
tackling,4,7.35E-06,0,0,3.79E-05,4,2
choosing,4,7.35E-06,2,4.56E-06,1.89E-05,2,2
prevents,4,7.35E-06,2,4.56E-06,1.89E-05,2,2
pledging,4,7.35E-06,1,2.28E-06,2.84E-05,3,2
reverend,4,7.35E-06,3,6.83E-06,9.47E-06,1,3
drinking,4,7.35E-06,0,0,3.79E-05,4,2
reserved,4,7.35E-06,0,0,3.79E-05,4,2
openings,4,7.35E-06,3,6.83E-06,9.47E-06,1,3
survival,4,7.35E-06,2,4.56E-06,1.89E-05,2,3
marathon,4,7.35E-06,2,4.56E-06,1.89E-05,2,3
spectrum,4,7.35E-06,3,6.83E-06,9.47E-06,1,2
deferred,4,7.35E-06,1,2.28E-06,2.84E-05,3,2
columbia,4,7.35E-06,3,6.83E-06,9.47E-06,1,3
murdered,4,7.35E-06,2,4.56E-06,1.89E-05,2,2
diminish,4,7.35E-06,3,6.83E-06,9.47E-06,1,3
prospect,4,7.35E-06,3,6.83E-06,9.47E-06,1,2
timeline,4,7.35E-06,1,2.28E-06,2.84E-05,3,3
knocking,4,7.35E-06,2,4.56E-06,1.89E-05,2,2
richmond,4,7.35E-06,1,2.28E-06,2.84E-05,3,2
generate,4,7.35E-06,1,2.28E-06,2.84E-05,3,3
stickers,4,7.35E-06,0,0,3.79E-05,4,2
offshore,4,7.35E-06,0,0,3.79E-05,4,2
finances,4,7.35E-06,3,6.83E-06,9.47E-06,1,2
controls,4,7.35E-06,3,6.83E-06,9.47E-06,1,2
ideology,4,7.35E-06,3,6.83E-06,9.47E-06,1,4
tracking,4,7.35E-06,3,6.83E-06,9.47E-06,1,2
disclose,4,7.35E-06,3,6.83E-06,9.47E-06,1,2
historys,4,7.35E-06,1,2.28E-06,2.84E-05,3,3
disposal,4,7.35E-06,3,6.83E-06,9.47E-06,1,3
mourning,4,7.35E-06,2,4.56E-06,1.89E-05,2,2
donating,4,7.35E-06,3,6.83E-06,9.47E-06,1,3
backlash,4,7.35E-06,4,9.11E-06,0,0,2
scholars,4,7.35E-06,4,9.11E-06,0,0,2
matching,4,7.35E-06,4,9.11E-06,0,0,2
mcdaniel,4,7.35E-06,4,9.11E-06,0,0,2
scandals,4,7.35E-06,4,9.11E-06,0,0,2
rounding,4,7.35E-06,4,9.11E-06,0,0,2
takedown,4,7.35E-06,4,9.11E-06,0,0,3
predator,4,7.35E-06,4,9.11E-06,0,0,3
accuracy,4,7.35E-06,4,9.11E-06,0,0,4
renaming,4,7.35E-06,4,9.11E-06,0,0,3
slightly,4,7.35E-06,4,9.11E-06,0,0,2
credible,4,7.35E-06,4,9.11E-06,0,0,3
lunatics,4,7.35E-06,4,9.11E-06,0,0,3
claiming,4,7.35E-06,4,9.11E-06,0,0,2
restored,4,7.35E-06,4,9.11E-06,0,0,2
betrayed,4,7.35E-06,4,9.11E-06,0,0,2
releases,4,7.35E-06,4,9.11E-06,0,0,2
dominant,4,7.35E-06,4,9.11E-06,0,0,3
ingraham,4,7.35E-06,4,9.11E-06,0,0,3
crashing,4,7.35E-06,4,9.11E-06,0,0,2
shouting,4,7.35E-06,4,9.11E-06,0,0,2
rhetoric,4,7.35E-06,4,9.11E-06,0,0,3
mightily,4,7.35E-06,4,9.11E-06,0,0,3
outdated,4,7.35E-06,4,9.11E-06,0,0,2
brighter,4,7.35E-06,4,9.11E-06,0,0,2
trashing,4,7.35E-06,4,9.11E-06,0,0,2
profound,4,7.35E-06,4,9.11E-06,0,0,2
failures,4,7.35E-06,4,9.11E-06,0,0,2
jonathan,4,7.35E-06,4,9.11E-06,0,0,3
closings,4,7.35E-06,4,9.11E-06,0,0,2
thanking,4,7.35E-06,4,9.11E-06,0,0,2
studying,4,7.35E-06,4,9.11E-06,0,0,2
terminal,4,7.35E-06,4,9.11E-06,0,0,3
enhanced,4,7.35E-06,4,9.11E-06,0,0,2
unstable,4,7.35E-06,4,9.11E-06,0,0,3
famously,4,7.35E-06,4,9.11E-06,0,0,3
obsolete,4,7.35E-06,4,9.11E-06,0,0,3
unlikely,4,7.35E-06,4,9.11E-06,0,0,4
cleaners,4,7.35E-06,4,9.11E-06,0,0,2
warnings,4,7.35E-06,4,9.11E-06,0,0,2
missteps,4,7.35E-06,4,9.11E-06,0,0,2
accusing,4,7.35E-06,4,9.11E-06,0,0,3
swearing,4,7.35E-06,4,9.11E-06,0,0,2
gracious,4,7.35E-06,4,9.11E-06,0,0,3
generous,4,7.35E-06,4,9.11E-06,0,0,3
retained,4,7.35E-06,4,9.11E-06,0,0,2
transfer,4,7.35E-06,4,9.11E-06,0,0,2
tolerate,4,7.35E-06,4,9.11E-06,0,0,3
packages,4,7.35E-06,4,9.11E-06,0,0,2
occurred,4,7.35E-06,4,9.11E-06,0,0,2
declared,4,7.35E-06,4,9.11E-06,0,0,2
material,4,7.35E-06,4,9.11E-06,0,0,3
luncheon,4,7.35E-06,4,9.11E-06,0,0,2
enormous,4,7.35E-06,4,9.11E-06,0,0,3
removing,4,7.35E-06,4,9.11E-06,0,0,3
behaving,4,7.35E-06,4,9.11E-06,0,0,3
crookeds,4,7.35E-06,4,9.11E-06,0,0,2
interior,4,7.35E-06,4,9.11E-06,0,0,3
soybeans,4,7.35E-06,4,9.11E-06,0,0,2
cleanest,4,7.35E-06,4,9.11E-06,0,0,2
liberals,4,7.35E-06,4,9.11E-06,0,0,3
tariffed,4,7.35E-06,4,9.11E-06,0,0,2
assaults,4,7.35E-06,4,9.11E-06,0,0,2
overruns,4,7.35E-06,4,9.11E-06,0,0,3
realizes,4,7.35E-06,4,9.11E-06,0,0,2
indicted,4,7.35E-06,4,9.11E-06,0,0,2
deported,4,7.35E-06,4,9.11E-06,0,0,2
sunny,4,7.35E-06,0,0,3.79E-05,4,2
gonna,4,7.35E-06,0,0,3.79E-05,4,2
glenn,4,7.35E-06,4,9.11E-06,0,0,1
jeanne,4,7.35E-06,3,6.83E-06,9.47E-06,1,1
bannon,4,7.35E-06,4,9.11E-06,0,0,2
dianne,4,7.35E-06,4,9.11E-06,0,0,1
minnesotas,4,7.35E-06,2,4.56E-06,1.89E-05,2,4
connection,4,7.35E-06,4,9.11E-06,0,0,3
sentenced,4,7.35E-06,3,6.83E-06,9.47E-06,1,2
somewhere,4,7.35E-06,1,2.28E-06,2.84E-05,3,3
treasures,4,7.35E-06,2,4.56E-06,1.89E-05,2,2
discovery,4,7.35E-06,1,2.28E-06,2.84E-05,3,4
fortunate,4,7.35E-06,1,2.28E-06,2.84E-05,3,3
extending,4,7.35E-06,0,0,3.79E-05,4,3
declining,4,7.35E-06,3,6.83E-06,9.47E-06,1,3
recipient,4,7.35E-06,3,6.83E-06,9.47E-06,1,3
pakistani,4,7.35E-06,3,6.83E-06,9.47E-06,1,4
senseless,4,7.35E-06,2,4.56E-06,1.89E-05,2,3
someplace,4,7.35E-06,3,6.83E-06,9.47E-06,1,3
happiness,4,7.35E-06,0,0,3.79E-05,4,3
automatic,4,7.35E-06,3,6.83E-06,9.47E-06,1,4
civilians,4,7.35E-06,3,6.83E-06,9.47E-06,1,3
inaugural,4,7.35E-06,2,4.56E-06,1.89E-05,2,4
wasserman,4,7.35E-06,3,6.83E-06,9.47E-06,1,3
abortions,4,7.35E-06,0,0,3.79E-05,4,3
insulting,4,7.35E-06,3,6.83E-06,9.47E-06,1,3
meanwhile,4,7.35E-06,3,6.83E-06,9.47E-06,1,3
crumbling,4,7.35E-06,3,6.83E-06,9.47E-06,1,2
classroom,4,7.35E-06,0,0,3.79E-05,4,2
refinance,4,7.35E-06,1,2.28E-06,2.84E-05,3,3
apologies,4,7.35E-06,3,6.83E-06,9.47E-06,1,4
prevented,4,7.35E-06,1,2.28E-06,2.84E-05,3,2
graduates,4,7.35E-06,0,0,3.79E-05,4,2
convinced,4,7.35E-06,3,6.83E-06,9.47E-06,1,2
financing,4,7.35E-06,2,4.56E-06,1.89E-05,2,3
giveaways,4,7.35E-06,1,2.28E-06,2.84E-05,3,3
overnight,4,7.35E-06,3,6.83E-06,9.47E-06,1,3
backtrack,4,7.35E-06,0,0,3.79E-05,4,2
appearing,4,7.35E-06,3,6.83E-06,9.47E-06,1,3
addiction,4,7.35E-06,3,6.83E-06,9.47E-06,1,3
unfolding,4,7.35E-06,3,6.83E-06,9.47E-06,1,3
advancing,4,7.35E-06,3,6.83E-06,9.47E-06,1,3
nationals,4,7.35E-06,3,6.83E-06,9.47E-06,1,3
wondering,4,7.35E-06,3,6.83E-06,9.47E-06,1,3
corrected,4,7.35E-06,4,9.11E-06,0,0,2
reference,4,7.35E-06,4,9.11E-06,0,0,3
succeeded,4,7.35E-06,4,9.11E-06,0,0,2
disasters,4,7.35E-06,4,9.11E-06,0,0,3
globalist,4,7.35E-06,4,9.11E-06,0,0,3
breakdown,4,7.35E-06,4,9.11E-06,0,0,2
petrified,4,7.35E-06,4,9.11E-06,0,0,3
estimates,4,7.35E-06,4,9.11E-06,0,0,3
residents,4,7.35E-06,4,9.11E-06,0,0,3
heartland,4,7.35E-06,4,9.11E-06,0,0,2
unanimous,4,7.35E-06,4,9.11E-06,0,0,4
stimulate,4,7.35E-06,4,9.11E-06,0,0,3
pandering,4,7.35E-06,4,9.11E-06,0,0,3
defective,4,7.35E-06,4,9.11E-06,0,0,3
countless,4,7.35E-06,4,9.11E-06,0,0,2
exhausted,4,7.35E-06,4,9.11E-06,0,0,2
defeating,4,7.35E-06,4,9.11E-06,0,0,3
briefings,4,7.35E-06,4,9.11E-06,0,0,2
submarine,4,7.35E-06,4,9.11E-06,0,0,3
quadruple,4,7.35E-06,4,9.11E-06,0,0,3
mountains,4,7.35E-06,4,9.11E-06,0,0,2
rochester,4,7.35E-06,4,9.11E-06,0,0,3
sentences,4,7.35E-06,4,9.11E-06,0,0,2
decorated,4,7.35E-06,4,9.11E-06,0,0,3
superstar,4,7.35E-06,4,9.11E-06,0,0,3
overthrow,4,7.35E-06,4,9.11E-06,0,0,3
sentiment,4,7.35E-06,4,9.11E-06,0,0,3
distorted,4,7.35E-06,4,9.11E-06,0,0,2
technical,4,7.35E-06,4,9.11E-06,0,0,3
extortion,4,7.35E-06,4,9.11E-06,0,0,3
airplanes,4,7.35E-06,4,9.11E-06,0,0,2
motto,4,7.35E-06,2,4.56E-06,1.89E-05,2,2
certainty,4,7.35E-06,4,9.11E-06,0,0,3
capturing,4,7.35E-06,4,9.11E-06,0,0,3
routinely,4,7.35E-06,4,9.11E-06,0,0,4
detriment,4,7.35E-06,4,9.11E-06,0,0,3
synagogue,4,7.35E-06,4,9.11E-06,0,0,4
instantly,4,7.35E-06,4,9.11E-06,0,0,3
turnberry,4,7.35E-06,4,9.11E-06,0,0,3
hemingway,4,7.35E-06,4,9.11E-06,0,0,3
subpoenas,4,7.35E-06,4,9.11E-06,0,0,3
tightened,4,7.35E-06,4,9.11E-06,0,0,2
directors,4,7.35E-06,4,9.11E-06,0,0,3
yvette,4,7.35E-06,4,9.11E-06,0,0,1
fatter,4,7.35E-06,4,9.11E-06,0,0,2
spotted,4,7.35E-06,2,4.56E-06,1.89E-05,2,1
watters,4,7.35E-06,4,9.11E-06,0,0,2
attended,4,7.35E-06,4,9.11E-06,0,0,2
manhattan,4,7.35E-06,4,9.11E-06,0,0,3
attorneys,4,7.35E-06,4,9.11E-06,0,0,3
forgetting,4,7.35E-06,2,4.56E-06,1.89E-05,2,3
tells,4,7.35E-06,2,4.56E-06,1.89E-05,2,1
mills,4,7.35E-06,4,9.11E-06,0,0,1
allen,4,7.35E-06,4,9.11E-06,0,0,2
battlefield,4,7.35E-06,3,6.83E-06,9.47E-06,1,3
pillar,4,7.35E-06,3,6.83E-06,9.47E-06,1,2
seller,4,7.35E-06,4,9.11E-06,0,0,2
valley,4,7.35E-06,4,9.11E-06,0,0,2
battleground,4,7.35E-06,3,6.83E-06,9.47E-06,1,3
billing,4,7.35E-06,4,9.11E-06,0,0,2
rollout,4,7.35E-06,4,9.11E-06,0,0,2
alleged,4,7.35E-06,4,9.11E-06,0,0,2
stalling,4,7.35E-06,1,2.28E-06,2.84E-05,3,2
formally,4,7.35E-06,4,9.11E-06,0,0,3
generally,4,7.35E-06,4,9.11E-06,0,0,4
bombshell,4,7.35E-06,4,9.11E-06,0,0,2
tuberville,4,7.35E-06,4,9.11E-06,0,0,3
bestseller,4,7.35E-06,4,9.11E-06,0,0,3
jacksonville,4,7.35E-06,4,9.11E-06,0,0,3
statistically,4,7.35E-06,4,9.11E-06,0,0,4
unite,4,7.35E-06,3,6.83E-06,9.47E-06,1,2
haiti,4,7.35E-06,2,4.56E-06,1.89E-05,2,2
habits,4,7.35E-06,2,4.56E-06,1.89E-05,2,2
invite,4,7.35E-06,3,6.83E-06,9.47E-06,1,2
merits,4,7.35E-06,4,9.11E-06,0,0,2
credits,4,7.35E-06,1,2.28E-06,2.84E-05,3,2
britain,4,7.35E-06,4,9.11E-06,0,0,2
awaited,4,7.35E-06,4,9.11E-06,0,0,2
pitcher,4,7.35E-06,4,9.11E-06,0,0,2
identity,4,7.35E-06,2,4.56E-06,1.89E-05,2,4
portrait,4,7.35E-06,3,6.83E-06,9.47E-06,1,2
glitches,4,7.35E-06,4,9.11E-06,0,0,1
lawsuits,4,7.35E-06,4,9.11E-06,0,0,2
politely,4,7.35E-06,4,9.11E-06,0,0,4
solitary,4,7.35E-06,4,9.11E-06,0,0,4
visiting,4,7.35E-06,4,9.11E-06,0,0,3
actuality,4,7.35E-06,4,9.11E-06,0,0,4
criticism,4,7.35E-06,4,9.11E-06,0,0,3
institute,4,7.35E-06,4,9.11E-06,0,0,3
attitude,4,7.35E-06,4,9.11E-06,0,0,3
benefiting,4,7.35E-06,2,4.56E-06,1.89E-05,2,4
inequality,4,7.35E-06,0,0,3.79E-05,4,5
definition,4,7.35E-06,3,6.83E-06,9.47E-06,1,4
ineptitude,4,7.35E-06,4,9.11E-06,0,0,4
instituted,4,7.35E-06,4,9.11E-06,0,0,3
hesitation,4,7.35E-06,4,9.11E-06,0,0,4
obliterate,4,7.35E-06,4,9.11E-06,0,0,4
recommit,4,7.35E-06,1,2.28E-06,2.84E-05,3,3
commitments,4,7.35E-06,3,6.83E-06,9.47E-06,1,3
obliterated,4,7.35E-06,4,9.11E-06,0,0,4
criminality,4,7.35E-06,4,9.11E-06,0,0,5
disabilities,4,7.35E-06,0,0,3.79E-05,4,5
institutions,4,7.35E-06,3,6.83E-06,9.47E-06,1,4
affordability,4,7.35E-06,0,0,3.79E-05,4,6
motivation,4,7.35E-06,1,2.28E-06,2.84E-05,3,4
organizers,4,7.35E-06,0,0,3.79E-05,4,4
questioned,4,7.35E-06,3,6.83E-06,9.47E-06,1,2
birthright,4,7.35E-06,3,6.83E-06,9.47E-06,1,2
everglades,4,7.35E-06,2,4.56E-06,1.89E-05,2,3
graduating,4,7.35E-06,2,4.56E-06,1.89E-05,2,3
describing,4,7.35E-06,3,6.83E-06,9.47E-06,1,3
congestion,4,7.35E-06,3,6.83E-06,9.47E-06,1,3
aggressive,4,7.35E-06,3,6.83E-06,9.47E-06,1,3
invincible,4,7.35E-06,2,4.56E-06,1.89E-05,2,4
valentines,4,7.35E-06,0,0,3.79E-05,4,3
undermines,4,7.35E-06,2,4.56E-06,1.89E-05,2,3
selflessly,4,7.35E-06,3,6.83E-06,9.47E-06,1,3
compassion,4,7.35E-06,3,6.83E-06,9.47E-06,1,3
introduced,4,7.35E-06,3,6.83E-06,9.47E-06,1,3
philosophy,4,7.35E-06,3,6.83E-06,9.47E-06,1,4
calculator,4,7.35E-06,0,0,3.79E-05,4,4
apparently,4,7.35E-06,3,6.83E-06,9.47E-06,1,4
bargaining,4,7.35E-06,3,6.83E-06,9.47E-06,1,3
conviction,4,7.35E-06,3,6.83E-06,9.47E-06,1,3
unleashing,4,7.35E-06,3,6.83E-06,9.47E-06,1,3
tabulation,4,7.35E-06,4,9.11E-06,0,0,4
contractor,4,7.35E-06,4,9.11E-06,0,0,3
quarantine,4,7.35E-06,4,9.11E-06,0,0,3
superpower,4,7.35E-06,4,9.11E-06,0,0,4
harvesting,4,7.35E-06,4,9.11E-06,0,0,3
excoriated,4,7.35E-06,4,9.11E-06,0,0,3
viewership,4,7.35E-06,4,9.11E-06,0,0,3
monumental,4,7.35E-06,4,9.11E-06,0,0,4
discretion,4,7.35E-06,4,9.11E-06,0,0,3
dismissing,4,7.35E-06,4,9.11E-06,0,0,3
protesting,4,7.35E-06,4,9.11E-06,0,0,3
dominating,4,7.35E-06,4,9.11E-06,0,0,4
distancing,4,7.35E-06,4,9.11E-06,0,0,3
improperly,4,7.35E-06,4,9.11E-06,0,0,4
consistent,4,7.35E-06,4,9.11E-06,0,0,3
circulated,4,7.35E-06,4,9.11E-06,0,0,3
electrical,4,7.35E-06,4,9.11E-06,0,0,4
nominating,4,7.35E-06,4,9.11E-06,0,0,4
unfairness,4,7.35E-06,4,9.11E-06,0,0,3
industrial,4,7.35E-06,4,9.11E-06,0,0,3
mistakenly,4,7.35E-06,4,9.11E-06,0,0,4
delinquent,4,7.35E-06,4,9.11E-06,0,0,3
astronauts,4,7.35E-06,4,9.11E-06,0,0,3
ungrateful,4,7.35E-06,4,9.11E-06,0,0,4
degenerate,4,7.35E-06,4,9.11E-06,0,0,4
suggesting,4,7.35E-06,4,9.11E-06,0,0,3
evacuation,4,7.35E-06,4,9.11E-06,0,0,4
obstructed,4,7.35E-06,4,9.11E-06,0,0,2
memorandum,4,7.35E-06,4,9.11E-06,0,0,4
servicemen,4,7.35E-06,4,9.11E-06,0,0,4
mentioning,4,7.35E-06,4,9.11E-06,0,0,3
somethings,4,7.35E-06,4,9.11E-06,0,0,3
declassify,4,7.35E-06,4,9.11E-06,0,0,4
wrongdoing,4,7.35E-06,4,9.11E-06,0,0,2
weaponized,4,7.35E-06,4,9.11E-06,0,0,3
comment,4,7.35E-06,4,9.11E-06,0,0,2
scammed,4,7.35E-06,4,9.11E-06,0,0,1
immense,4,7.35E-06,4,9.11E-06,0,0,2
mouthed,4,7.35E-06,4,9.11E-06,0,0,1
bothered,4,7.35E-06,4,9.11E-06,0,0,2
cathedral,4,7.35E-06,4,9.11E-06,0,0,3
commercials,4,7.35E-06,4,9.11E-06,0,0,3
vindication,4,7.35E-06,3,6.83E-06,9.47E-06,1,4
overturning,4,7.35E-06,1,2.28E-06,2.84E-05,3,4
nonpartisan,4,7.35E-06,1,2.28E-06,2.84E-05,3,4
certificate,4,7.35E-06,0,0,3.79E-05,4,4
preparation,4,7.35E-06,4,9.11E-06,0,0,4
lawlessness,4,7.35E-06,4,9.11E-06,0,0,3
efficiently,4,7.35E-06,4,9.11E-06,0,0,4
destabilize,4,7.35E-06,4,9.11E-06,0,0,4
warfighters,4,7.35E-06,4,9.11E-06,0,0,3
compliments,4,7.35E-06,4,9.11E-06,0,0,3
evangelical,4,7.35E-06,4,9.11E-06,0,0,5
surrounding,4,7.35E-06,4,9.11E-06,0,0,3
description,4,7.35E-06,4,9.11E-06,0,0,3
interchange,4,7.35E-06,4,9.11E-06,0,0,3
reconstruct,4,7.35E-06,4,9.11E-06,0,0,3
congressmen,4,7.35E-06,4,9.11E-06,0,0,3
credentials,4,7.35E-06,4,9.11E-06,0,0,3
established,4,7.35E-06,4,9.11E-06,0,0,3
inaugurated,4,7.35E-06,4,9.11E-06,0,0,4
trumprussia,4,7.35E-06,4,9.11E-06,0,0,3
everlasting,4,7.35E-06,4,9.11E-06,0,0,4
differently,4,7.35E-06,4,9.11E-06,0,0,4
astonishing,4,7.35E-06,4,9.11E-06,0,0,4
accumulated,4,7.35E-06,4,9.11E-06,0,0,4
consistently,4,7.35E-06,2,4.56E-06,1.89E-05,2,4
embarrassing,4,7.35E-06,3,6.83E-06,9.47E-06,1,4
tremendously,4,7.35E-06,4,9.11E-06,0,0,4
miraculously,4,7.35E-06,4,9.11E-06,0,0,5
indoctrinate,4,7.35E-06,4,9.11E-06,0,0,4
jurisdiction,4,7.35E-06,4,9.11E-06,0,0,4
applications,4,7.35E-06,4,9.11E-06,0,0,4
denuclearize,4,7.35E-06,4,9.11E-06,0,0,4
preparations,4,7.35E-06,4,9.11E-06,0,0,4
confidential,4,7.35E-06,4,9.11E-06,0,0,4
congratulates,4,7.35E-06,1,2.28E-06,2.84E-05,3,4
grandchildren,4,7.35E-06,2,4.56E-06,1.89E-05,2,3
inappropriate,4,7.35E-06,4,9.11E-06,0,0,4
consequential,4,7.35E-06,4,9.11E-06,0,0,4
administrator,4,7.35E-06,4,9.11E-06,0,0,5
congratulating,4,7.35E-06,2,4.56E-06,1.89E-05,2,5
accomplishment,4,7.35E-06,2,4.56E-06,1.89E-05,2,4
identification,4,7.35E-06,4,9.11E-06,0,0,6
representation,4,7.35E-06,4,9.11E-06,0,0,5
environmentalists,4,7.35E-06,1,2.28E-06,2.84E-05,3,6
eat,3,5.51E-06,2,4.56E-06,9.47E-06,1,1
bfd,3,5.51E-06,0,0,2.84E-05,3,1
bar,3,5.51E-06,2,4.56E-06,9.47E-06,1,1
cbo,3,5.51E-06,1,2.28E-06,1.89E-05,2,1
sox,3,5.51E-06,1,2.28E-06,1.89E-05,2,1
tip,3,5.51E-06,2,4.56E-06,9.47E-06,1,1
ton,3,5.51E-06,2,4.56E-06,9.47E-06,1,1
feb,3,5.51E-06,0,0,2.84E-05,3,1
cry,3,5.51E-06,2,4.56E-06,9.47E-06,1,1
pin,3,5.51E-06,2,4.56E-06,9.47E-06,1,1
dam,3,5.51E-06,3,6.83E-06,0,0,1
gen,3,5.51E-06,3,6.83E-06,0,0,1
lsu,3,5.51E-06,3,6.83E-06,0,0,1
bed,3,5.51E-06,3,6.83E-06,0,0,1
sin,3,5.51E-06,3,6.83E-06,0,0,1
jeb,3,5.51E-06,3,6.83E-06,0,0,1
wet,3,5.51E-06,3,6.83E-06,0,0,1
nda,3,5.51E-06,3,6.83E-06,0,0,1
ali,3,5.51E-06,3,6.83E-06,0,0,1
jfk,3,5.51E-06,3,6.83E-06,0,0,1
pen,3,5.51E-06,3,6.83E-06,0,0,1
dhs,3,5.51E-06,3,6.83E-06,0,0,1
dir,3,5.51E-06,3,6.83E-06,0,0,1
rat,3,5.51E-06,3,6.83E-06,0,0,1
lng,3,5.51E-06,3,6.83E-06,0,0,1
asa,3,5.51E-06,3,6.83E-06,0,0,1
rob,3,5.51E-06,3,6.83E-06,0,0,1
hint,3,5.51E-06,0,0,2.84E-05,3,1
dust,3,5.51E-06,1,2.28E-06,1.89E-05,2,1
beau,3,5.51E-06,0,0,2.84E-05,3,2
maya,3,5.51E-06,0,0,2.84E-05,3,2
moms,3,5.51E-06,0,0,2.84E-05,3,1
myth,3,5.51E-06,1,2.28E-06,1.89E-05,2,1
lori,3,5.51E-06,2,4.56E-06,9.47E-06,1,2
shop,3,5.51E-06,1,2.28E-06,1.89E-05,2,1
tova,3,5.51E-06,1,2.28E-06,1.89E-05,2,2
doma,3,5.51E-06,0,0,2.84E-05,3,2
tear,3,5.51E-06,2,4.56E-06,9.47E-06,1,1
dime,3,5.51E-06,1,2.28E-06,1.89E-05,2,1
bird,3,5.51E-06,0,0,2.84E-05,3,1
wire,3,5.51E-06,2,4.56E-06,9.47E-06,1,1
jerk,3,5.51E-06,2,4.56E-06,9.47E-06,1,1
owes,3,5.51E-06,2,4.56E-06,9.47E-06,1,1
prep,3,5.51E-06,2,4.56E-06,9.47E-06,1,1
owns,3,5.51E-06,1,2.28E-06,1.89E-05,2,1
helm,3,5.51E-06,2,4.56E-06,9.47E-06,1,1
pink,3,5.51E-06,0,0,2.84E-05,3,1
rosh,3,5.51E-06,2,4.56E-06,9.47E-06,1,1
root,3,5.51E-06,2,4.56E-06,9.47E-06,1,1
usps,3,5.51E-06,3,6.83E-06,0,0,1
zach,3,5.51E-06,3,6.83E-06,0,0,1
slam,3,5.51E-06,3,6.83E-06,0,0,1
myer,3,5.51E-06,3,6.83E-06,0,0,1
Ú¯Ø±,3,5.51E-06,3,6.83E-06,0,0,#ERROR!
fate,3,5.51E-06,3,6.83E-06,0,0,1
cnbc,3,5.51E-06,3,6.83E-06,0,0,#ERROR!
drag,3,5.51E-06,3,6.83E-06,0,0,1
soft,3,5.51E-06,3,6.83E-06,0,0,1
sara,3,5.51E-06,3,6.83E-06,0,0,2
bang,3,5.51E-06,3,6.83E-06,0,0,1
foes,3,5.51E-06,3,6.83E-06,0,0,1
slot,3,5.51E-06,3,6.83E-06,0,0,1
rant,3,5.51E-06,3,6.83E-06,0,0,1
ruth,3,5.51E-06,3,6.83E-06,0,0,1
chad,3,5.51E-06,3,6.83E-06,0,0,1
lier,3,5.51E-06,3,6.83E-06,0,0,1
hows,3,5.51E-06,3,6.83E-06,0,0,1
drum,3,5.51E-06,3,6.83E-06,0,0,1
lawn,3,5.51E-06,3,6.83E-06,0,0,1
curt,3,5.51E-06,3,6.83E-06,0,0,1
cain,3,5.51E-06,3,6.83E-06,0,0,1
legs,3,5.51E-06,3,6.83E-06,0,0,1
wapo,3,5.51E-06,3,6.83E-06,0,0,2
noko,3,5.51E-06,3,6.83E-06,0,0,2
mapp,3,5.51E-06,3,6.83E-06,0,0,1
amir,3,5.51E-06,3,6.83E-06,0,0,2
boat,3,5.51E-06,3,6.83E-06,0,0,1
lame,3,5.51E-06,3,6.83E-06,0,0,1
jane,3,5.51E-06,3,6.83E-06,0,0,1
jams,3,5.51E-06,3,6.83E-06,0,0,1
flee,3,5.51E-06,3,6.83E-06,0,0,1
tide,3,5.51E-06,3,6.83E-06,0,0,1
cows,3,5.51E-06,3,6.83E-06,0,0,1
tons,3,5.51E-06,3,6.83E-06,0,0,1
asset,3,5.51E-06,2,4.56E-06,9.47E-06,1,2
selma,3,5.51E-06,0,0,2.84E-05,3,2
risen,3,5.51E-06,1,2.28E-06,1.89E-05,2,2
joins,3,5.51E-06,1,2.28E-06,1.89E-05,2,1
ebola,3,5.51E-06,1,2.28E-06,1.89E-05,2,3
budge,3,5.51E-06,2,4.56E-06,9.47E-06,1,1
ladys,3,5.51E-06,0,0,2.84E-05,3,2
ethic,3,5.51E-06,1,2.28E-06,1.89E-05,2,2
broad,3,5.51E-06,2,4.56E-06,9.47E-06,1,1
awful,3,5.51E-06,2,4.56E-06,9.47E-06,1,2
shore,3,5.51E-06,2,4.56E-06,9.47E-06,1,1
glass,3,5.51E-06,2,4.56E-06,9.47E-06,1,1
weigh,3,5.51E-06,0,0,2.84E-05,3,1
angel,3,5.51E-06,2,4.56E-06,9.47E-06,1,2
retro,3,5.51E-06,0,0,2.84E-05,3,2
sixth,3,5.51E-06,2,4.56E-06,9.47E-06,1,1
reply,3,5.51E-06,1,2.28E-06,1.89E-05,2,2
dewey,3,5.51E-06,2,4.56E-06,9.47E-06,1,2
meets,3,5.51E-06,1,2.28E-06,1.89E-05,2,1
santa,3,5.51E-06,2,4.56E-06,9.47E-06,1,2
rails,3,5.51E-06,1,2.28E-06,1.89E-05,2,1
strip,3,5.51E-06,2,4.56E-06,9.47E-06,1,1
irene,3,5.51E-06,0,0,2.84E-05,3,2
alice,3,5.51E-06,2,4.56E-06,9.47E-06,1,2
swear,3,5.51E-06,2,4.56E-06,9.47E-06,1,1
latin,3,5.51E-06,2,4.56E-06,9.47E-06,1,2
lunar,3,5.51E-06,2,4.56E-06,9.47E-06,1,2
slide,3,5.51E-06,2,4.56E-06,9.47E-06,1,1
elise,3,5.51E-06,3,6.83E-06,0,0,2
nolte,3,5.51E-06,3,6.83E-06,0,0,1
krebs,3,5.51E-06,3,6.83E-06,0,0,1
clark,3,5.51E-06,3,6.83E-06,0,0,1
tribe,3,5.51E-06,3,6.83E-06,0,0,1
hogan,3,5.51E-06,3,6.83E-06,0,0,2
ocala,3,5.51E-06,3,6.83E-06,0,0,3
coney,3,5.51E-06,3,6.83E-06,0,0,2
techs,3,5.51E-06,3,6.83E-06,0,0,1
jorge,3,5.51E-06,3,6.83E-06,0,0,1
hicks,3,5.51E-06,3,6.83E-06,0,0,1
rubin,3,5.51E-06,3,6.83E-06,0,0,2
yemen,3,5.51E-06,3,6.83E-06,0,0,2
knife,3,5.51E-06,3,6.83E-06,0,0,1
troop,3,5.51E-06,3,6.83E-06,0,0,1
actor,3,5.51E-06,3,6.83E-06,0,0,2
error,3,5.51E-06,3,6.83E-06,0,0,2
forts,3,5.51E-06,3,6.83E-06,0,0,1
noted,3,5.51E-06,3,6.83E-06,0,0,1
delta,3,5.51E-06,3,6.83E-06,0,0,2
fried,3,5.51E-06,3,6.83E-06,0,0,1
swift,3,5.51E-06,3,6.83E-06,0,0,1
smear,3,5.51E-06,3,6.83E-06,0,0,1
lesko,3,5.51E-06,3,6.83E-06,0,0,2
maker,3,5.51E-06,3,6.83E-06,0,0,2
corky,3,5.51E-06,3,6.83E-06,0,0,2
route,3,5.51E-06,3,6.83E-06,0,0,1
gavin,3,5.51E-06,3,6.83E-06,0,0,2
frack,3,5.51E-06,3,6.83E-06,0,0,1
alarm,3,5.51E-06,3,6.83E-06,0,0,2
royal,3,5.51E-06,3,6.83E-06,0,0,2
lynda,3,5.51E-06,3,6.83E-06,0,0,2
shady,3,5.51E-06,3,6.83E-06,0,0,2
bucks,3,5.51E-06,3,6.83E-06,0,0,1
smash,3,5.51E-06,3,6.83E-06,0,0,1
trove,3,5.51E-06,3,6.83E-06,0,0,1
hacks,3,5.51E-06,3,6.83E-06,0,0,1
bogus,3,5.51E-06,3,6.83E-06,0,0,2
havoc,3,5.51E-06,3,6.83E-06,0,0,2
outed,3,5.51E-06,3,6.83E-06,0,0,1
tyler,3,5.51E-06,3,6.83E-06,0,0,2
logan,3,5.51E-06,3,6.83E-06,0,0,2
spews,3,5.51E-06,3,6.83E-06,0,0,1
creep,3,5.51E-06,3,6.83E-06,0,0,1
hbcus,3,5.51E-06,3,6.83E-06,0,0,1
flies,3,5.51E-06,3,6.83E-06,0,0,1
salon,3,5.51E-06,3,6.83E-06,0,0,2
lenin,3,5.51E-06,3,6.83E-06,0,0,2
booed,3,5.51E-06,3,6.83E-06,0,0,1
older,3,5.51E-06,3,6.83E-06,0,0,2
regis,3,5.51E-06,3,6.83E-06,0,0,2
cathy,3,5.51E-06,3,6.83E-06,0,0,2
vicky,3,5.51E-06,3,6.83E-06,0,0,2
chase,3,5.51E-06,3,6.83E-06,0,0,1
horse,3,5.51E-06,3,6.83E-06,0,0,1
radio,3,5.51E-06,3,6.83E-06,0,0,2
petro,3,5.51E-06,3,6.83E-06,0,0,2
yield,3,5.51E-06,3,6.83E-06,0,0,1
diane,3,5.51E-06,3,6.83E-06,0,0,1
plead,3,5.51E-06,3,6.83E-06,0,0,1
clips,3,5.51E-06,3,6.83E-06,0,0,1
hcare,3,5.51E-06,3,6.83E-06,0,0,1
nukes,3,5.51E-06,3,6.83E-06,0,0,1
tones,3,5.51E-06,3,6.83E-06,0,0,1
mazda,3,5.51E-06,3,6.83E-06,0,0,2
qatar,3,5.51E-06,3,6.83E-06,0,0,2
lakes,3,5.51E-06,3,6.83E-06,0,0,1
ernie,3,5.51E-06,3,6.83E-06,0,0,2
flows,3,5.51E-06,3,6.83E-06,0,0,1
kinds,3,5.51E-06,3,6.83E-06,0,0,1
braun,3,5.51E-06,3,6.83E-06,0,0,1
minus,3,5.51E-06,3,6.83E-06,0,0,2
vince,3,5.51E-06,3,6.83E-06,0,0,1
heels,3,5.51E-06,3,6.83E-06,0,0,1
gowdy,3,5.51E-06,3,6.83E-06,0,0,2
sport,3,5.51E-06,3,6.83E-06,0,0,1
avail,3,5.51E-06,3,6.83E-06,0,0,2
bonus,3,5.51E-06,3,6.83E-06,0,0,2
sicko,3,5.51E-06,3,6.83E-06,0,0,2
wreck,3,5.51E-06,3,6.83E-06,0,0,1
bribe,3,5.51E-06,3,6.83E-06,0,0,1
farce,3,5.51E-06,3,6.83E-06,0,0,1
conte,3,5.51E-06,3,6.83E-06,0,0,1
mario,3,5.51E-06,3,6.83E-06,0,0,2
poway,3,5.51E-06,3,6.83E-06,0,0,2
golan,3,5.51E-06,3,6.83E-06,0,0,2
aiming,3,5.51E-06,2,4.56E-06,9.47E-06,1,2
cynics,3,5.51E-06,0,0,2.84E-05,3,2
repair,3,5.51E-06,1,2.28E-06,1.89E-05,2,2
parent,3,5.51E-06,1,2.28E-06,1.89E-05,2,2
shapes,3,5.51E-06,2,4.56E-06,9.47E-06,1,1
sprint,3,5.51E-06,2,4.56E-06,9.47E-06,1,1
keeper,3,5.51E-06,0,0,2.84E-05,3,2
trains,3,5.51E-06,1,2.28E-06,1.89E-05,2,1
joshua,3,5.51E-06,1,2.28E-06,1.89E-05,2,2
lonely,3,5.51E-06,2,4.56E-06,9.47E-06,1,3
unborn,3,5.51E-06,2,4.56E-06,9.47E-06,1,2
caring,3,5.51E-06,1,2.28E-06,1.89E-05,2,2
poised,3,5.51E-06,2,4.56E-06,9.47E-06,1,1
trends,3,5.51E-06,2,4.56E-06,9.47E-06,1,1
trials,3,5.51E-06,2,4.56E-06,9.47E-06,1,1
joyous,3,5.51E-06,1,2.28E-06,1.89E-05,2,2
asthma,3,5.51E-06,0,0,2.84E-05,3,2
bounce,3,5.51E-06,2,4.56E-06,9.47E-06,1,1
semper,3,5.51E-06,2,4.56E-06,9.47E-06,1,2
racked,3,5.51E-06,1,2.28E-06,1.89E-05,2,1
upheld,3,5.51E-06,0,0,2.84E-05,3,2
foster,3,5.51E-06,2,4.56E-06,9.47E-06,1,2
purple,3,5.51E-06,2,4.56E-06,9.47E-06,1,2
takers,3,5.51E-06,2,4.56E-06,9.47E-06,1,2
method,3,5.51E-06,2,4.56E-06,9.47E-06,1,2
casino,3,5.51E-06,1,2.28E-06,1.89E-05,2,3
ranked,3,5.51E-06,1,2.28E-06,1.89E-05,2,1
gerald,3,5.51E-06,2,4.56E-06,9.47E-06,1,2
intend,3,5.51E-06,2,4.56E-06,9.47E-06,1,2
scenes,3,5.51E-06,2,4.56E-06,9.47E-06,1,1
pierce,3,5.51E-06,1,2.28E-06,1.89E-05,2,1
depend,3,5.51E-06,1,2.28E-06,1.89E-05,2,2
custom,3,5.51E-06,1,2.28E-06,1.89E-05,2,2
rebate,3,5.51E-06,0,0,2.84E-05,3,2
barber,3,5.51E-06,1,2.28E-06,1.89E-05,2,2
havens,3,5.51E-06,1,2.28E-06,1.89E-05,2,2
replay,3,5.51E-06,2,4.56E-06,9.47E-06,1,2
charts,3,5.51E-06,2,4.56E-06,9.47E-06,1,1
parker,3,5.51E-06,2,4.56E-06,9.47E-06,1,2
fairer,3,5.51E-06,1,2.28E-06,1.89E-05,2,2
daring,3,5.51E-06,2,4.56E-06,9.47E-06,1,2
iphone,3,5.51E-06,1,2.28E-06,1.89E-05,2,2
finger,3,5.51E-06,2,4.56E-06,9.47E-06,1,2
approx,3,5.51E-06,2,4.56E-06,9.47E-06,1,2
finals,3,5.51E-06,2,4.56E-06,9.47E-06,1,2
cheney,3,5.51E-06,2,4.56E-06,9.47E-06,1,2
stream,3,5.51E-06,1,2.28E-06,1.89E-05,2,1
lights,3,5.51E-06,2,4.56E-06,9.47E-06,1,1
filing,3,5.51E-06,2,4.56E-06,9.47E-06,1,2
emerge,3,5.51E-06,2,4.56E-06,9.47E-06,1,2
weaken,3,5.51E-06,2,4.56E-06,9.47E-06,1,2
viable,3,5.51E-06,3,6.83E-06,0,0,2
regain,3,5.51E-06,3,6.83E-06,0,0,2
delphi,3,5.51E-06,3,6.83E-06,0,0,2
toomey,3,5.51E-06,3,6.83E-06,0,0,2
tossed,3,5.51E-06,3,6.83E-06,0,0,1
stacey,3,5.51E-06,3,6.83E-06,0,0,2
viewed,3,5.51E-06,3,6.83E-06,0,0,1
staten,3,5.51E-06,3,6.83E-06,0,0,2
sleaze,3,5.51E-06,3,6.83E-06,0,0,1
sample,3,5.51E-06,3,6.83E-06,0,0,2
sidney,3,5.51E-06,3,6.83E-06,0,0,2
insure,3,5.51E-06,3,6.83E-06,0,0,2
censor,3,5.51E-06,3,6.83E-06,0,0,2
solely,3,5.51E-06,3,6.83E-06,0,0,3
prople,3,5.51E-06,3,6.83E-06,0,0,2
vernon,3,5.51E-06,3,6.83E-06,0,0,2
misery,3,5.51E-06,3,6.83E-06,0,0,3
forged,3,5.51E-06,3,6.83E-06,0,0,1
durham,3,5.51E-06,3,6.83E-06,0,0,2
absurd,3,5.51E-06,3,6.83E-06,0,0,2
libyan,3,5.51E-06,3,6.83E-06,0,0,2
laxalt,3,5.51E-06,3,6.83E-06,0,0,2
nessel,3,5.51E-06,3,6.83E-06,0,0,2
excess,3,5.51E-06,3,6.83E-06,0,0,2
tucker,3,5.51E-06,3,6.83E-06,0,0,2
booker,3,5.51E-06,3,6.83E-06,0,0,2
lapdog,3,5.51E-06,3,6.83E-06,0,0,2
dumber,3,5.51E-06,3,6.83E-06,0,0,2
wicked,3,5.51E-06,3,6.83E-06,0,0,1
outlet,3,5.51E-06,3,6.83E-06,0,0,2
porous,3,5.51E-06,3,6.83E-06,0,0,2
nancys,3,5.51E-06,3,6.83E-06,0,0,2
rushed,3,5.51E-06,3,6.83E-06,0,0,1
kosovo,3,5.51E-06,3,6.83E-06,0,0,3
needle,3,5.51E-06,3,6.83E-06,0,0,2
tribal,3,5.51E-06,3,6.83E-06,0,0,2
tracks,3,5.51E-06,3,6.83E-06,0,0,1
kasich,3,5.51E-06,3,6.83E-06,0,0,2
loosen,3,5.51E-06,3,6.83E-06,0,0,2
affair,3,5.51E-06,3,6.83E-06,0,0,2
artist,3,5.51E-06,3,6.83E-06,0,0,2
framed,3,5.51E-06,3,6.83E-06,0,0,1
jacobs,3,5.51E-06,3,6.83E-06,0,0,2
strict,3,5.51E-06,3,6.83E-06,0,0,1
plunge,3,5.51E-06,3,6.83E-06,0,0,1
blasts,3,5.51E-06,3,6.83E-06,0,0,1
faulty,3,5.51E-06,3,6.83E-06,0,0,2
navajo,3,5.51E-06,3,6.83E-06,0,0,3
models,3,5.51E-06,3,6.83E-06,0,0,2
purely,3,5.51E-06,3,6.83E-06,0,0,3
escape,3,5.51E-06,3,6.83E-06,0,0,2
invoke,3,5.51E-06,3,6.83E-06,0,0,2
beware,3,5.51E-06,3,6.83E-06,0,0,2
payoff,3,5.51E-06,3,6.83E-06,0,0,2
nascar,3,5.51E-06,3,6.83E-06,0,0,2
mailed,3,5.51E-06,3,6.83E-06,0,0,1
safest,3,5.51E-06,3,6.83E-06,0,0,2
richly,3,5.51E-06,3,6.83E-06,0,0,2
klacik,3,5.51E-06,3,6.83E-06,0,0,2
cuomos,3,5.51E-06,3,6.83E-06,0,0,2
christ,3,5.51E-06,3,6.83E-06,0,0,1
jumped,3,5.51E-06,3,6.83E-06,0,0,1
conman,3,5.51E-06,3,6.83E-06,0,0,2
extent,3,5.51E-06,3,6.83E-06,0,0,2
desire,3,5.51E-06,3,6.83E-06,0,0,2
shaped,3,5.51E-06,3,6.83E-06,0,0,1
lester,3,5.51E-06,3,6.83E-06,0,0,2
blamed,3,5.51E-06,3,6.83E-06,0,0,1
droves,3,5.51E-06,3,6.83E-06,0,0,1
resume,3,5.51E-06,3,6.83E-06,0,0,2
pilots,3,5.51E-06,3,6.83E-06,0,0,2
moreno,3,5.51E-06,3,6.83E-06,0,0,3
slower,3,5.51E-06,3,6.83E-06,0,0,2
bureau,3,5.51E-06,3,6.83E-06,0,0,3
zoning,3,5.51E-06,3,6.83E-06,0,0,2
unused,3,5.51E-06,3,6.83E-06,0,0,2
fading,3,5.51E-06,3,6.83E-06,0,0,2
foiled,3,5.51E-06,3,6.83E-06,0,0,1
design,3,5.51E-06,3,6.83E-06,0,0,2
import,3,5.51E-06,3,6.83E-06,0,0,2
fueled,3,5.51E-06,3,6.83E-06,0,0,1
laffer,3,5.51E-06,3,6.83E-06,0,0,2
virgin,3,5.51E-06,3,6.83E-06,0,0,2
blames,3,5.51E-06,3,6.83E-06,0,0,1
somber,3,5.51E-06,3,6.83E-06,0,0,2
handel,3,5.51E-06,3,6.83E-06,0,0,2
sergio,3,5.51E-06,3,6.83E-06,0,0,2
eleven,3,5.51E-06,3,6.83E-06,0,0,3
german,3,5.51E-06,3,6.83E-06,0,0,2
bikers,3,5.51E-06,3,6.83E-06,0,0,2
julian,3,5.51E-06,3,6.83E-06,0,0,2
actors,3,5.51E-06,3,6.83E-06,0,0,2
hanson,3,5.51E-06,3,6.83E-06,0,0,2
warmly,3,5.51E-06,3,6.83E-06,0,0,2
sooooo,3,5.51E-06,3,6.83E-06,0,0,3
median,3,5.51E-06,3,6.83E-06,0,0,2
zeldin,3,5.51E-06,3,6.83E-06,0,0,2
morici,3,5.51E-06,3,6.83E-06,0,0,3
felons,3,5.51E-06,3,6.83E-06,0,0,2
appear,3,5.51E-06,3,6.83E-06,0,0,2
trumka,3,5.51E-06,3,6.83E-06,0,0,2
stamps,3,5.51E-06,3,6.83E-06,0,0,1
boxing,3,5.51E-06,3,6.83E-06,0,0,2
savage,3,5.51E-06,3,6.83E-06,0,0,2
smears,3,5.51E-06,3,6.83E-06,0,0,1
turley,3,5.51E-06,3,6.83E-06,0,0,2
fakers,3,5.51E-06,3,6.83E-06,0,0,2
waiver,3,5.51E-06,3,6.83E-06,0,0,2
snakes,3,5.51E-06,3,6.83E-06,0,0,1
remake,3,5.51E-06,3,6.83E-06,0,0,2
studio,3,5.51E-06,3,6.83E-06,0,0,2
naming,3,5.51E-06,3,6.83E-06,0,0,2
grazed,3,5.51E-06,3,6.83E-06,0,0,1
huawei,3,5.51E-06,3,6.83E-06,0,0,2
rivlin,3,5.51E-06,3,6.83E-06,0,0,2
tables,3,5.51E-06,3,6.83E-06,0,0,2
guaido,3,5.51E-06,3,6.83E-06,0,0,3
fridays,3,5.51E-06,1,2.28E-06,1.89E-05,2,2
absence,3,5.51E-06,0,0,2.84E-05,3,2
sisters,3,5.51E-06,0,0,2.84E-05,3,2
conquer,3,5.51E-06,2,4.56E-06,9.47E-06,1,2
applied,3,5.51E-06,2,4.56E-06,9.47E-06,1,2
persons,3,5.51E-06,1,2.28E-06,1.89E-05,2,2
cynical,3,5.51E-06,0,0,2.84E-05,3,3
soaring,3,5.51E-06,2,4.56E-06,9.47E-06,1,2
angelou,3,5.51E-06,0,0,2.84E-05,3,3
trapped,3,5.51E-06,0,0,2.84E-05,3,1
suffers,3,5.51E-06,2,4.56E-06,9.47E-06,1,2
strikes,3,5.51E-06,1,2.28E-06,1.89E-05,2,1
slowing,3,5.51E-06,2,4.56E-06,9.47E-06,1,2
urgency,3,5.51E-06,1,2.28E-06,1.89E-05,2,3
praises,3,5.51E-06,2,4.56E-06,9.47E-06,1,1
pioneer,3,5.51E-06,1,2.28E-06,1.89E-05,2,2
airfare,3,5.51E-06,0,0,2.84E-05,3,2
expands,3,5.51E-06,2,4.56E-06,9.47E-06,1,2
buddies,3,5.51E-06,0,0,2.84E-05,3,2
rewards,3,5.51E-06,1,2.28E-06,1.89E-05,2,2
invests,3,5.51E-06,0,0,2.84E-05,3,2
reduces,3,5.51E-06,2,4.56E-06,9.47E-06,1,2
chasing,3,5.51E-06,2,4.56E-06,9.47E-06,1,2
resumes,3,5.51E-06,0,0,2.84E-05,3,2
mindset,3,5.51E-06,2,4.56E-06,9.47E-06,1,2
boovote,3,5.51E-06,0,0,2.84E-05,3,2
depends,3,5.51E-06,1,2.28E-06,1.89E-05,2,2
valerie,3,5.51E-06,2,4.56E-06,9.47E-06,1,3
travels,3,5.51E-06,2,4.56E-06,9.47E-06,1,2
tourism,3,5.51E-06,1,2.28E-06,1.89E-05,2,2
cordray,3,5.51E-06,1,2.28E-06,1.89E-05,2,2
pending,3,5.51E-06,2,4.56E-06,9.47E-06,1,2
artists,3,5.51E-06,2,4.56E-06,9.47E-06,1,2
shelter,3,5.51E-06,1,2.28E-06,1.89E-05,2,2
renewal,3,5.51E-06,2,4.56E-06,9.47E-06,1,3
budgets,3,5.51E-06,2,4.56E-06,9.47E-06,1,2
rescued,3,5.51E-06,2,4.56E-06,9.47E-06,1,2
sundays,3,5.51E-06,2,4.56E-06,9.47E-06,1,2
secures,3,5.51E-06,2,4.56E-06,9.47E-06,1,2
kickoff,3,5.51E-06,1,2.28E-06,1.89E-05,2,2
schmidt,3,5.51E-06,3,6.83E-06,0,0,1
healing,3,5.51E-06,3,6.83E-06,0,0,2
orleans,3,5.51E-06,3,6.83E-06,0,0,2
prepaid,3,5.51E-06,3,6.83E-06,0,0,2
pointed,3,5.51E-06,3,6.83E-06,0,0,1
circles,3,5.51E-06,3,6.83E-06,0,0,2
altered,3,5.51E-06,3,6.83E-06,0,0,2
brazile,3,5.51E-06,3,6.83E-06,0,0,3
cleanup,3,5.51E-06,3,6.83E-06,0,0,2
vibrant,3,5.51E-06,3,6.83E-06,0,0,2
screwed,3,5.51E-06,3,6.83E-06,0,0,1
nigeria,3,5.51E-06,3,6.83E-06,0,0,3
miranda,3,5.51E-06,3,6.83E-06,0,0,3
madness,3,5.51E-06,3,6.83E-06,0,0,2
stuffed,3,5.51E-06,3,6.83E-06,0,0,1
margins,3,5.51E-06,3,6.83E-06,0,0,2
flipped,3,5.51E-06,3,6.83E-06,0,0,1
navarro,3,5.51E-06,3,6.83E-06,0,0,3
harvest,3,5.51E-06,3,6.83E-06,0,0,2
windows,3,5.51E-06,3,6.83E-06,0,0,2
thieves,3,5.51E-06,3,6.83E-06,0,0,1
distort,3,5.51E-06,3,6.83E-06,0,0,2
defraud,3,5.51E-06,3,6.83E-06,0,0,2
despair,3,5.51E-06,3,6.83E-06,0,0,2
inflame,3,5.51E-06,3,6.83E-06,0,0,2
lunatic,3,5.51E-06,3,6.83E-06,0,0,3
rampage,3,5.51E-06,3,6.83E-06,0,0,2
useless,3,5.51E-06,3,6.83E-06,0,0,3
prisons,3,5.51E-06,3,6.83E-06,0,0,2
bumping,3,5.51E-06,3,6.83E-06,0,0,2
mocking,3,5.51E-06,3,6.83E-06,0,0,2
recused,3,5.51E-06,3,6.83E-06,0,0,2
powered,3,5.51E-06,3,6.83E-06,0,0,2
magakag,3,5.51E-06,3,6.83E-06,0,0,3
routine,3,5.51E-06,3,6.83E-06,0,0,2
surgery,3,5.51E-06,3,6.83E-06,0,0,3
wavered,3,5.51E-06,3,6.83E-06,0,0,2
factual,3,5.51E-06,3,6.83E-06,0,0,2
repeals,3,5.51E-06,3,6.83E-06,0,0,2
boltons,3,5.51E-06,3,6.83E-06,0,0,2
debacle,3,5.51E-06,3,6.83E-06,0,0,3
slander,3,5.51E-06,3,6.83E-06,0,0,2
sharper,3,5.51E-06,3,6.83E-06,0,0,2
cowboys,3,5.51E-06,3,6.83E-06,0,0,2
harshly,3,5.51E-06,3,6.83E-06,0,0,2
issuing,3,5.51E-06,3,6.83E-06,0,0,2
tracing,3,5.51E-06,3,6.83E-06,0,0,2
convict,3,5.51E-06,3,6.83E-06,0,0,2
ominous,3,5.51E-06,3,6.83E-06,0,0,3
douglas,3,5.51E-06,3,6.83E-06,0,0,2
harming,3,5.51E-06,3,6.83E-06,0,0,2
lefties,3,5.51E-06,3,6.83E-06,0,0,2
maguire,3,5.51E-06,3,6.83E-06,0,0,2
crazier,3,5.51E-06,3,6.83E-06,0,0,2
shaping,3,5.51E-06,3,6.83E-06,0,0,2
founder,3,5.51E-06,3,6.83E-06,0,0,2
handing,3,5.51E-06,3,6.83E-06,0,0,2
matches,3,5.51E-06,3,6.83E-06,0,0,1
farming,3,5.51E-06,3,6.83E-06,0,0,2
bedford,3,5.51E-06,3,6.83E-06,0,0,2
formula,3,5.51E-06,3,6.83E-06,0,0,3
chaotic,3,5.51E-06,3,6.83E-06,0,0,2
loading,3,5.51E-06,3,6.83E-06,0,0,2
execute,3,5.51E-06,3,6.83E-06,0,0,3
accuses,3,5.51E-06,3,6.83E-06,0,0,2
amateur,3,5.51E-06,3,6.83E-06,0,0,3
lightly,3,5.51E-06,3,6.83E-06,0,0,2
needing,3,5.51E-06,3,6.83E-06,0,0,2
angrily,3,5.51E-06,3,6.83E-06,0,0,3
vehicle,3,5.51E-06,3,6.83E-06,0,0,3
reveals,3,5.51E-06,3,6.83E-06,0,0,2
courses,3,5.51E-06,3,6.83E-06,0,0,1
forgive,3,5.51E-06,3,6.83E-06,0,0,2
oakland,3,5.51E-06,3,6.83E-06,0,0,2
concert,3,5.51E-06,3,6.83E-06,0,0,2
scalise,3,5.51E-06,3,6.83E-06,0,0,2
watches,3,5.51E-06,3,6.83E-06,0,0,1
outlook,3,5.51E-06,3,6.83E-06,0,0,2
erdogan,3,5.51E-06,3,6.83E-06,0,0,3
lessons,3,5.51E-06,3,6.83E-06,0,0,2
ricardo,3,5.51E-06,3,6.83E-06,0,0,3
leagues,3,5.51E-06,3,6.83E-06,0,0,2
dynamic,3,5.51E-06,3,6.83E-06,0,0,3
customs,3,5.51E-06,3,6.83E-06,0,0,2
ridding,3,5.51E-06,3,6.83E-06,0,0,2
triumph,3,5.51E-06,3,6.83E-06,0,0,1
belgium,3,5.51E-06,3,6.83E-06,0,0,2
forests,3,5.51E-06,3,6.83E-06,0,0,2
smiling,3,5.51E-06,3,6.83E-06,0,0,2
assange,3,5.51E-06,3,6.83E-06,0,0,2
wrongly,3,5.51E-06,3,6.83E-06,0,0,2
defying,3,5.51E-06,3,6.83E-06,0,0,2
footage,3,5.51E-06,3,6.83E-06,0,0,2
fearful,3,5.51E-06,3,6.83E-06,0,0,2
screens,3,5.51E-06,3,6.83E-06,0,0,1
wedding,3,5.51E-06,3,6.83E-06,0,0,2
rouhani,3,5.51E-06,3,6.83E-06,0,0,3
ranting,3,5.51E-06,3,6.83E-06,0,0,2
wildest,3,5.51E-06,3,6.83E-06,0,0,2
tearing,3,5.51E-06,3,6.83E-06,0,0,2
jeanine,3,5.51E-06,3,6.83E-06,0,0,2
donovan,3,5.51E-06,3,6.83E-06,0,0,3
wrapped,3,5.51E-06,3,6.83E-06,0,0,1
minions,3,5.51E-06,3,6.83E-06,0,0,2
operate,3,5.51E-06,3,6.83E-06,0,0,3
impacts,3,5.51E-06,3,6.83E-06,0,0,2
bonkers,3,5.51E-06,3,6.83E-06,0,0,2
migrant,3,5.51E-06,3,6.83E-06,0,0,2
crossed,3,5.51E-06,3,6.83E-06,0,0,1
interim,3,5.51E-06,3,6.83E-06,0,0,3
affairs,3,5.51E-06,3,6.83E-06,0,0,2
suicide,3,5.51E-06,3,6.83E-06,0,0,2
revived,3,5.51E-06,3,6.83E-06,0,0,2
plainly,3,5.51E-06,3,6.83E-06,0,0,2
reverse,3,5.51E-06,3,6.83E-06,0,0,2
shiftys,3,5.51E-06,3,6.83E-06,0,0,2
dressed,3,5.51E-06,3,6.83E-06,0,0,1
fragile,3,5.51E-06,3,6.83E-06,0,0,3
pompous,3,5.51E-06,3,6.83E-06,0,0,2
israeli,3,5.51E-06,3,6.83E-06,0,0,3
stooges,3,5.51E-06,3,6.83E-06,0,0,1
bedbugs,3,5.51E-06,3,6.83E-06,0,0,2
joaquin,3,5.51E-06,3,6.83E-06,0,0,2
juaquin,3,5.51E-06,3,6.83E-06,0,0,2
shepard,3,5.51E-06,3,6.83E-06,0,0,2
subvert,3,5.51E-06,3,6.83E-06,0,0,2
visible,3,5.51E-06,3,6.83E-06,0,0,3
devalue,3,5.51E-06,3,6.83E-06,0,0,3
emperor,3,5.51E-06,3,6.83E-06,0,0,3
majesty,3,5.51E-06,3,6.83E-06,0,0,3
ann,3,5.51E-06,2,4.56E-06,9.47E-06,1,1
anna,3,5.51E-06,3,6.83E-06,0,0,2
steadily,3,5.51E-06,2,4.56E-06,9.47E-06,1,3
cynicism,3,5.51E-06,0,0,2.84E-05,3,3
robinson,3,5.51E-06,1,2.28E-06,1.89E-05,2,3
droughts,3,5.51E-06,0,0,2.84E-05,3,1
dramatic,3,5.51E-06,2,4.56E-06,9.47E-06,1,3
throwing,3,5.51E-06,2,4.56E-06,9.47E-06,1,2
renewing,3,5.51E-06,1,2.28E-06,1.89E-05,2,3
campuses,3,5.51E-06,2,4.56E-06,9.47E-06,1,2
darkness,3,5.51E-06,0,0,2.84E-05,3,2
inaction,3,5.51E-06,1,2.28E-06,1.89E-05,2,3
applying,3,5.51E-06,1,2.28E-06,1.89E-05,2,2
memories,3,5.51E-06,0,0,2.84E-05,3,3
lighting,3,5.51E-06,0,0,2.84E-05,3,2
universe,3,5.51E-06,2,4.56E-06,9.47E-06,1,3
survivor,3,5.51E-06,1,2.28E-06,1.89E-05,2,3
defunded,3,5.51E-06,1,2.28E-06,1.89E-05,2,2
stafford,3,5.51E-06,1,2.28E-06,1.89E-05,2,2
ronna,3,5.51E-06,3,6.83E-06,0,0,2
divisive,3,5.51E-06,2,4.56E-06,9.47E-06,1,3
archives,3,5.51E-06,0,0,2.84E-05,3,2
outbreak,3,5.51E-06,2,4.56E-06,9.47E-06,1,2
leveling,3,5.51E-06,0,0,2.84E-05,3,3
advisors,3,5.51E-06,2,4.56E-06,9.47E-06,1,3
striving,3,5.51E-06,0,0,2.84E-05,3,2
pretends,3,5.51E-06,2,4.56E-06,9.47E-06,1,2
describe,3,5.51E-06,2,4.56E-06,9.47E-06,1,2
weakened,3,5.51E-06,2,4.56E-06,9.47E-06,1,2
contrast,3,5.51E-06,2,4.56E-06,9.47E-06,1,2
disloyal,3,5.51E-06,2,4.56E-06,9.47E-06,1,3
totaling,3,5.51E-06,0,0,2.84E-05,3,3
inspires,3,5.51E-06,1,2.28E-06,1.89E-05,2,2
playlist,3,5.51E-06,0,0,2.84E-05,3,2
clooneys,3,5.51E-06,0,0,2.84E-05,3,2
activist,3,5.51E-06,2,4.56E-06,9.47E-06,1,3
proposes,3,5.51E-06,1,2.28E-06,1.89E-05,2,2
mortgage,3,5.51E-06,1,2.28E-06,1.89E-05,2,2
dividing,3,5.51E-06,2,4.56E-06,9.47E-06,1,3
calendar,3,5.51E-06,1,2.28E-06,1.89E-05,2,3
welcomes,3,5.51E-06,0,0,2.84E-05,3,2
disabled,3,5.51E-06,2,4.56E-06,9.47E-06,1,2
revenues,3,5.51E-06,2,4.56E-06,9.47E-06,1,3
enjoying,3,5.51E-06,2,4.56E-06,9.47E-06,1,3
frequent,3,5.51E-06,2,4.56E-06,9.47E-06,1,2
inserted,3,5.51E-06,2,4.56E-06,9.47E-06,1,2
reliance,3,5.51E-06,2,4.56E-06,9.47E-06,1,2
hashanah,3,5.51E-06,2,4.56E-06,9.47E-06,1,3
provider,3,5.51E-06,1,2.28E-06,1.89E-05,2,3
pursuing,3,5.51E-06,2,4.56E-06,9.47E-06,1,2
husbands,3,5.51E-06,2,4.56E-06,9.47E-06,1,2
ordering,3,5.51E-06,2,4.56E-06,9.47E-06,1,3
verified,3,5.51E-06,3,6.83E-06,0,0,3
ignorant,3,5.51E-06,3,6.83E-06,0,0,3
sampling,3,5.51E-06,3,6.83E-06,0,0,2
screamed,3,5.51E-06,3,6.83E-06,0,0,1
checking,3,5.51E-06,3,6.83E-06,0,0,2
victoria,3,5.51E-06,3,6.83E-06,0,0,3
potatoes,3,5.51E-06,3,6.83E-06,0,0,3
stuffing,3,5.51E-06,3,6.83E-06,0,0,2
observed,3,5.51E-06,3,6.83E-06,0,0,2
managers,3,5.51E-06,3,6.83E-06,0,0,3
marxists,3,5.51E-06,3,6.83E-06,0,0,2
miracles,3,5.51E-06,3,6.83E-06,0,0,3
depraved,3,5.51E-06,3,6.83E-06,0,0,2
examined,3,5.51E-06,3,6.83E-06,0,0,3
stifling,3,5.51E-06,3,6.83E-06,0,0,2
destroys,3,5.51E-06,3,6.83E-06,0,0,2
instance,3,5.51E-06,3,6.83E-06,0,0,2
chanting,3,5.51E-06,3,6.83E-06,0,0,2
pensions,3,5.51E-06,3,6.83E-06,0,0,2
doctrine,3,5.51E-06,3,6.83E-06,0,0,2
deployed,3,5.51E-06,3,6.83E-06,0,0,2
advisory,3,5.51E-06,3,6.83E-06,0,0,4
nickname,3,5.51E-06,3,6.83E-06,0,0,2
deputies,3,5.51E-06,3,6.83E-06,0,0,3
truckers,3,5.51E-06,3,6.83E-06,0,0,2
truthful,3,5.51E-06,3,6.83E-06,0,0,2
regional,3,5.51E-06,3,6.83E-06,0,0,3
reflects,3,5.51E-06,3,6.83E-06,0,0,2
bergdahl,3,5.51E-06,3,6.83E-06,0,0,2
dynamics,3,5.51E-06,3,6.83E-06,0,0,3
parental,3,5.51E-06,3,6.83E-06,0,0,3
peddling,3,5.51E-06,3,6.83E-06,0,0,2
declined,3,5.51E-06,3,6.83E-06,0,0,2
obstacle,3,5.51E-06,3,6.83E-06,0,0,3
fabulous,3,5.51E-06,3,6.83E-06,0,0,3
upgrades,3,5.51E-06,3,6.83E-06,0,0,2
courtesy,3,5.51E-06,3,6.83E-06,0,0,3
hopeless,3,5.51E-06,3,6.83E-06,0,0,3
showcase,3,5.51E-06,3,6.83E-06,0,0,2
leverage,3,5.51E-06,3,6.83E-06,0,0,3
conceded,3,5.51E-06,3,6.83E-06,0,0,2
nowadays,3,5.51E-06,3,6.83E-06,0,0,3
monument,3,5.51E-06,3,6.83E-06,0,0,3
denounce,3,5.51E-06,3,6.83E-06,0,0,2
kangaroo,3,5.51E-06,3,6.83E-06,0,0,3
rushmore,3,5.51E-06,3,6.83E-06,0,0,2
recieved,3,5.51E-06,3,6.83E-06,0,0,2
reynolds,3,5.51E-06,3,6.83E-06,0,0,2
decrease,3,5.51E-06,3,6.83E-06,0,0,2
playbook,3,5.51E-06,3,6.83E-06,0,0,2
imposing,3,5.51E-06,3,6.83E-06,0,0,3
sickness,3,5.51E-06,3,6.83E-06,0,0,2
evenings,3,5.51E-06,3,6.83E-06,0,0,3
disarray,3,5.51E-06,3,6.83E-06,0,0,3
actively,3,5.51E-06,3,6.83E-06,0,0,4
pertains,3,5.51E-06,3,6.83E-06,0,0,2
believer,3,5.51E-06,3,6.83E-06,0,0,3
survived,3,5.51E-06,3,6.83E-06,0,0,2
mandated,3,5.51E-06,3,6.83E-06,0,0,2
cowardly,3,5.51E-06,3,6.83E-06,0,0,3
chemical,3,5.51E-06,3,6.83E-06,0,0,3
disposed,3,5.51E-06,3,6.83E-06,0,0,2
grieving,3,5.51E-06,3,6.83E-06,0,0,2
ovations,3,5.51E-06,3,6.83E-06,0,0,3
violates,3,5.51E-06,3,6.83E-06,0,0,2
penguins,3,5.51E-06,3,6.83E-06,0,0,2
feelings,3,5.51E-06,3,6.83E-06,0,0,2
condemns,3,5.51E-06,3,6.83E-06,0,0,2
unfunded,3,5.51E-06,3,6.83E-06,0,0,2
blessing,3,5.51E-06,3,6.83E-06,0,0,2
prestige,3,5.51E-06,3,6.83E-06,0,0,2
benjamin,3,5.51E-06,3,6.83E-06,0,0,3
canadian,3,5.51E-06,3,6.83E-06,0,0,3
executed,3,5.51E-06,3,6.83E-06,0,0,3
lockheed,3,5.51E-06,3,6.83E-06,0,0,2
longtime,3,5.51E-06,3,6.83E-06,0,0,2
strictly,3,5.51E-06,3,6.83E-06,0,0,2
shanahan,3,5.51E-06,3,6.83E-06,0,0,3
retiring,3,5.51E-06,3,6.83E-06,0,0,3
needless,3,5.51E-06,3,6.83E-06,0,0,2
thiessen,3,5.51E-06,3,6.83E-06,0,0,2
redacted,3,5.51E-06,3,6.83E-06,0,0,2
someones,3,5.51E-06,3,6.83E-06,0,0,2
conclude,3,5.51E-06,3,6.83E-06,0,0,2
disputes,3,5.51E-06,3,6.83E-06,0,0,2
morrison,3,5.51E-06,3,6.83E-06,0,0,3
lanny,3,5.51E-06,3,6.83E-06,0,0,2
pushback,3,5.51E-06,3,6.83E-06,0,0,2
diverted,3,5.51E-06,3,6.83E-06,0,0,2
damaging,3,5.51E-06,3,6.83E-06,0,0,3
selfless,3,5.51E-06,3,6.83E-06,0,0,2
donny,3,5.51E-06,3,6.83E-06,0,0,2
detailed,3,5.51E-06,3,6.83E-06,0,0,2
composed,3,5.51E-06,3,6.83E-06,0,0,2
proclaim,3,5.51E-06,3,6.83E-06,0,0,2
outrages,3,5.51E-06,3,6.83E-06,0,0,2
replaces,3,5.51E-06,3,6.83E-06,0,0,2
backfire,3,5.51E-06,3,6.83E-06,0,0,2
checkers,3,5.51E-06,3,6.83E-06,0,0,2
devalued,3,5.51E-06,3,6.83E-06,0,0,3
monetary,3,5.51E-06,3,6.83E-06,0,0,4
stephens,3,5.51E-06,3,6.83E-06,0,0,2
tensions,3,5.51E-06,3,6.83E-06,0,0,2
divorced,3,5.51E-06,3,6.83E-06,0,0,2
flyovers,3,5.51E-06,3,6.83E-06,0,0,2
smuggled,3,5.51E-06,3,6.83E-06,0,0,1
tennis,3,5.51E-06,1,2.28E-06,1.89E-05,2,2
cannon,3,5.51E-06,0,0,2.84E-05,3,2
flynns,3,5.51E-06,3,6.83E-06,0,0,1
skinny,3,5.51E-06,3,6.83E-06,0,0,2
tunnels,3,5.51E-06,3,6.83E-06,0,0,2
innovate,3,5.51E-06,1,2.28E-06,1.89E-05,2,3
brennans,3,5.51E-06,3,6.83E-06,0,0,2
roseanne,3,5.51E-06,3,6.83E-06,0,0,2
henninger,3,5.51E-06,3,6.83E-06,0,0,3
connected,3,5.51E-06,3,6.83E-06,0,0,2
innovators,3,5.51E-06,3,6.83E-06,0,0,4
breadwinners,3,5.51E-06,0,0,2.84E-05,3,3
drill,3,5.51E-06,2,4.56E-06,9.47E-06,1,1
shall,3,5.51E-06,2,4.56E-06,9.47E-06,1,1
tally,3,5.51E-06,2,4.56E-06,9.47E-06,1,2
attract,3,5.51E-06,1,2.28E-06,1.89E-05,2,2
chill,3,5.51E-06,3,6.83E-06,0,0,1
burnett,3,5.51E-06,2,4.56E-06,9.47E-06,1,2
gallon,3,5.51E-06,0,0,2.84E-05,3,2
allied,3,5.51E-06,2,4.56E-06,9.47E-06,1,2
shuttle,3,5.51E-06,1,2.28E-06,1.89E-05,2,2
fallon,3,5.51E-06,1,2.28E-06,1.89E-05,2,2
gazette,3,5.51E-06,3,6.83E-06,0,0,2
patterson,3,5.51E-06,3,6.83E-06,0,0,3
polled,3,5.51E-06,3,6.83E-06,0,0,1
yellow,3,5.51E-06,3,6.83E-06,0,0,2
recall,3,5.51E-06,3,6.83E-06,0,0,2
illness,3,5.51E-06,2,4.56E-06,9.47E-06,1,2
goodlatte,3,5.51E-06,3,6.83E-06,0,0,2
morally,3,5.51E-06,2,4.56E-06,9.47E-06,1,3
collins,3,5.51E-06,3,6.83E-06,0,0,2
shelley,3,5.51E-06,3,6.83E-06,0,0,2
rollins,3,5.51E-06,3,6.83E-06,0,0,2
phyllis,3,5.51E-06,3,6.83E-06,0,0,2
farrell,3,5.51E-06,3,6.83E-06,0,0,2
windfall,3,5.51E-06,3,6.83E-06,0,0,2
drilling,3,5.51E-06,3,6.83E-06,0,0,2
changebut,3,5.51E-06,0,0,2.84E-05,3,3
observing,3,5.51E-06,2,4.56E-06,9.47E-06,1,3
empowered,3,5.51E-06,1,2.28E-06,1.89E-05,2,3
diplomacy,3,5.51E-06,2,4.56E-06,9.47E-06,1,4
requiring,3,5.51E-06,0,0,2.84E-05,3,3
precision,3,5.51E-06,2,4.56E-06,9.47E-06,1,3
consensus,3,5.51E-06,1,2.28E-06,1.89E-05,2,3
upholding,3,5.51E-06,2,4.56E-06,9.47E-06,1,3
expecting,3,5.51E-06,1,2.28E-06,1.89E-05,2,3
throwback,3,5.51E-06,1,2.28E-06,1.89E-05,2,2
alongside,3,5.51E-06,1,2.28E-06,1.89E-05,2,3
reminding,3,5.51E-06,1,2.28E-06,1.89E-05,2,3
diplomats,3,5.51E-06,2,4.56E-06,9.47E-06,1,3
rescinded,3,5.51E-06,2,4.56E-06,9.47E-06,1,2
governing,3,5.51E-06,2,4.56E-06,9.47E-06,1,3
addresses,3,5.51E-06,2,4.56E-06,9.47E-06,1,2
accounted,3,5.51E-06,2,4.56E-06,9.47E-06,1,2
childrens,3,5.51E-06,2,4.56E-06,9.47E-06,1,2
activated,3,5.51E-06,1,2.28E-06,1.89E-05,2,3
transfers,3,5.51E-06,2,4.56E-06,9.47E-06,1,2
davenport,3,5.51E-06,0,0,2.84E-05,3,3
proposals,3,5.51E-06,1,2.28E-06,1.89E-05,2,3
retaining,3,5.51E-06,1,2.28E-06,1.89E-05,2,3
threatens,3,5.51E-06,1,2.28E-06,1.89E-05,2,2
crippling,3,5.51E-06,2,4.56E-06,9.47E-06,1,2
melbourne,3,5.51E-06,2,4.56E-06,9.47E-06,1,2
repeating,3,5.51E-06,2,4.56E-06,9.47E-06,1,3
crackdown,3,5.51E-06,2,4.56E-06,9.47E-06,1,2
homeowner,3,5.51E-06,0,0,2.84E-05,3,3
contested,3,5.51E-06,2,4.56E-06,9.47E-06,1,2
quarterly,3,5.51E-06,2,4.56E-06,9.47E-06,1,3
hallowed,3,5.51E-06,3,6.83E-06,0,0,2
blueprint,3,5.51E-06,2,4.56E-06,9.47E-06,1,2
physician,3,5.51E-06,2,4.56E-06,9.47E-06,1,3
certified,3,5.51E-06,2,4.56E-06,9.47E-06,1,3
headlines,3,5.51E-06,2,4.56E-06,9.47E-06,1,2
deserving,3,5.51E-06,2,4.56E-06,9.47E-06,1,3
competent,3,5.51E-06,2,4.56E-06,9.47E-06,1,3
canceling,3,5.51E-06,2,4.56E-06,9.47E-06,1,3
rationing,3,5.51E-06,2,4.56E-06,9.47E-06,1,3
threshold,3,5.51E-06,3,6.83E-06,0,0,2
tampering,3,5.51E-06,3,6.83E-06,0,0,3
simington,3,5.51E-06,3,6.83E-06,0,0,3
clobbered,3,5.51E-06,3,6.83E-06,0,0,2
alliance,3,5.51E-06,3,6.83E-06,0,0,2
dominance,3,5.51E-06,3,6.83E-06,0,0,3
privately,3,5.51E-06,3,6.83E-06,0,0,4
developer,3,5.51E-06,3,6.83E-06,0,0,4
tabulated,3,5.51E-06,3,6.83E-06,0,0,3
energized,3,5.51E-06,3,6.83E-06,0,0,3
exception,3,5.51E-06,3,6.83E-06,0,0,3
blatantly,3,5.51E-06,3,6.83E-06,0,0,3
johnstown,3,5.51E-06,3,6.83E-06,0,0,2
corrupted,3,5.51E-06,3,6.83E-06,0,0,2
operating,3,5.51E-06,3,6.83E-06,0,0,4
encounter,3,5.51E-06,3,6.83E-06,0,0,3
followers,3,5.51E-06,2,4.56E-06,9.47E-06,1,3
allentown,3,5.51E-06,3,6.83E-06,0,0,3
prevalent,3,5.51E-06,3,6.83E-06,0,0,3
performed,3,5.51E-06,3,6.83E-06,0,0,2
allegedly,3,5.51E-06,3,6.83E-06,0,0,4
unsourced,3,5.51E-06,3,6.83E-06,0,0,2
forewoman,3,5.51E-06,3,6.83E-06,0,0,4
profusely,3,5.51E-06,3,6.83E-06,0,0,4
miserably,3,5.51E-06,3,6.83E-06,0,0,4
publisher,3,5.51E-06,3,6.83E-06,0,0,3
eternally,3,5.51E-06,3,6.83E-06,0,0,4
informing,3,5.51E-06,3,6.83E-06,0,0,3
resilient,3,5.51E-06,3,6.83E-06,0,0,3
traveling,3,5.51E-06,3,6.83E-06,0,0,3
statewide,3,5.51E-06,3,6.83E-06,0,0,3
footprint,3,5.51E-06,3,6.83E-06,0,0,2
pretended,3,5.51E-06,3,6.83E-06,0,0,2
intensive,3,5.51E-06,3,6.83E-06,0,0,3
producers,3,5.51E-06,3,6.83E-06,0,0,3
proactive,3,5.51E-06,3,6.83E-06,0,0,2
inflicted,3,5.51E-06,3,6.83E-06,0,0,2
markwayne,3,5.51E-06,3,6.83E-06,0,0,2
poisonous,3,5.51E-06,3,6.83E-06,0,0,3
executing,3,5.51E-06,3,6.83E-06,0,0,4
vandalism,3,5.51E-06,3,6.83E-06,0,0,3
relevance,3,5.51E-06,3,6.83E-06,0,0,3
prosecute,3,5.51E-06,3,6.83E-06,0,0,3
lecturing,3,5.51E-06,3,6.83E-06,0,0,3
enforcing,3,5.51E-06,3,6.83E-06,0,0,3
blackouts,3,5.51E-06,3,6.83E-06,0,0,2
stockpile,3,5.51E-06,3,6.83E-06,0,0,3
injustice,3,5.51E-06,3,6.83E-06,0,0,3
disclosed,3,5.51E-06,3,6.83E-06,0,0,2
disagreed,3,5.51E-06,3,6.83E-06,0,0,3
motivated,3,5.51E-06,3,6.83E-06,0,0,3
panicking,3,5.51E-06,3,6.83E-06,0,0,3
moderator,3,5.51E-06,3,6.83E-06,0,0,4
basically,3,5.51E-06,3,6.83E-06,0,0,4
indicator,3,5.51E-06,3,6.83E-06,0,0,4
separated,3,5.51E-06,3,6.83E-06,0,0,3
allocated,3,5.51E-06,3,6.83E-06,0,0,3
directing,3,5.51E-06,3,6.83E-06,0,0,3
remainder,3,5.51E-06,3,6.83E-06,0,0,3
sovereign,3,5.51E-06,3,6.83E-06,0,0,3
peninsula,3,5.51E-06,3,6.83E-06,0,0,4
southwest,3,5.51E-06,3,6.83E-06,0,0,2
extremism,3,5.51E-06,3,6.83E-06,0,0,3
vacations,3,5.51E-06,3,6.83E-06,0,0,3
appellate,3,5.51E-06,3,6.83E-06,0,0,3
dwindling,3,5.51E-06,3,6.83E-06,0,0,2
smugglers,3,5.51E-06,3,6.83E-06,0,0,2
girardeau,3,5.51E-06,3,6.83E-06,0,0,4
bolsonaro,3,5.51E-06,3,6.83E-06,0,0,4
disproven,3,5.51E-06,3,6.83E-06,0,0,3
forecasts,3,5.51E-06,3,6.83E-06,0,0,3
exercises,3,5.51E-06,3,6.83E-06,0,0,3
fraudster,3,5.51E-06,3,6.83E-06,0,0,2
arrington,3,5.51E-06,3,6.83E-06,0,0,3
justified,3,5.51E-06,3,6.83E-06,0,0,3
practiced,3,5.51E-06,3,6.83E-06,0,0,2
fulfilled,3,5.51E-06,3,6.83E-06,0,0,2
disturbed,3,5.51E-06,3,6.83E-06,0,0,2
sondlands,3,5.51E-06,3,6.83E-06,0,0,2
uncovered,3,5.51E-06,3,6.83E-06,0,0,3
enriching,3,5.51E-06,3,6.83E-06,0,0,3
hollywood,3,5.51E-06,3,6.83E-06,0,0,3
unfreedom,3,5.51E-06,3,6.83E-06,0,0,3
covington,3,5.51E-06,3,6.83E-06,0,0,3
typically,3,5.51E-06,3,6.83E-06,0,0,4
partially,3,5.51E-06,3,6.83E-06,0,0,3
brilliance,3,5.51E-06,3,6.83E-06,0,0,2
allegation,3,5.51E-06,3,6.83E-06,0,0,4
billionaire,3,5.51E-06,2,4.56E-06,9.47E-06,1,3
exit,3,5.51E-06,3,6.83E-06,0,0,2
financially,3,5.51E-06,3,6.83E-06,0,0,4
alito,3,5.51E-06,3,6.83E-06,0,0,3
controlling,3,5.51E-06,3,6.83E-06,0,0,3
coatesville,3,5.51E-06,3,6.83E-06,0,0,3
bestselling,3,5.51E-06,3,6.83E-06,0,0,3
purposefully,3,5.51E-06,2,4.56E-06,9.47E-06,1,5
specifically,3,5.51E-06,3,6.83E-06,0,0,5
uncontrollable,3,5.51E-06,3,6.83E-06,0,0,5
awaits,3,5.51E-06,2,4.56E-06,9.47E-06,1,2
pundit,3,5.51E-06,3,6.83E-06,0,0,2
environmentally,3,5.51E-06,3,6.83E-06,0,0,6
jovita,3,5.51E-06,3,6.83E-06,0,0,3
javits,3,5.51E-06,3,6.83E-06,0,0,2
vanity,3,5.51E-06,3,6.83E-06,0,0,3
switch,3,5.51E-06,3,6.83E-06,0,0,1
kitchen,3,5.51E-06,2,4.56E-06,9.47E-06,1,2
gravity,3,5.51E-06,2,4.56E-06,9.47E-06,1,3
recruit,3,5.51E-06,0,0,2.84E-05,3,2
edition,3,5.51E-06,1,2.28E-06,1.89E-05,2,3
digital,3,5.51E-06,2,4.56E-06,9.47E-06,1,3
charity,3,5.51E-06,3,6.83E-06,0,0,3
italian,3,5.51E-06,3,6.83E-06,0,0,3
whitmer,3,5.51E-06,3,6.83E-06,0,0,2
jupiter,3,5.51E-06,3,6.83E-06,0,0,3
british,3,5.51E-06,3,6.83E-06,0,0,2
granite,3,5.51E-06,3,6.83E-06,0,0,2
pitching,3,5.51E-06,1,2.28E-06,1.89E-05,2,2
criteria,3,5.51E-06,2,4.56E-06,9.47E-06,1,3
pruitt,3,5.51E-06,3,6.83E-06,0,0,1
quitting,3,5.51E-06,3,6.83E-06,0,0,2
belittling,3,5.51E-06,3,6.83E-06,0,0,3
ingenuity,3,5.51E-06,1,2.28E-06,1.89E-05,2,4
diversity,3,5.51E-06,2,4.56E-06,9.47E-06,1,4
limitless,3,5.51E-06,3,6.83E-06,0,0,3
charities,3,5.51E-06,3,6.83E-06,0,0,3
constitutionally,3,5.51E-06,3,6.83E-06,0,0,6
inevitable,3,5.51E-06,1,2.28E-06,1.89E-05,2,5
substitute,3,5.51E-06,2,4.56E-06,9.47E-06,1,3
arithmetic,3,5.51E-06,0,0,2.84E-05,3,4
capitalize,3,5.51E-06,3,6.83E-06,0,0,4
quantities,3,5.51E-06,3,6.83E-06,0,0,3
initiatives,3,5.51E-06,0,0,2.84E-05,3,4
obliteration,3,5.51E-06,3,6.83E-06,0,0,5
christianity,3,5.51E-06,3,6.83E-06,0,0,4
hospitalized,3,5.51E-06,3,6.83E-06,0,0,4
metropolitan,3,5.51E-06,3,6.83E-06,0,0,5
constituents,3,5.51E-06,3,6.83E-06,0,0,3
deductibility,3,5.51E-06,3,6.83E-06,0,0,6
hammer,3,5.51E-06,2,4.56E-06,9.47E-06,1,2
immoral,3,5.51E-06,3,6.83E-06,0,0,3
communists,3,5.51E-06,3,6.83E-06,0,0,3
commemorate,3,5.51E-06,2,4.56E-06,9.47E-06,1,4
immeasurable,3,5.51E-06,1,2.28E-06,1.89E-05,2,5
commemorating,3,5.51E-06,2,4.56E-06,9.47E-06,1,5
communication,3,5.51E-06,3,6.83E-06,0,0,5
generating,3,5.51E-06,0,0,2.84E-05,3,4
conscience,3,5.51E-06,1,2.28E-06,1.89E-05,2,2
objectives,3,5.51E-06,2,4.56E-06,9.47E-06,1,3
redemption,3,5.51E-06,2,4.56E-06,9.47E-06,1,3
nonviolent,3,5.51E-06,0,0,2.84E-05,3,3
charleston,3,5.51E-06,2,4.56E-06,9.47E-06,1,3
undeniable,3,5.51E-06,1,2.28E-06,1.89E-05,2,4
embodiment,3,5.51E-06,2,4.56E-06,9.47E-06,1,4
accessible,3,5.51E-06,0,0,2.84E-05,3,4
automakers,3,5.51E-06,1,2.28E-06,1.89E-05,2,4
greenhouse,3,5.51E-06,0,0,2.84E-05,3,2
oppression,3,5.51E-06,2,4.56E-06,9.47E-06,1,3
privileged,3,5.51E-06,0,0,2.84E-05,3,3
reflection,3,5.51E-06,0,0,2.84E-05,3,3
heartbreak,3,5.51E-06,1,2.28E-06,1.89E-05,2,2
deductions,3,5.51E-06,1,2.28E-06,1.89E-05,2,3
floridians,3,5.51E-06,1,2.28E-06,1.89E-05,2,3
chairwoman,3,5.51E-06,2,4.56E-06,9.47E-06,1,3
incentives,3,5.51E-06,2,4.56E-06,9.47E-06,1,3
classrooms,3,5.51E-06,1,2.28E-06,1.89E-05,2,2
internship,3,5.51E-06,0,0,2.84E-05,3,3
photograph,3,5.51E-06,2,4.56E-06,9.47E-06,1,3
deductible,3,5.51E-06,2,4.56E-06,9.47E-06,1,4
characters,3,5.51E-06,2,4.56E-06,9.47E-06,1,3
appointing,3,5.51E-06,2,4.56E-06,9.47E-06,1,3
legislator,3,5.51E-06,0,0,2.84E-05,3,4
earthquake,3,5.51E-06,2,4.56E-06,9.47E-06,1,2
responding,3,5.51E-06,2,4.56E-06,9.47E-06,1,3
relentless,3,5.51E-06,2,4.56E-06,9.47E-06,1,3
artificial,3,5.51E-06,3,6.83E-06,0,0,4
widespread,3,5.51E-06,3,6.83E-06,0,0,3
threatened,3,5.51E-06,3,6.83E-06,0,0,2
eviscerate,3,5.51E-06,3,6.83E-06,0,0,4
restaurant,3,5.51E-06,3,6.83E-06,0,0,3
autonomous,3,5.51E-06,3,6.83E-06,0,0,4
esther,3,5.51E-06,3,6.83E-06,0,0,2
suppressed,3,5.51E-06,3,6.83E-06,0,0,2
abolishing,3,5.51E-06,3,6.83E-06,0,0,4
floodgates,3,5.51E-06,3,6.83E-06,0,0,2
eliminated,3,5.51E-06,3,6.83E-06,0,0,4
difficulty,3,5.51E-06,3,6.83E-06,0,0,4
preserving,3,5.51E-06,3,6.83E-06,0,0,3
sufficient,3,5.51E-06,3,6.83E-06,0,0,3
categories,3,5.51E-06,3,6.83E-06,0,0,4
distribute,3,5.51E-06,3,6.83E-06,0,0,3
australias,3,5.51E-06,3,6.83E-06,0,0,3
exceptions,3,5.51E-06,3,6.83E-06,0,0,3
confiscate,3,5.51E-06,3,6.83E-06,0,0,3
reelection,3,5.51E-06,3,6.83E-06,0,0,3
profoundly,3,5.51E-06,3,6.83E-06,0,0,3
properties,3,5.51E-06,3,6.83E-06,0,0,3
astounding,3,5.51E-06,3,6.83E-06,0,0,3
sulzberger,3,5.51E-06,3,6.83E-06,0,0,3
casualties,3,5.51E-06,3,6.83E-06,0,0,3
ventilator,3,5.51E-06,3,6.83E-06,0,0,4
triumphant,3,5.51E-06,3,6.83E-06,0,0,2
subversive,3,5.51E-06,3,6.83E-06,0,0,3
protective,3,5.51E-06,3,6.83E-06,0,0,3
zuckerberg,3,5.51E-06,3,6.83E-06,0,0,3
predicting,3,5.51E-06,3,6.83E-06,0,0,3
oppressive,3,5.51E-06,3,6.83E-06,0,0,3
perpetuate,3,5.51E-06,3,6.83E-06,0,0,3
afternoons,3,5.51E-06,3,6.83E-06,0,0,3
indication,3,5.51E-06,3,6.83E-06,0,0,4
richardson,3,5.51E-06,3,6.83E-06,0,0,3
negatively,3,5.51E-06,3,6.83E-06,0,0,5
hemisphere,3,5.51E-06,3,6.83E-06,0,0,3
indirectly,3,5.51E-06,3,6.83E-06,0,0,4
unpleasant,3,5.51E-06,3,6.83E-06,0,0,3
liberalism,3,5.51E-06,3,6.83E-06,0,0,4
compliment,3,5.51E-06,3,6.83E-06,0,0,3
pertaining,3,5.51E-06,3,6.83E-06,0,0,3
indicating,3,5.51E-06,3,6.83E-06,0,0,4
squandered,3,5.51E-06,3,6.83E-06,0,0,2
fundraiser,3,5.51E-06,3,6.83E-06,0,0,3
newspapers,3,5.51E-06,3,6.83E-06,0,0,3
encourages,3,5.51E-06,3,6.83E-06,0,0,3
cutsreform,3,5.51E-06,3,6.83E-06,0,0,3
proportion,3,5.51E-06,3,6.83E-06,0,0,3
alexandria,3,5.51E-06,3,6.83E-06,0,0,4
impeccable,3,5.51E-06,3,6.83E-06,0,0,4
regulatory,3,5.51E-06,3,6.83E-06,0,0,5
infighting,3,5.51E-06,3,6.83E-06,0,0,3
renovating,3,5.51E-06,3,6.83E-06,0,0,4
separation,3,5.51E-06,3,6.83E-06,0,0,4
subsidizes,3,5.51E-06,3,6.83E-06,0,0,3
requesting,3,5.51E-06,3,6.83E-06,0,0,3
turnaround,3,5.51E-06,3,6.83E-06,0,0,3
identified,3,5.51E-06,3,6.83E-06,0,0,4
censorship,3,5.51E-06,3,6.83E-06,0,0,3
engagement,3,5.51E-06,3,6.83E-06,0,0,4
indictment,3,5.51E-06,3,6.83E-06,0,0,3
confronted,3,5.51E-06,3,6.83E-06,0,0,2
structural,3,5.51E-06,3,6.83E-06,0,0,3
proceeding,3,5.51E-06,3,6.83E-06,0,0,3
louisianas,3,5.51E-06,3,6.83E-06,0,0,4
comcastnbc,3,5.51E-06,3,6.83E-06,0,0,2
refineries,3,5.51E-06,3,6.83E-06,0,0,4
purporting,3,5.51E-06,3,6.83E-06,0,0,3
reimbursed,3,5.51E-06,3,6.83E-06,0,0,2
farther,3,5.51E-06,0,0,2.84E-05,3,2
theaters,3,5.51E-06,1,2.28E-06,1.89E-05,2,2
matthew,3,5.51E-06,3,6.83E-06,0,0,2
northeast,3,5.51E-06,3,6.83E-06,0,0,2
gatherings,3,5.51E-06,3,6.83E-06,0,0,3
grandmother,3,5.51E-06,3,6.83E-06,0,0,3
consequence,3,5.51E-06,1,2.28E-06,1.89E-05,2,3
preventable,3,5.51E-06,2,4.56E-06,9.47E-06,1,4
exceptional,3,5.51E-06,2,4.56E-06,9.47E-06,1,4
approaching,3,5.51E-06,2,4.56E-06,9.47E-06,1,3
orientation,3,5.51E-06,1,2.28E-06,1.89E-05,2,4
unspeakable,3,5.51E-06,2,4.56E-06,9.47E-06,1,4
uncertainty,3,5.51E-06,1,2.28E-06,1.89E-05,2,4
momentarily,3,5.51E-06,2,4.56E-06,9.47E-06,1,5
reauthorize,3,5.51E-06,2,4.56E-06,9.47E-06,1,4
predecessor,3,5.51E-06,2,4.56E-06,9.47E-06,1,4
explanation,3,5.51E-06,1,2.28E-06,1.89E-05,2,4
interactive,3,5.51E-06,0,0,2.84E-05,3,4
sustainable,3,5.51E-06,2,4.56E-06,9.47E-06,1,4
preexisting,3,5.51E-06,2,4.56E-06,9.47E-06,1,3
frustration,3,5.51E-06,2,4.56E-06,9.47E-06,1,3
unwatchable,3,5.51E-06,3,6.83E-06,0,0,4
unelectable,3,5.51E-06,3,6.83E-06,0,0,5
irrefutable,3,5.51E-06,3,6.83E-06,0,0,5
graduations,3,5.51E-06,3,6.83E-06,0,0,3
landscaping,3,5.51E-06,3,6.83E-06,0,0,3
operational,3,5.51E-06,3,6.83E-06,0,0,5
foolishness,3,5.51E-06,3,6.83E-06,0,0,3
restriction,3,5.51E-06,3,6.83E-06,0,0,3
exceedingly,3,5.51E-06,3,6.83E-06,0,0,4
experiences,3,5.51E-06,3,6.83E-06,0,0,3
retaliation,3,5.51E-06,3,6.83E-06,0,0,4
unambiguous,3,5.51E-06,3,6.83E-06,0,0,5
affirmative,3,5.51E-06,3,6.83E-06,0,0,4
blagojevich,3,5.51E-06,3,6.83E-06,0,0,4
implemented,3,5.51E-06,3,6.83E-06,0,0,3
humiliating,3,5.51E-06,3,6.83E-06,0,0,4
effectively,3,5.51E-06,3,6.83E-06,0,0,5
reinstating,3,5.51E-06,3,6.83E-06,0,0,3
unbreakable,3,5.51E-06,3,6.83E-06,0,0,4
senselessly,3,5.51E-06,3,6.83E-06,0,0,4
combination,3,5.51E-06,3,6.83E-06,0,0,4
forgiveness,3,5.51E-06,3,6.83E-06,0,0,4
lewandowski,3,5.51E-06,3,6.83E-06,0,0,4
shoplifting,3,5.51E-06,3,6.83E-06,0,0,3
negotiators,3,5.51E-06,3,6.83E-06,0,0,4
unfortunate,3,5.51E-06,3,6.83E-06,0,0,4
forthcoming,3,5.51E-06,3,6.83E-06,0,0,3
convictions,3,5.51E-06,3,6.83E-06,0,0,3
retribution,3,5.51E-06,3,6.83E-06,0,0,4
restrictive,3,5.51E-06,3,6.83E-06,0,0,3
cooperative,3,5.51E-06,3,6.83E-06,0,0,4
speakership,3,5.51E-06,3,6.83E-06,0,0,3
manipulated,3,5.51E-06,3,6.83E-06,0,0,4
transcribed,3,5.51E-06,3,6.83E-06,0,0,2
controversy,3,5.51E-06,3,6.83E-06,0,0,4
appalachian,3,5.51E-06,3,6.83E-06,0,0,4
contributed,3,5.51E-06,3,6.83E-06,0,0,3
culminating,3,5.51E-06,3,6.83E-06,0,0,4
participants,3,5.51E-06,2,4.56E-06,9.47E-06,1,4
disagreement,3,5.51E-06,1,2.28E-06,1.89E-05,2,4
warscombined,3,5.51E-06,0,0,2.84E-05,3,3
instructions,3,5.51E-06,2,4.56E-06,9.47E-06,1,3
manufacturer,3,5.51E-06,0,0,2.84E-05,3,5
difficulties,3,5.51E-06,2,4.56E-06,9.47E-06,1,4
partnerships,3,5.51E-06,2,4.56E-06,9.47E-06,1,3
technologies,3,5.51E-06,2,4.56E-06,9.47E-06,1,4
intervention,3,5.51E-06,3,6.83E-06,0,0,4
philadelpiha,3,5.51E-06,3,6.83E-06,0,0,5
implementing,3,5.51E-06,3,6.83E-06,0,0,4
unsuccessful,3,5.51E-06,3,6.83E-06,0,0,4
hemorrhaging,3,5.51E-06,3,6.83E-06,0,0,4
administered,3,5.51E-06,3,6.83E-06,0,0,4
conservation,3,5.51E-06,3,6.83E-06,0,0,4
constructive,3,5.51E-06,3,6.83E-06,0,0,3
experiencing,3,5.51E-06,3,6.83E-06,0,0,4
grandstander,3,5.51E-06,3,6.83E-06,0,0,3
considerable,3,5.51E-06,3,6.83E-06,0,0,5
teleprompter,3,5.51E-06,3,6.83E-06,0,0,4
endorsements,3,5.51E-06,3,6.83E-06,0,0,4
contemplated,3,5.51E-06,3,6.83E-06,0,0,3
palestinians,3,5.51E-06,3,6.83E-06,0,0,4
acknowledged,3,5.51E-06,3,6.83E-06,0,0,3
recognizable,3,5.51E-06,3,6.83E-06,0,0,5
deregulation,3,5.51E-06,3,6.83E-06,0,0,5
governmental,3,5.51E-06,3,6.83E-06,0,0,4
renegotiated,3,5.51E-06,3,6.83E-06,0,0,4
presidencies,3,5.51E-06,3,6.83E-06,0,0,4
incarceration,3,5.51E-06,2,4.56E-06,9.47E-06,1,5
certification,3,5.51E-06,3,6.83E-06,0,0,5
discrepancies,3,5.51E-06,3,6.83E-06,0,0,4
represenative,3,5.51E-06,3,6.83E-06,0,0,5
disrespectful,3,5.51E-06,3,6.83E-06,0,0,4
entertainment,3,5.51E-06,3,6.83E-06,0,0,4
investigative,3,5.51E-06,3,6.83E-06,0,0,5
reimbursement,3,5.51E-06,3,6.83E-06,0,0,4
renegotiation,3,5.51E-06,3,6.83E-06,0,0,5
protectionist,3,5.51E-06,3,6.83E-06,0,0,4
inconceivable,3,5.51E-06,3,6.83E-06,0,0,5
enlightenment,3,5.51E-06,3,6.83E-06,0,0,4
discriminating,3,5.51E-06,1,2.28E-06,1.89E-05,2,5
discriminatory,3,5.51E-06,2,4.56E-06,9.47E-06,1,6
indoctrination,3,5.51E-06,3,6.83E-06,0,0,5
reconciliation,3,5.51E-06,3,6.83E-06,0,0,5
entrepreneurship,3,5.51E-06,1,2.28E-06,1.89E-05,2,5
counterterrorism,3,5.51E-06,3,6.83E-06,0,0,5
declassification,3,5.51E-06,3,6.83E-06,0,0,6
tag,2,3.67E-06,0,0,1.89E-05,2,1
arc,2,3.67E-06,0,0,1.89E-05,2,1
ear,2,3.67E-06,0,0,1.89E-05,2,1
til,2,3.67E-06,0,0,1.89E-05,2,1
fec,2,3.67E-06,0,0,1.89E-05,2,1
gif,2,3.67E-06,0,0,1.89E-05,2,1
app,2,3.67E-06,1,2.28E-06,9.47E-06,1,1
mug,2,3.67E-06,0,0,1.89E-05,2,1
fee,2,3.67E-06,1,2.28E-06,9.47E-06,1,1
mil,2,3.67E-06,0,0,1.89E-05,2,1
unc,2,3.67E-06,0,0,1.89E-05,2,1
bos,2,3.67E-06,0,0,1.89E-05,2,1
pet,2,3.67E-06,1,2.28E-06,9.47E-06,1,1
aug,2,3.67E-06,1,2.28E-06,9.47E-06,1,1
fdr,2,3.67E-06,1,2.28E-06,9.47E-06,1,1
pls,2,3.67E-06,0,0,1.89E-05,2,1
usb,2,3.67E-06,2,4.56E-06,0,0,1
lid,2,3.67E-06,2,4.56E-06,0,0,1
una,2,3.67E-06,2,4.56E-06,0,0,1
des,2,3.67E-06,2,4.56E-06,0,0,1
wan,2,3.67E-06,2,4.56E-06,0,0,1
odd,2,3.67E-06,2,4.56E-06,0,0,1
col,2,3.67E-06,2,4.56E-06,0,0,1
pam,2,3.67E-06,2,4.56E-06,0,0,1
mud,2,3.67E-06,2,4.56E-06,0,0,1
blm,2,3.67E-06,2,4.56E-06,0,0,1
fry,2,3.67E-06,2,4.56E-06,0,0,1
eli,2,3.67E-06,2,4.56E-06,0,0,1
tds,2,3.67E-06,2,4.56E-06,0,0,1
hal,2,3.67E-06,2,4.56E-06,0,0,1
ink,2,3.67E-06,2,4.56E-06,0,0,1
ate,2,3.67E-06,2,4.56E-06,0,0,1
sex,2,3.67E-06,2,4.56E-06,0,0,1
tha,2,3.67E-06,2,4.56E-06,0,0,1
org,2,3.67E-06,2,4.56E-06,0,0,1
yoo,2,3.67E-06,2,4.56E-06,0,0,1
pre,2,3.67E-06,2,4.56E-06,0,0,1
amb,2,3.67E-06,2,4.56E-06,0,0,1
rok,2,3.67E-06,2,4.56E-06,0,0,1
mph,2,3.67E-06,2,4.56E-06,0,0,1
qtr,2,3.67E-06,2,4.56E-06,0,0,1
rdy,2,3.67E-06,2,4.56E-06,0,0,1
wwi,2,3.67E-06,2,4.56E-06,0,0,1
jeh,2,3.67E-06,2,4.56E-06,0,0,1
leo,2,3.67E-06,2,4.56E-06,0,0,1
dna,2,3.67E-06,2,4.56E-06,0,0,1
pan,2,3.67E-06,2,4.56E-06,0,0,1
gag,2,3.67E-06,2,4.56E-06,0,0,1
dov,2,3.67E-06,2,4.56E-06,0,0,1
liu,2,3.67E-06,2,4.56E-06,0,0,1
deb,2,3.67E-06,2,4.56E-06,0,0,1
egg,2,3.67E-06,2,4.56E-06,0,0,1
snl,2,3.67E-06,2,4.56E-06,0,0,1
kag,2,3.67E-06,2,4.56E-06,0,0,1
abu,2,3.67E-06,2,4.56E-06,0,0,1
mix,2,3.67E-06,2,4.56E-06,0,0,1
ass,2,3.67E-06,2,4.56E-06,0,0,1
dmz,2,3.67E-06,2,4.56E-06,0,0,1
cdt,2,3.67E-06,2,4.56E-06,0,0,1
tops,2,3.67E-06,1,2.28E-06,9.47E-06,1,1
curb,2,3.67E-06,1,2.28E-06,9.47E-06,1,1
nail,2,3.67E-06,1,2.28E-06,9.47E-06,1,1
isil,2,3.67E-06,0,0,1.89E-05,2,2
rein,2,3.67E-06,0,0,1.89E-05,2,1
ofas,2,3.67E-06,0,0,1.89E-05,2,2
luis,2,3.67E-06,0,0,1.89E-05,2,1
bent,2,3.67E-06,1,2.28E-06,9.47E-06,1,1
worn,2,3.67E-06,1,2.28E-06,9.47E-06,1,1
lens,2,3.67E-06,0,0,1.89E-05,2,1
duke,2,3.67E-06,1,2.28E-06,9.47E-06,1,1
prop,2,3.67E-06,1,2.28E-06,9.47E-06,1,1
wifi,2,3.67E-06,1,2.28E-06,9.47E-06,1,2
bury,2,3.67E-06,0,0,1.89E-05,2,2
akin,2,3.67E-06,1,2.28E-06,9.47E-06,1,2
leno,2,3.67E-06,1,2.28E-06,9.47E-06,1,2
refs,2,3.67E-06,0,0,1.89E-05,2,1
void,2,3.67E-06,1,2.28E-06,9.47E-06,1,1
keys,2,3.67E-06,1,2.28E-06,9.47E-06,1,1
nose,2,3.67E-06,1,2.28E-06,9.47E-06,1,1
whod,2,3.67E-06,0,0,1.89E-05,2,1
fare,2,3.67E-06,1,2.28E-06,9.47E-06,1,1
quiz,2,3.67E-06,0,0,1.89E-05,2,1
bike,2,3.67E-06,0,0,1.89E-05,2,1
tilt,2,3.67E-06,0,0,1.89E-05,2,1
milk,2,3.67E-06,1,2.28E-06,9.47E-06,1,1
load,2,3.67E-06,0,0,1.89E-05,2,1
sort,2,3.67E-06,1,2.28E-06,9.47E-06,1,1
cede,2,3.67E-06,1,2.28E-06,9.47E-06,1,1
gops,2,3.67E-06,0,0,1.89E-05,2,1
mugs,2,3.67E-06,0,0,1.89E-05,2,1
toss,2,3.67E-06,0,0,1.89E-05,2,1
amid,2,3.67E-06,1,2.28E-06,9.47E-06,1,2
sway,2,3.67E-06,1,2.28E-06,9.47E-06,1,1
awed,2,3.67E-06,1,2.28E-06,9.47E-06,1,1
blog,2,3.67E-06,0,0,1.89E-05,2,1
noon,2,3.67E-06,1,2.28E-06,9.47E-06,1,1
issa,2,3.67E-06,2,4.56E-06,0,0,2
aide,2,3.67E-06,2,4.56E-06,0,0,1
stab,2,3.67E-06,2,4.56E-06,0,0,1
wipe,2,3.67E-06,2,4.56E-06,0,0,1
walz,2,3.67E-06,2,4.56E-06,0,0,1
gaga,2,3.67E-06,2,4.56E-06,0,0,2
roam,2,3.67E-06,2,4.56E-06,0,0,1
para,2,3.67E-06,2,4.56E-06,0,0,2
sore,2,3.67E-06,2,4.56E-06,0,0,1
stan,2,3.67E-06,2,4.56E-06,0,0,1
ramp,2,3.67E-06,2,4.56E-06,0,0,1
intl,2,3.67E-06,2,4.56E-06,0,0,1
lone,2,3.67E-06,2,4.56E-06,0,0,1
fish,2,3.67E-06,2,4.56E-06,0,0,1
cubs,2,3.67E-06,2,4.56E-06,0,0,1
idly,2,3.67E-06,2,4.56E-06,0,0,2
dive,2,3.67E-06,2,4.56E-06,0,0,1
grad,2,3.67E-06,2,4.56E-06,0,0,1
bats,2,3.67E-06,2,4.56E-06,0,0,1
stir,2,3.67E-06,2,4.56E-06,0,0,1
chop,2,3.67E-06,2,4.56E-06,0,0,1
tale,2,3.67E-06,2,4.56E-06,0,0,2
tent,2,3.67E-06,2,4.56E-06,0,0,1
dawn,2,3.67E-06,2,4.56E-06,0,0,1
riot,2,3.67E-06,2,4.56E-06,0,0,1
cole,2,3.67E-06,2,4.56E-06,0,0,2
labs,2,3.67E-06,2,4.56E-06,0,0,1
mack,2,3.67E-06,2,4.56E-06,0,0,1
fold,2,3.67E-06,2,4.56E-06,0,0,1
zoom,2,3.67E-06,2,4.56E-06,0,0,1
sins,2,3.67E-06,2,4.56E-06,0,0,1
lous,2,3.67E-06,2,4.56E-06,0,0,1
huma,2,3.67E-06,2,4.56E-06,0,0,2
mere,2,3.67E-06,2,4.56E-06,0,0,1
kobe,2,3.67E-06,2,4.56E-06,0,0,1
russ,2,3.67E-06,2,4.56E-06,0,0,1
pact,2,3.67E-06,2,4.56E-06,0,0,1
birx,2,3.67E-06,2,4.56E-06,0,0,1
diet,2,3.67E-06,2,4.56E-06,0,0,1
coke,2,3.67E-06,2,4.56E-06,0,0,1
ryun,2,3.67E-06,2,4.56E-06,0,0,1
silk,2,3.67E-06,2,4.56E-06,0,0,1
pile,2,3.67E-06,2,4.56E-06,0,0,2
tire,2,3.67E-06,2,4.56E-06,0,0,1
ring,2,3.67E-06,2,4.56E-06,0,0,1
pled,2,3.67E-06,2,4.56E-06,0,0,#ERROR!
cfpb,2,3.67E-06,2,4.56E-06,0,0,#ERROR!
ucla,2,3.67E-06,2,4.56E-06,0,0,2
azar,2,3.67E-06,2,4.56E-06,0,0,2
mtgs,2,3.67E-06,2,4.56E-06,0,0,#ERROR!
espn,2,3.67E-06,2,4.56E-06,0,0,1
heel,2,3.67E-06,2,4.56E-06,0,0,1
ward,2,3.67E-06,2,4.56E-06,0,0,1
wone,2,3.67E-06,2,4.56E-06,0,0,1
dies,2,3.67E-06,2,4.56E-06,0,0,1
cusp,2,3.67E-06,2,4.56E-06,0,0,1
sisi,2,3.67E-06,2,4.56E-06,0,0,2
kurt,2,3.67E-06,2,4.56E-06,0,0,1
vows,2,3.67E-06,2,4.56E-06,0,0,1
tata,2,3.67E-06,2,4.56E-06,0,0,2
jims,2,3.67E-06,2,4.56E-06,0,0,1
woke,2,3.67E-06,2,4.56E-06,0,0,1
plea,2,3.67E-06,2,4.56E-06,0,0,1
diya,2,3.67E-06,2,4.56E-06,0,0,2
cape,2,3.67E-06,2,4.56E-06,0,0,1
erik,2,3.67E-06,2,4.56E-06,0,0,2
neal,2,3.67E-06,2,4.56E-06,0,0,1
kiss,2,3.67E-06,2,4.56E-06,0,0,1
duda,2,3.67E-06,2,4.56E-06,0,0,2
nike,2,3.67E-06,2,4.56E-06,0,0,1
snap,2,3.67E-06,2,4.56E-06,0,0,1
suck,2,3.67E-06,2,4.56E-06,0,0,1
bond,2,3.67E-06,2,4.56E-06,0,0,1
mudd,2,3.67E-06,2,4.56E-06,0,0,1
roby,2,3.67E-06,2,4.56E-06,0,0,2
clay,2,3.67E-06,2,4.56E-06,0,0,1
trey,2,3.67E-06,2,4.56E-06,0,0,1
niro,2,3.67E-06,2,4.56E-06,0,0,2
iger,2,3.67E-06,2,4.56E-06,0,0,2
awol,2,3.67E-06,2,4.56E-06,0,0,2
seth,2,3.67E-06,2,4.56E-06,0,0,1
alec,2,3.67E-06,2,4.56E-06,0,0,2
ploy,2,3.67E-06,2,4.56E-06,0,0,1
rips,2,3.67E-06,2,4.56E-06,0,0,1
bakr,2,3.67E-06,2,4.56E-06,0,0,1
oecd,2,3.67E-06,2,4.56E-06,0,0,1
gate,2,3.67E-06,2,4.56E-06,0,0,1
moat,2,3.67E-06,2,4.56E-06,0,0,1
tore,2,3.67E-06,2,4.56E-06,0,0,1
mcas,2,3.67E-06,2,4.56E-06,0,0,1
dose,2,3.67E-06,2,4.56E-06,0,0,1
gene,2,3.67E-06,2,4.56E-06,0,0,1
duck,2,3.67E-06,2,4.56E-06,0,0,1
fing,2,3.67E-06,2,4.56E-06,0,0,1
thad,2,3.67E-06,2,4.56E-06,0,0,1
peck,2,3.67E-06,2,4.56E-06,0,0,1
garb,2,3.67E-06,2,4.56E-06,0,0,1
crude,2,3.67E-06,1,2.28E-06,9.47E-06,1,1
dozen,2,3.67E-06,1,2.28E-06,9.47E-06,1,2
candy,2,3.67E-06,1,2.28E-06,9.47E-06,1,2
tooth,2,3.67E-06,1,2.28E-06,9.47E-06,1,1
tovah,2,3.67E-06,0,0,1.89E-05,2,2
stack,2,3.67E-06,0,0,1.89E-05,2,1
jails,2,3.67E-06,1,2.28E-06,9.47E-06,1,1
spark,2,3.67E-06,0,0,1.89E-05,2,1
beats,2,3.67E-06,0,0,1.89E-05,2,1
stamp,2,3.67E-06,1,2.28E-06,9.47E-06,1,1
rhode,2,3.67E-06,1,2.28E-06,9.47E-06,1,1
posed,2,3.67E-06,1,2.28E-06,9.47E-06,1,1
shout,2,3.67E-06,1,2.28E-06,9.47E-06,1,1
robin,2,3.67E-06,0,0,1.89E-05,2,2
messy,2,3.67E-06,1,2.28E-06,9.47E-06,1,2
bread,2,3.67E-06,0,0,1.89E-05,2,1
urban,2,3.67E-06,1,2.28E-06,9.47E-06,1,2
debut,2,3.67E-06,0,0,1.89E-05,2,2
brush,2,3.67E-06,0,0,1.89E-05,2,1
draft,2,3.67E-06,1,2.28E-06,9.47E-06,1,1
fifty,2,3.67E-06,1,2.28E-06,9.47E-06,1,2
aloha,2,3.67E-06,0,0,1.89E-05,2,3
sings,2,3.67E-06,0,0,1.89E-05,2,1
wives,2,3.67E-06,0,0,1.89E-05,2,1
spurs,2,3.67E-06,1,2.28E-06,9.47E-06,1,1
binds,2,3.67E-06,0,0,1.89E-05,2,1
wound,2,3.67E-06,1,2.28E-06,9.47E-06,1,1
ashes,2,3.67E-06,1,2.28E-06,9.47E-06,1,1
crack,2,3.67E-06,0,0,1.89E-05,2,1
faint,2,3.67E-06,1,2.28E-06,9.47E-06,1,1
dress,2,3.67E-06,1,2.28E-06,9.47E-06,1,1
verge,2,3.67E-06,0,0,1.89E-05,2,1
mercy,2,3.67E-06,0,0,1.89E-05,2,2
towel,2,3.67E-06,0,0,1.89E-05,2,2
reins,2,3.67E-06,0,0,1.89E-05,2,1
handy,2,3.67E-06,0,0,1.89E-05,2,2
rerun,2,3.67E-06,0,0,1.89E-05,2,2
copay,2,3.67E-06,0,0,1.89E-05,2,2
tying,2,3.67E-06,1,2.28E-06,9.47E-06,1,1
paths,2,3.67E-06,0,0,1.89E-05,2,1
elena,2,3.67E-06,0,0,1.89E-05,2,3
crush,2,3.67E-06,1,2.28E-06,9.47E-06,1,1
cream,2,3.67E-06,0,0,1.89E-05,2,1
cedar,2,3.67E-06,1,2.28E-06,9.47E-06,1,2
fiber,2,3.67E-06,1,2.28E-06,9.47E-06,1,2
junes,2,3.67E-06,1,2.28E-06,9.47E-06,1,1
erica,2,3.67E-06,1,2.28E-06,9.47E-06,1,3
ampad,2,3.67E-06,0,0,1.89E-05,2,2
walks,2,3.67E-06,1,2.28E-06,9.47E-06,1,1
dates,2,3.67E-06,1,2.28E-06,9.47E-06,1,1
stare,2,3.67E-06,1,2.28E-06,9.47E-06,1,1
toxic,2,3.67E-06,1,2.28E-06,9.47E-06,1,2
chili,2,3.67E-06,0,0,1.89E-05,2,2
faced,2,3.67E-06,1,2.28E-06,9.47E-06,1,1
fries,2,3.67E-06,0,0,1.89E-05,2,1
drama,2,3.67E-06,1,2.28E-06,9.47E-06,1,2
taste,2,3.67E-06,1,2.28E-06,9.47E-06,1,1
kroft,2,3.67E-06,0,0,1.89E-05,2,1
ramps,2,3.67E-06,1,2.28E-06,9.47E-06,1,1
kathy,2,3.67E-06,1,2.28E-06,9.47E-06,1,2
chile,2,3.67E-06,1,2.28E-06,9.47E-06,1,2
ideal,2,3.67E-06,1,2.28E-06,9.47E-06,1,2
crews,2,3.67E-06,1,2.28E-06,9.47E-06,1,1
iraqs,2,3.67E-06,0,0,1.89E-05,2,2
fears,2,3.67E-06,1,2.28E-06,9.47E-06,1,1
waves,2,3.67E-06,1,2.28E-06,9.47E-06,1,1
smoke,2,3.67E-06,1,2.28E-06,9.47E-06,1,1
busts,2,3.67E-06,1,2.28E-06,9.47E-06,1,1
input,2,3.67E-06,1,2.28E-06,9.47E-06,1,2
laced,2,3.67E-06,2,4.56E-06,0,0,1
baier,2,3.67E-06,2,4.56E-06,0,0,2
usage,2,3.67E-06,2,4.56E-06,0,0,2
stays,2,3.67E-06,2,4.56E-06,0,0,1
darin,2,3.67E-06,2,4.56E-06,0,0,2
goose,2,3.67E-06,2,4.56E-06,0,0,1
omaha,2,3.67E-06,2,4.56E-06,0,0,3
mooch,2,3.67E-06,2,4.56E-06,0,0,1
camps,2,3.67E-06,2,4.56E-06,0,0,1
razor,2,3.67E-06,2,4.56E-06,0,0,2
panic,2,3.67E-06,2,4.56E-06,0,0,2
tamed,2,3.67E-06,2,4.56E-06,0,0,1
bluff,2,3.67E-06,2,4.56E-06,0,0,1
flash,2,3.67E-06,2,4.56E-06,0,0,1
blake,2,3.67E-06,2,4.56E-06,0,0,1
slams,2,3.67E-06,2,4.56E-06,0,0,1
downs,2,3.67E-06,2,4.56E-06,0,0,1
aspen,2,3.67E-06,2,4.56E-06,0,0,2
burrs,2,3.67E-06,2,4.56E-06,0,0,1
alert,2,3.67E-06,2,4.56E-06,0,0,2
askin,2,3.67E-06,2,4.56E-06,0,0,2
walsh,2,3.67E-06,2,4.56E-06,0,0,1
bragg,2,3.67E-06,2,4.56E-06,0,0,1
buses,2,3.67E-06,2,4.56E-06,0,0,1
cheap,2,3.67E-06,2,4.56E-06,0,0,1
trash,2,3.67E-06,2,4.56E-06,0,0,1
keane,2,3.67E-06,2,4.56E-06,0,0,1
weber,2,3.67E-06,2,4.56E-06,0,0,2
mikes,2,3.67E-06,2,4.56E-06,0,0,1
cargo,2,3.67E-06,2,4.56E-06,0,0,2
bondi,2,3.67E-06,2,4.56E-06,0,0,2
farms,2,3.67E-06,2,4.56E-06,0,0,1
pulse,2,3.67E-06,2,4.56E-06,0,0,1
sheer,2,3.67E-06,2,4.56E-06,0,0,1
dover,2,3.67E-06,2,4.56E-06,0,0,2
lacks,2,3.67E-06,2,4.56E-06,0,0,1
hoped,2,3.67E-06,2,4.56E-06,0,0,1
sword,2,3.67E-06,2,4.56E-06,0,0,1
gayle,2,3.67E-06,2,4.56E-06,0,0,2
puppy,2,3.67E-06,2,4.56E-06,0,0,2
tubes,2,3.67E-06,2,4.56E-06,0,0,1
widen,2,3.67E-06,2,4.56E-06,0,0,2
jodey,2,3.67E-06,2,4.56E-06,0,0,2
louie,2,3.67E-06,2,4.56E-06,0,0,2
niece,2,3.67E-06,2,4.56E-06,0,0,1
bynum,2,3.67E-06,2,4.56E-06,0,0,2
hagan,2,3.67E-06,2,4.56E-06,0,0,2
huber,2,3.67E-06,2,4.56E-06,0,0,2
beret,2,3.67E-06,2,4.56E-06,0,0,2
scams,2,3.67E-06,2,4.56E-06,0,0,1
bader,2,3.67E-06,2,4.56E-06,0,0,2
tesla,2,3.67E-06,2,4.56E-06,0,0,2
carly,2,3.67E-06,2,4.56E-06,0,0,2
chera,2,3.67E-06,2,4.56E-06,0,0,2
asman,2,3.67E-06,2,4.56E-06,0,0,2
jesus,2,3.67E-06,2,4.56E-06,0,0,2
toast,2,3.67E-06,2,4.56E-06,0,0,1
execs,2,3.67E-06,2,4.56E-06,0,0,2
tires,2,3.67E-06,2,4.56E-06,0,0,1
dusty,2,3.67E-06,2,4.56E-06,0,0,2
chess,2,3.67E-06,2,4.56E-06,0,0,1
diana,2,3.67E-06,2,4.56E-06,0,0,2
grabs,2,3.67E-06,2,4.56E-06,0,0,1
faker,2,3.67E-06,2,4.56E-06,0,0,2
reign,2,3.67E-06,2,4.56E-06,0,0,1
barry,2,3.67E-06,2,4.56E-06,0,0,2
vucic,2,3.67E-06,2,4.56E-06,0,0,2
coons,2,3.67E-06,2,4.56E-06,0,0,1
chang,2,3.67E-06,2,4.56E-06,0,0,1
risch,2,3.67E-06,2,4.56E-06,0,0,1
purge,2,3.67E-06,2,4.56E-06,0,0,1
byron,2,3.67E-06,2,4.56E-06,0,0,2
evers,2,3.67E-06,2,4.56E-06,0,0,2
brees,2,3.67E-06,2,4.56E-06,0,0,1
ridge,2,3.67E-06,2,4.56E-06,0,0,1
idiot,2,3.67E-06,2,4.56E-06,0,0,2
roles,2,3.67E-06,2,4.56E-06,0,0,2
scorn,2,3.67E-06,2,4.56E-06,0,0,1
spike,2,3.67E-06,2,4.56E-06,0,0,1
fargo,2,3.67E-06,2,4.56E-06,0,0,2
seeks,2,3.67E-06,2,4.56E-06,0,0,1
recep,2,3.67E-06,2,4.56E-06,0,0,2
greet,2,3.67E-06,2,4.56E-06,0,0,1
tokyo,2,3.67E-06,2,4.56E-06,0,0,2
macri,2,3.67E-06,2,4.56E-06,0,0,2
guilt,2,3.67E-06,2,4.56E-06,0,0,1
lamar,2,3.67E-06,2,4.56E-06,0,0,2
ghani,2,3.67E-06,2,4.56E-06,0,0,2
heyer,2,3.67E-06,2,4.56E-06,0,0,2
merck,2,3.67E-06,2,4.56E-06,0,0,1
kates,2,3.67E-06,2,4.56E-06,0,0,1
evils,2,3.67E-06,2,4.56E-06,0,0,2
sadiq,2,3.67E-06,2,4.56E-06,0,0,2
deeds,2,3.67E-06,2,4.56E-06,0,0,1
estes,2,3.67E-06,2,4.56E-06,0,0,1
perez,2,3.67E-06,2,4.56E-06,0,0,2
edges,2,3.67E-06,2,4.56E-06,0,0,1
peril,2,3.67E-06,2,4.56E-06,0,0,2
slats,2,3.67E-06,2,4.56E-06,0,0,1
anton,2,3.67E-06,2,4.56E-06,0,0,2
haley,2,3.67E-06,2,4.56E-06,0,0,2
gorka,2,3.67E-06,2,4.56E-06,0,0,2
cruel,2,3.67E-06,2,4.56E-06,0,0,1
blast,2,3.67E-06,2,4.56E-06,0,0,1
sikhs,2,3.67E-06,2,4.56E-06,0,0,1
jains,2,3.67E-06,2,4.56E-06,0,0,1
wines,2,3.67E-06,2,4.56E-06,0,0,1
waltz,2,3.67E-06,2,4.56E-06,0,0,1
shock,2,3.67E-06,2,4.56E-06,0,0,1
heidi,2,3.67E-06,2,4.56E-06,0,0,2
lined,2,3.67E-06,2,4.56E-06,0,0,1
harsh,2,3.67E-06,2,4.56E-06,0,0,1
array,2,3.67E-06,2,4.56E-06,0,0,2
dimon,2,3.67E-06,2,4.56E-06,0,0,2
grain,2,3.67E-06,2,4.56E-06,0,0,1
steil,2,3.67E-06,2,4.56E-06,0,0,1
civic,2,3.67E-06,2,4.56E-06,0,0,2
blank,2,3.67E-06,2,4.56E-06,0,0,1
steer,2,3.67E-06,2,4.56E-06,0,0,1
alene,2,3.67E-06,2,4.56E-06,0,0,2
bezos,2,3.67E-06,2,4.56E-06,0,0,2
nixon,2,3.67E-06,2,4.56E-06,0,0,2
drawn,2,3.67E-06,2,4.56E-06,0,0,1
ranks,2,3.67E-06,2,4.56E-06,0,0,1
novel,2,3.67E-06,2,4.56E-06,0,0,2
bruno,2,3.67E-06,2,4.56E-06,0,0,2
greek,2,3.67E-06,2,4.56E-06,0,0,1
oprah,2,3.67E-06,2,4.56E-06,0,0,2
edwin,2,3.67E-06,2,4.56E-06,0,0,2
greta,2,3.67E-06,2,4.56E-06,0,0,2
lance,2,3.67E-06,2,4.56E-06,0,0,1
geary,2,3.67E-06,2,4.56E-06,0,0,2
burns,2,3.67E-06,2,4.56E-06,0,0,1
howie,2,3.67E-06,2,4.56E-06,0,0,2
rocks,2,3.67E-06,2,4.56E-06,0,0,1
tulsi,2,3.67E-06,2,4.56E-06,0,0,2
aides,2,3.67E-06,2,4.56E-06,0,0,1
holes,2,3.67E-06,2,4.56E-06,0,0,2
dicey,2,3.67E-06,2,4.56E-06,0,0,2
stems,2,3.67E-06,2,4.56E-06,0,0,1
riley,2,3.67E-06,2,4.56E-06,0,0,2
axios,2,3.67E-06,2,4.56E-06,0,0,2
maxed,2,3.67E-06,2,4.56E-06,0,0,1
coats,2,3.67E-06,2,4.56E-06,0,0,1
reams,2,3.67E-06,2,4.56E-06,0,0,1
overs,2,3.67E-06,2,4.56E-06,0,0,2
osaka,2,3.67E-06,2,4.56E-06,0,0,3
famer,2,3.67E-06,2,4.56E-06,0,0,2
lords,2,3.67E-06,2,4.56E-06,0,0,1
redos,2,3.67E-06,2,4.56E-06,0,0,2
resch,2,3.67E-06,2,4.56E-06,0,0,1
barrs,2,3.67E-06,2,4.56E-06,0,0,1
deroy,2,3.67E-06,2,4.56E-06,0,0,2
bucket,2,3.67E-06,0,0,1.89E-05,2,2
dishes,2,3.67E-06,0,0,1.89E-05,2,1
kippur,2,3.67E-06,1,2.28E-06,9.47E-06,1,2
oldest,2,3.67E-06,1,2.28E-06,9.47E-06,1,2
shanah,2,3.67E-06,0,0,1.89E-05,2,2
priced,2,3.67E-06,1,2.28E-06,9.47E-06,1,1
inchip,2,3.67E-06,0,0,1.89E-05,2,2
tricks,2,3.67E-06,1,2.28E-06,9.47E-06,1,1
detect,2,3.67E-06,1,2.28E-06,9.47E-06,1,2
guided,2,3.67E-06,1,2.28E-06,9.47E-06,1,1
shines,2,3.67E-06,0,0,1.89E-05,2,1
truman,2,3.67E-06,1,2.28E-06,9.47E-06,1,2
budged,2,3.67E-06,0,0,1.89E-05,2,1
invent,2,3.67E-06,0,0,1.89E-05,2,2
joyful,2,3.67E-06,1,2.28E-06,9.47E-06,1,2
shrink,2,3.67E-06,0,0,1.89E-05,2,1
tactic,2,3.67E-06,1,2.28E-06,9.47E-06,1,2
fierce,2,3.67E-06,0,0,1.89E-05,2,1
output,2,3.67E-06,1,2.28E-06,9.47E-06,1,2
bodies,2,3.67E-06,0,0,1.89E-05,2,2
deport,2,3.67E-06,1,2.28E-06,9.47E-06,1,2
retain,2,3.67E-06,1,2.28E-06,9.47E-06,1,2
beings,2,3.67E-06,1,2.28E-06,9.47E-06,1,1
outnot,2,3.67E-06,0,0,1.89E-05,2,2
silver,2,3.67E-06,1,2.28E-06,9.47E-06,1,2
nailed,2,3.67E-06,1,2.28E-06,9.47E-06,1,1
mentor,2,3.67E-06,1,2.28E-06,9.47E-06,1,2
tarmac,2,3.67E-06,1,2.28E-06,9.47E-06,1,2
taping,2,3.67E-06,1,2.28E-06,9.47E-06,1,2
messor,2,3.67E-06,0,0,1.89E-05,2,2
skewed,2,3.67E-06,0,0,1.89E-05,2,1
sesame,2,3.67E-06,0,0,1.89E-05,2,2
recipe,2,3.67E-06,0,0,1.89E-05,2,2
spouse,2,3.67E-06,1,2.28E-06,9.47E-06,1,1
notion,2,3.67E-06,0,0,1.89E-05,2,2
kerrys,2,3.67E-06,1,2.28E-06,9.47E-06,1,2
unjust,2,3.67E-06,0,0,1.89E-05,2,2
rehire,2,3.67E-06,1,2.28E-06,9.47E-06,1,2
cookie,2,3.67E-06,1,2.28E-06,9.47E-06,1,2
cayman,2,3.67E-06,0,0,1.89E-05,2,2
flyers,2,3.67E-06,1,2.28E-06,9.47E-06,1,1
intern,2,3.67E-06,0,0,1.89E-05,2,2
todaya,2,3.67E-06,0,0,1.89E-05,2,3
candid,2,3.67E-06,1,2.28E-06,9.47E-06,1,2
widely,2,3.67E-06,1,2.28E-06,9.47E-06,1,3
washes,2,3.67E-06,1,2.28E-06,9.47E-06,1,1
pocket,2,3.67E-06,1,2.28E-06,9.47E-06,1,2
sandra,2,3.67E-06,0,0,1.89E-05,2,2
jeremy,2,3.67E-06,1,2.28E-06,9.47E-06,1,3
hoodie,2,3.67E-06,0,0,1.89E-05,2,2
regret,2,3.67E-06,1,2.28E-06,9.47E-06,1,2
strive,2,3.67E-06,0,0,1.89E-05,2,1
engine,2,3.67E-06,1,2.28E-06,9.47E-06,1,2
renews,2,3.67E-06,1,2.28E-06,9.47E-06,1,2
polish,2,3.67E-06,1,2.28E-06,9.47E-06,1,2
pluses,2,3.67E-06,2,4.56E-06,0,0,1
infamy,2,3.67E-06,2,4.56E-06,0,0,3
nbcwsj,2,3.67E-06,2,4.56E-06,0,0,#ERROR!
taxing,2,3.67E-06,2,4.56E-06,0,0,2
carney,2,3.67E-06,2,4.56E-06,0,0,2
bowden,2,3.67E-06,2,4.56E-06,0,0,2
cartel,2,3.67E-06,2,4.56E-06,0,0,2
versus,2,3.67E-06,2,4.56E-06,0,0,2
refers,2,3.67E-06,2,4.56E-06,0,0,2
gladly,2,3.67E-06,2,4.56E-06,0,0,2
freely,2,3.67E-06,2,4.56E-06,0,0,2
indoor,2,3.67E-06,2,4.56E-06,0,0,2
dining,2,3.67E-06,2,4.56E-06,0,0,2
cutler,2,3.67E-06,2,4.56E-06,0,0,2
posted,2,3.67E-06,2,4.56E-06,0,0,1
mayhem,2,3.67E-06,2,4.56E-06,0,0,2
sahara,2,3.67E-06,2,4.56E-06,0,0,3
shouts,2,3.67E-06,2,4.56E-06,0,0,1
routed,2,3.67E-06,2,4.56E-06,0,0,1
outlaw,2,3.67E-06,2,4.56E-06,0,0,2
moines,2,3.67E-06,2,4.56E-06,0,0,1
shield,2,3.67E-06,2,4.56E-06,0,0,1
random,2,3.67E-06,2,4.56E-06,0,0,2
measly,2,3.67E-06,2,4.56E-06,0,0,2
lining,2,3.67E-06,2,4.56E-06,0,0,2
meghan,2,3.67E-06,2,4.56E-06,0,0,2
minden,2,3.67E-06,2,4.56E-06,0,0,2
knocks,2,3.67E-06,2,4.56E-06,0,0,1
Ø¯Ø³Øª,2,3.67E-06,2,4.56E-06,0,0,#ERROR!
sleeps,2,3.67E-06,2,4.56E-06,0,0,1
graves,2,3.67E-06,2,4.56E-06,0,0,1
mighty,2,3.67E-06,2,4.56E-06,0,0,2
doomed,2,3.67E-06,2,4.56E-06,0,0,1
cubans,2,3.67E-06,2,4.56E-06,0,0,2
qassem,2,3.67E-06,2,4.56E-06,0,0,2
routes,2,3.67E-06,2,4.56E-06,0,0,1
lineup,2,3.67E-06,2,4.56E-06,0,0,2
medium,2,3.67E-06,2,4.56E-06,0,0,2
riders,2,3.67E-06,2,4.56E-06,0,0,2
hinson,2,3.67E-06,2,4.56E-06,0,0,2
stigma,2,3.67E-06,2,4.56E-06,0,0,2
serbia,2,3.67E-06,2,4.56E-06,0,0,2
lasted,2,3.67E-06,2,4.56E-06,0,0,1
chriss,2,3.67E-06,2,4.56E-06,0,0,1
puzzle,2,3.67E-06,2,4.56E-06,0,0,2
messed,2,3.67E-06,2,4.56E-06,0,0,1
peters,2,3.67E-06,2,4.56E-06,0,0,2
spared,2,3.67E-06,2,4.56E-06,0,0,1
unlock,2,3.67E-06,2,4.56E-06,0,0,2
texans,2,3.67E-06,2,4.56E-06,0,0,2
capone,2,3.67E-06,2,4.56E-06,0,0,2
nashua,2,3.67E-06,2,4.56E-06,0,0,2
bounty,2,3.67E-06,2,4.56E-06,0,0,2
chorus,2,3.67E-06,2,4.56E-06,0,0,2
misses,2,3.67E-06,2,4.56E-06,0,0,1
symbol,2,3.67E-06,2,4.56E-06,0,0,2
untold,2,3.67E-06,2,4.56E-06,0,0,2
rivals,2,3.67E-06,2,4.56E-06,0,0,2
slight,2,3.67E-06,2,4.56E-06,0,0,1
seemed,2,3.67E-06,2,4.56E-06,0,0,1
curfew,2,3.67E-06,2,4.56E-06,0,0,2
felony,2,3.67E-06,2,4.56E-06,0,0,3
bailed,2,3.67E-06,2,4.56E-06,0,0,1
venues,2,3.67E-06,2,4.56E-06,0,0,2
wesley,2,3.67E-06,2,4.56E-06,0,0,2
behave,2,3.67E-06,2,4.56E-06,0,0,2
inhofe,2,3.67E-06,2,4.56E-06,0,0,2
rogers,2,3.67E-06,2,4.56E-06,0,0,2
defame,2,3.67E-06,2,4.56E-06,0,0,2
adrian,2,3.67E-06,2,4.56E-06,0,0,2
powmia,2,3.67E-06,2,4.56E-06,0,0,2
seized,2,3.67E-06,2,4.56E-06,0,0,1
rebuke,2,3.67E-06,2,4.56E-06,0,0,2
ashame,2,3.67E-06,2,4.56E-06,0,0,2
brazen,2,3.67E-06,2,4.56E-06,0,0,2
employ,2,3.67E-06,2,4.56E-06,0,0,2
roving,2,3.67E-06,2,4.56E-06,0,0,2
bounds,2,3.67E-06,2,4.56E-06,0,0,1
mixing,2,3.67E-06,2,4.56E-06,0,0,2
looted,2,3.67E-06,2,4.56E-06,0,0,1
insist,2,3.67E-06,2,4.56E-06,0,0,2
injury,2,3.67E-06,2,4.56E-06,0,0,3
oclock,2,3.67E-06,2,4.56E-06,0,0,2
saints,2,3.67E-06,2,4.56E-06,0,0,1
mutiny,2,3.67E-06,2,4.56E-06,0,0,3
flames,2,3.67E-06,2,4.56E-06,0,0,1
indias,2,3.67E-06,2,4.56E-06,0,0,2
hoover,2,3.67E-06,2,4.56E-06,0,0,2
muslim,2,3.67E-06,2,4.56E-06,0,0,2
vessel,2,3.67E-06,2,4.56E-06,0,0,2
tracey,2,3.67E-06,2,4.56E-06,0,0,2
remedy,2,3.67E-06,2,4.56E-06,0,0,3
tricky,2,3.67E-06,2,4.56E-06,0,0,2
shakes,2,3.67E-06,2,4.56E-06,0,0,1
recuse,2,3.67E-06,2,4.56E-06,0,0,2
carson,2,3.67E-06,2,4.56E-06,0,0,2
circle,2,3.67E-06,2,4.56E-06,0,0,2
everwe,2,3.67E-06,2,4.56E-06,0,0,2
bukele,2,3.67E-06,2,4.56E-06,0,0,3
weakly,2,3.67E-06,2,4.56E-06,0,0,2
wolves,2,3.67E-06,2,4.56E-06,0,0,1
lastly,2,3.67E-06,2,4.56E-06,0,0,2
noonan,2,3.67E-06,2,4.56E-06,0,0,2
blaine,2,3.67E-06,2,4.56E-06,0,0,1
crafts,2,3.67E-06,2,4.56E-06,0,0,1
burned,2,3.67E-06,2,4.56E-06,0,0,1
dupont,2,3.67E-06,2,4.56E-06,0,0,2
pauses,2,3.67E-06,2,4.56E-06,0,0,1
tayyip,2,3.67E-06,2,4.56E-06,0,0,2
flakey,2,3.67E-06,2,4.56E-06,0,0,2
anemic,2,3.67E-06,2,4.56E-06,0,0,3
yokota,2,3.67E-06,2,4.56E-06,0,0,3
reince,2,3.67E-06,2,4.56E-06,0,0,1
revive,2,3.67E-06,2,4.56E-06,0,0,2
alexis,2,3.67E-06,2,4.56E-06,0,0,3
greece,2,3.67E-06,2,4.56E-06,0,0,1
louder,2,3.67E-06,2,4.56E-06,0,0,2
locals,2,3.67E-06,2,4.56E-06,0,0,2
fences,2,3.67E-06,2,4.56E-06,0,0,1
doings,2,3.67E-06,2,4.56E-06,0,0,1
barron,2,3.67E-06,2,4.56E-06,0,0,2
sleazy,2,3.67E-06,2,4.56E-06,0,0,2
delete,2,3.67E-06,2,4.56E-06,0,0,2
norman,2,3.67E-06,2,4.56E-06,0,0,2
engage,2,3.67E-06,2,4.56E-06,0,0,2
surged,2,3.67E-06,2,4.56E-06,0,0,1
lavrov,2,3.67E-06,2,4.56E-06,0,0,2
outcry,2,3.67E-06,2,4.56E-06,0,0,2
bogged,2,3.67E-06,2,4.56E-06,0,0,1
string,2,3.67E-06,2,4.56E-06,0,0,1
chairs,2,3.67E-06,2,4.56E-06,0,0,1
weight,2,3.67E-06,2,4.56E-06,0,0,1
mcgurk,2,3.67E-06,2,4.56E-06,0,0,1
drones,2,3.67E-06,2,4.56E-06,0,0,1
obtain,2,3.67E-06,2,4.56E-06,0,0,2
wilbur,2,3.67E-06,2,4.56E-06,0,0,2
arthur,2,3.67E-06,2,4.56E-06,0,0,2
snipes,2,3.67E-06,2,4.56E-06,0,0,1
mumbai,2,3.67E-06,2,4.56E-06,0,0,2
waving,2,3.67E-06,2,4.56E-06,0,0,2
ironic,2,3.67E-06,2,4.56E-06,0,0,3
sinema,2,3.67E-06,2,4.56E-06,0,0,3
timber,2,3.67E-06,2,4.56E-06,0,0,2
cramer,2,3.67E-06,2,4.56E-06,0,0,2
throws,2,3.67E-06,2,4.56E-06,0,0,1
minors,2,3.67E-06,2,4.56E-06,0,0,2
master,2,3.67E-06,2,4.56E-06,0,0,2
texted,2,3.67E-06,2,4.56E-06,0,0,1
smarts,2,3.67E-06,2,4.56E-06,0,0,1
divide,2,3.67E-06,2,4.56E-06,0,0,2
bashar,2,3.67E-06,2,4.56E-06,0,0,2
hikind,2,3.67E-06,2,4.56E-06,0,0,2
yorker,2,3.67E-06,2,4.56E-06,0,0,2
heroin,2,3.67E-06,2,4.56E-06,0,0,2
kobach,2,3.67E-06,2,4.56E-06,0,0,2
majors,2,3.67E-06,2,4.56E-06,0,0,2
lebron,2,3.67E-06,2,4.56E-06,0,0,2
spacex,2,3.67E-06,2,4.56E-06,0,0,2
wilkie,2,3.67E-06,2,4.56E-06,0,0,2
asians,2,3.67E-06,2,4.56E-06,0,0,2
raving,2,3.67E-06,2,4.56E-06,0,0,2
kremer,2,3.67E-06,2,4.56E-06,0,0,2
punchy,2,3.67E-06,2,4.56E-06,0,0,2
boxers,2,3.67E-06,2,4.56E-06,0,0,2
stoped,2,3.67E-06,2,4.56E-06,0,0,1
eagles,2,3.67E-06,2,4.56E-06,0,0,2
gentle,2,3.67E-06,2,4.56E-06,0,0,2
pounds,2,3.67E-06,2,4.56E-06,0,0,1
unreal,2,3.67E-06,2,4.56E-06,0,0,2
admire,2,3.67E-06,2,4.56E-06,0,0,2
deploy,2,3.67E-06,2,4.56E-06,0,0,2
schoen,2,3.67E-06,2,4.56E-06,0,0,1
kissed,2,3.67E-06,2,4.56E-06,0,0,1
meddle,2,3.67E-06,2,4.56E-06,0,0,2
basics,2,3.67E-06,2,4.56E-06,0,0,2
rivers,2,3.67E-06,2,4.56E-06,0,0,2
durbin,2,3.67E-06,2,4.56E-06,0,0,2
dagger,2,3.67E-06,2,4.56E-06,0,0,2
brains,2,3.67E-06,2,4.56E-06,0,0,1
spikes,2,3.67E-06,2,4.56E-06,0,0,1
shreds,2,3.67E-06,2,4.56E-06,0,0,1
namely,2,3.67E-06,2,4.56E-06,0,0,3
boldly,2,3.67E-06,2,4.56E-06,0,0,2
virtue,2,3.67E-06,2,4.56E-06,0,0,2
parson,2,3.67E-06,2,4.56E-06,0,0,2
cherry,2,3.67E-06,2,4.56E-06,0,0,2
palais,2,3.67E-06,2,4.56E-06,0,0,2
vetoed,2,3.67E-06,2,4.56E-06,0,0,2
dearly,2,3.67E-06,2,4.56E-06,0,0,2
tlaibs,2,3.67E-06,2,4.56E-06,0,0,1
cortez,2,3.67E-06,2,4.56E-06,0,0,2
amazed,2,3.67E-06,2,4.56E-06,0,0,2
wounds,2,3.67E-06,2,4.56E-06,0,0,1
stefan,2,3.67E-06,2,4.56E-06,0,0,2
medias,2,3.67E-06,2,4.56E-06,0,0,2
wedded,2,3.67E-06,2,4.56E-06,0,0,1
mouths,2,3.67E-06,2,4.56E-06,0,0,1
lessen,2,3.67E-06,2,4.56E-06,0,0,2
hewson,2,3.67E-06,2,4.56E-06,0,0,2
kidney,2,3.67E-06,2,4.56E-06,0,0,2
draghi,2,3.67E-06,2,4.56E-06,0,0,2
smiled,2,3.67E-06,2,4.56E-06,0,0,1
temper,2,3.67E-06,2,4.56E-06,0,0,2
tumble,2,3.67E-06,2,4.56E-06,0,0,2
pissed,2,3.67E-06,2,4.56E-06,0,0,1
weirdo,2,3.67E-06,2,4.56E-06,0,0,2
uganda,2,3.67E-06,2,4.56E-06,0,0,3
widest,2,3.67E-06,2,4.56E-06,0,0,2
eaters,2,3.67E-06,2,4.56E-06,0,0,2
fantasy,2,3.67E-06,1,2.28E-06,9.47E-06,1,3
acquire,2,3.67E-06,1,2.28E-06,9.47E-06,1,2
mubarak,2,3.67E-06,0,0,1.89E-05,2,3
planets,2,3.67E-06,0,0,1.89E-05,2,2
careers,2,3.67E-06,1,2.28E-06,9.47E-06,1,2
teaches,2,3.67E-06,0,0,1.89E-05,2,1
broaden,2,3.67E-06,0,0,1.89E-05,2,2
leonard,2,3.67E-06,1,2.28E-06,9.47E-06,1,2
sleeves,2,3.67E-06,1,2.28E-06,9.47E-06,1,1
shadows,2,3.67E-06,0,0,1.89E-05,2,2
squeeze,2,3.67E-06,1,2.28E-06,9.47E-06,1,2
cleared,2,3.67E-06,1,2.28E-06,9.47E-06,1,1
saddled,2,3.67E-06,1,2.28E-06,9.47E-06,1,1
chooses,2,3.67E-06,1,2.28E-06,9.47E-06,1,1
bedrock,2,3.67E-06,0,0,1.89E-05,2,2
brainer,2,3.67E-06,1,2.28E-06,9.47E-06,1,2
loudest,2,3.67E-06,1,2.28E-06,9.47E-06,1,2
shifted,2,3.67E-06,1,2.28E-06,9.47E-06,1,1
dreamed,2,3.67E-06,1,2.28E-06,9.47E-06,1,1
hashoah,2,3.67E-06,1,2.28E-06,9.47E-06,1,2
diverse,2,3.67E-06,1,2.28E-06,9.47E-06,1,2
anxious,2,3.67E-06,1,2.28E-06,9.47E-06,1,3
winfrey,2,3.67E-06,1,2.28E-06,9.47E-06,1,2
dropout,2,3.67E-06,1,2.28E-06,9.47E-06,1,2
expires,2,3.67E-06,0,0,1.89E-05,2,2
reflect,2,3.67E-06,0,0,1.89E-05,2,2
faction,2,3.67E-06,0,0,1.89E-05,2,2
extract,2,3.67E-06,1,2.28E-06,9.47E-06,1,2
ranking,2,3.67E-06,1,2.28E-06,9.47E-06,1,2
baracks,2,3.67E-06,0,0,1.89E-05,2,2
muslims,2,3.67E-06,0,0,1.89E-05,2,2
sectors,2,3.67E-06,0,0,1.89E-05,2,2
concern,2,3.67E-06,1,2.28E-06,9.47E-06,1,2
defeats,2,3.67E-06,1,2.28E-06,9.47E-06,1,2
debated,2,3.67E-06,0,0,1.89E-05,2,2
spurred,2,3.67E-06,0,0,1.89E-05,2,1
evident,2,3.67E-06,1,2.28E-06,9.47E-06,1,3
broader,2,3.67E-06,0,0,1.89E-05,2,2
listens,2,3.67E-06,0,0,1.89E-05,2,2
handful,2,3.67E-06,0,0,1.89E-05,2,2
ohioans,2,3.67E-06,0,0,1.89E-05,2,3
seconds,2,3.67E-06,1,2.28E-06,9.47E-06,1,2
digging,2,3.67E-06,1,2.28E-06,9.47E-06,1,2
afghans,2,3.67E-06,1,2.28E-06,9.47E-06,1,2
womenor,2,3.67E-06,0,0,1.89E-05,2,3
insurer,2,3.67E-06,0,0,1.89E-05,2,3
binders,2,3.67E-06,0,0,1.89E-05,2,2
onstage,2,3.67E-06,0,0,1.89E-05,2,2
texting,2,3.67E-06,0,0,1.89E-05,2,2
msgsmth,2,3.67E-06,0,0,1.89E-05,2,#ERROR!
chicken,2,3.67E-06,1,2.28E-06,9.47E-06,1,2
regular,2,3.67E-06,1,2.28E-06,9.47E-06,1,3
clearer,2,3.67E-06,1,2.28E-06,9.47E-06,1,2
painful,2,3.67E-06,0,0,1.89E-05,2,2
keynote,2,3.67E-06,1,2.28E-06,9.47E-06,1,2
classes,2,3.67E-06,1,2.28E-06,9.47E-06,1,1
homesor,2,3.67E-06,0,0,1.89E-05,2,3
legends,2,3.67E-06,0,0,1.89E-05,2,2
ticking,2,3.67E-06,1,2.28E-06,9.47E-06,1,2
firemen,2,3.67E-06,1,2.28E-06,9.47E-06,1,3
beliefs,2,3.67E-06,1,2.28E-06,9.47E-06,1,2
georges,2,3.67E-06,1,2.28E-06,9.47E-06,1,1
clooney,2,3.67E-06,0,0,1.89E-05,2,2
richest,2,3.67E-06,1,2.28E-06,9.47E-06,1,2
futures,2,3.67E-06,1,2.28E-06,9.47E-06,1,2
vermont,2,3.67E-06,1,2.28E-06,9.47E-06,1,2
youtube,2,3.67E-06,0,0,1.89E-05,2,2
startup,2,3.67E-06,1,2.28E-06,9.47E-06,1,2
hangout,2,3.67E-06,0,0,1.89E-05,2,2
endures,2,3.67E-06,0,0,1.89E-05,2,2
handles,2,3.67E-06,1,2.28E-06,9.47E-06,1,2
lifting,2,3.67E-06,1,2.28E-06,9.47E-06,1,2
symbols,2,3.67E-06,1,2.28E-06,9.47E-06,1,2
canvass,2,3.67E-06,0,0,1.89E-05,2,2
notions,2,3.67E-06,0,0,1.89E-05,2,2
dorothy,2,3.67E-06,1,2.28E-06,9.47E-06,1,3
coakley,2,3.67E-06,0,0,1.89E-05,2,2
humbled,2,3.67E-06,1,2.28E-06,9.47E-06,1,1
forgets,2,3.67E-06,2,4.56E-06,0,0,2
flooded,2,3.67E-06,2,4.56E-06,0,0,1
hapless,2,3.67E-06,2,4.56E-06,0,0,2
exposes,2,3.67E-06,2,4.56E-06,0,0,2
elderly,2,3.67E-06,2,4.56E-06,0,0,3
abysmal,2,3.67E-06,2,4.56E-06,0,0,3
lenders,2,3.67E-06,2,4.56E-06,0,0,2
disdain,2,3.67E-06,2,4.56E-06,0,0,2
staffer,2,3.67E-06,2,4.56E-06,0,0,2
clouded,2,3.67E-06,2,4.56E-06,0,0,1
twisted,2,3.67E-06,2,4.56E-06,0,0,1
cronies,2,3.67E-06,2,4.56E-06,0,0,2
tanking,2,3.67E-06,2,4.56E-06,0,0,2
salutes,2,3.67E-06,2,4.56E-06,0,0,2
relying,2,3.67E-06,2,4.56E-06,0,0,2
morocco,2,3.67E-06,2,4.56E-06,0,0,3
beverly,2,3.67E-06,2,4.56E-06,0,0,3
rancher,2,3.67E-06,2,4.56E-06,0,0,2
dubuque,2,3.67E-06,2,4.56E-06,0,0,3
factory,2,3.67E-06,2,4.56E-06,0,0,3
lobster,2,3.67E-06,2,4.56E-06,0,0,2
fingers,2,3.67E-06,2,4.56E-06,0,0,2
dissent,2,3.67E-06,2,4.56E-06,0,0,2
admired,2,3.67E-06,2,4.56E-06,0,0,2
ravaged,2,3.67E-06,2,4.56E-06,0,0,2
invalid,2,3.67E-06,2,4.56E-06,0,0,3
carlson,2,3.67E-06,2,4.56E-06,0,0,2
revered,2,3.67E-06,2,4.56E-06,0,0,2
pastors,2,3.67E-06,2,4.56E-06,0,0,2
chocker,2,3.67E-06,2,4.56E-06,0,0,2
bookers,2,3.67E-06,2,4.56E-06,0,0,2
crazies,2,3.67E-06,2,4.56E-06,0,0,2
norfolk,2,3.67E-06,2,4.56E-06,0,0,2
shouted,2,3.67E-06,2,4.56E-06,0,0,1
taunted,2,3.67E-06,2,4.56E-06,0,0,1
crusade,2,3.67E-06,2,4.56E-06,0,0,2
nielsen,2,3.67E-06,2,4.56E-06,0,0,2
debater,2,3.67E-06,2,4.56E-06,0,0,3
nobodys,2,3.67E-06,2,4.56E-06,0,0,3
crushed,2,3.67E-06,2,4.56E-06,0,0,1
selfish,2,3.67E-06,2,4.56E-06,0,0,2
empathy,2,3.67E-06,2,4.56E-06,0,0,3
pension,2,3.67E-06,2,4.56E-06,0,0,2
disgust,2,3.67E-06,2,4.56E-06,0,0,2
curbing,2,3.67E-06,2,4.56E-06,0,0,2
smucker,2,3.67E-06,2,4.56E-06,0,0,2
mockery,2,3.67E-06,2,4.56E-06,0,0,3
recieve,2,3.67E-06,2,4.56E-06,0,0,2
periods,2,3.67E-06,2,4.56E-06,0,0,2
messner,2,3.67E-06,2,4.56E-06,0,0,2
pockets,2,3.67E-06,2,4.56E-06,0,0,2
puppets,2,3.67E-06,2,4.56E-06,0,0,2
cassidy,2,3.67E-06,2,4.56E-06,0,0,3
cordial,2,3.67E-06,2,4.56E-06,0,0,2
katrina,2,3.67E-06,2,4.56E-06,0,0,3
jenkins,2,3.67E-06,2,4.56E-06,0,0,2
lengthy,2,3.67E-06,2,4.56E-06,0,0,2
meadows,2,3.67E-06,2,4.56E-06,0,0,2
beijing,2,3.67E-06,2,4.56E-06,0,0,2
upended,2,3.67E-06,2,4.56E-06,0,0,2
popping,2,3.67E-06,2,4.56E-06,0,0,2
candace,2,3.67E-06,2,4.56E-06,0,0,2
blanket,2,3.67E-06,2,4.56E-06,0,0,2
precise,2,3.67E-06,2,4.56E-06,0,0,2
exceeds,2,3.67E-06,2,4.56E-06,0,0,2
vividly,2,3.67E-06,2,4.56E-06,0,0,3
yorkers,2,3.67E-06,2,4.56E-06,0,0,2
gardner,2,3.67E-06,2,4.56E-06,0,0,2
talkers,2,3.67E-06,2,4.56E-06,0,0,2
mediate,2,3.67E-06,2,4.56E-06,0,0,2
emerges,2,3.67E-06,2,4.56E-06,0,0,2
contain,2,3.67E-06,2,4.56E-06,0,0,2
rebuked,2,3.67E-06,2,4.56E-06,0,0,2
fondest,2,3.67E-06,2,4.56E-06,0,0,2
marches,2,3.67E-06,2,4.56E-06,0,0,1
fawning,2,3.67E-06,2,4.56E-06,0,0,2
oversaw,2,3.67E-06,2,4.56E-06,0,0,3
bolivia,2,3.67E-06,2,4.56E-06,0,0,3
provoke,2,3.67E-06,2,4.56E-06,0,0,2
whining,2,3.67E-06,2,4.56E-06,0,0,2
cheatin,2,3.67E-06,2,4.56E-06,0,0,2
quietly,2,3.67E-06,2,4.56E-06,0,0,3
fiorina,2,3.67E-06,2,4.56E-06,0,0,3
daniels,2,3.67E-06,2,4.56E-06,0,0,2
methods,2,3.67E-06,2,4.56E-06,0,0,2
targets,2,3.67E-06,2,4.56E-06,0,0,2
baptist,2,3.67E-06,2,4.56E-06,0,0,2
harmful,2,3.67E-06,2,4.56E-06,0,0,2
standby,2,3.67E-06,2,4.56E-06,0,0,2
restart,2,3.67E-06,2,4.56E-06,0,0,2
perform,2,3.67E-06,2,4.56E-06,0,0,2
touches,2,3.67E-06,2,4.56E-06,0,0,1
roadmap,2,3.67E-06,2,4.56E-06,0,0,2
equador,2,3.67E-06,2,4.56E-06,0,0,3
bedroom,2,3.67E-06,2,4.56E-06,0,0,2
bounces,2,3.67E-06,2,4.56E-06,0,0,1
diamond,2,3.67E-06,2,4.56E-06,0,0,2
colonel,2,3.67E-06,2,4.56E-06,0,0,3
airline,2,3.67E-06,2,4.56E-06,0,0,2
analyze,2,3.67E-06,2,4.56E-06,0,0,3
roberto,2,3.67E-06,2,4.56E-06,0,0,3
melanie,2,3.67E-06,2,4.56E-06,0,0,3
segment,2,3.67E-06,2,4.56E-06,0,0,2
harriss,2,3.67E-06,2,4.56E-06,0,0,2
rodgers,2,3.67E-06,2,4.56E-06,0,0,2
discord,2,3.67E-06,2,4.56E-06,0,0,2
wintour,2,3.67E-06,2,4.56E-06,0,0,2
crumble,2,3.67E-06,2,4.56E-06,0,0,2
kirsten,2,3.67E-06,2,4.56E-06,0,0,2
rafters,2,3.67E-06,2,4.56E-06,0,0,2
pursued,2,3.67E-06,2,4.56E-06,0,0,2
steinle,2,3.67E-06,2,4.56E-06,0,0,2
glowing,2,3.67E-06,2,4.56E-06,0,0,2
simpler,2,3.67E-06,2,4.56E-06,0,0,2
pressed,2,3.67E-06,2,4.56E-06,0,0,1
winding,2,3.67E-06,2,4.56E-06,0,0,2
renewed,2,3.67E-06,2,4.56E-06,0,0,2
sadness,2,3.67E-06,2,4.56E-06,0,0,2
priebus,2,3.67E-06,2,4.56E-06,0,0,2
drafted,2,3.67E-06,2,4.56E-06,0,0,1
tsipras,2,3.67E-06,2,4.56E-06,0,0,2
darkest,2,3.67E-06,2,4.56E-06,0,0,2
arsenal,2,3.67E-06,2,4.56E-06,0,0,3
revised,2,3.67E-06,2,4.56E-06,0,0,2
jamaica,2,3.67E-06,2,4.56E-06,0,0,3
condone,2,3.67E-06,2,4.56E-06,0,0,2
bigotry,2,3.67E-06,2,4.56E-06,0,0,3
enforce,2,3.67E-06,2,4.56E-06,0,0,2
advised,2,3.67E-06,2,4.56E-06,0,0,2
kushner,2,3.67E-06,2,4.56E-06,0,0,2
carrier,2,3.67E-06,2,4.56E-06,0,0,2
shinzÅ,2,3.67E-06,2,4.56E-06,0,0,1
retract,2,3.67E-06,2,4.56E-06,0,0,2
sekulow,2,3.67E-06,2,4.56E-06,0,0,3
alarmed,2,3.67E-06,2,4.56E-06,0,0,2
watered,2,3.67E-06,2,4.56E-06,0,0,2
covfefe,2,3.67E-06,2,4.56E-06,0,0,2
vatican,2,3.67E-06,2,4.56E-06,0,0,3
burdens,2,3.67E-06,2,4.56E-06,0,0,2
cochran,2,3.67E-06,2,4.56E-06,0,0,2
tapping,2,3.67E-06,2,4.56E-06,0,0,2
steeles,2,3.67E-06,2,4.56E-06,0,0,2
generel,2,3.67E-06,2,4.56E-06,0,0,3
swecker,2,3.67E-06,2,4.56E-06,0,0,2
changer,2,3.67E-06,2,4.56E-06,0,0,2
affects,2,3.67E-06,2,4.56E-06,0,0,2
banner,2,3.67E-06,1,2.28E-06,9.47E-06,1,2
devices,2,3.67E-06,2,4.56E-06,0,0,2
alerted,2,3.67E-06,2,4.56E-06,0,0,2
behaved,2,3.67E-06,2,4.56E-06,0,0,2
headway,2,3.67E-06,2,4.56E-06,0,0,2
lacking,2,3.67E-06,2,4.56E-06,0,0,2
andrzej,2,3.67E-06,2,4.56E-06,0,0,2
clauses,2,3.67E-06,2,4.56E-06,0,0,1
barrage,2,3.67E-06,2,4.56E-06,0,0,2
gutless,2,3.67E-06,2,4.56E-06,0,0,2
abusing,2,3.67E-06,2,4.56E-06,0,0,3
secrecy,2,3.67E-06,2,4.56E-06,0,0,3
seizing,2,3.67E-06,2,4.56E-06,0,0,2
secrets,2,3.67E-06,2,4.56E-06,0,0,2
actress,2,3.67E-06,2,4.56E-06,0,0,2
chocked,2,3.67E-06,2,4.56E-06,0,0,1
demoted,2,3.67E-06,2,4.56E-06,0,0,2
haywire,2,3.67E-06,2,4.56E-06,0,0,2
surveil,2,3.67E-06,2,4.56E-06,0,0,2
screams,2,3.67E-06,2,4.56E-06,0,0,1
endured,2,3.67E-06,2,4.56E-06,0,0,2
priding,2,3.67E-06,2,4.56E-06,0,0,2
marcelo,2,3.67E-06,2,4.56E-06,0,0,3
swiftly,2,3.67E-06,2,4.56E-06,0,0,2
breakup,2,3.67E-06,2,4.56E-06,0,0,2
dynasty,2,3.67E-06,2,4.56E-06,0,0,3
recusal,2,3.67E-06,2,4.56E-06,0,0,3
enabled,2,3.67E-06,2,4.56E-06,0,0,2
fischer,2,3.67E-06,2,4.56E-06,0,0,2
gesture,2,3.67E-06,2,4.56E-06,0,0,2
analyst,2,3.67E-06,2,4.56E-06,0,0,3
flunkie,2,3.67E-06,2,4.56E-06,0,0,2
amazons,2,3.67E-06,2,4.56E-06,0,0,3
defiant,2,3.67E-06,2,4.56E-06,0,0,2
stevens,2,3.67E-06,2,4.56E-06,0,0,2
schlapp,2,3.67E-06,2,4.56E-06,0,0,1
miramar,2,3.67E-06,2,4.56E-06,0,0,3
baldwin,2,3.67E-06,2,4.56E-06,0,0,2
tunnel,2,3.67E-06,2,4.56E-06,0,0,2
revival,2,3.67E-06,2,4.56E-06,0,0,3
insight,2,3.67E-06,2,4.56E-06,0,0,2
peanuts,2,3.67E-06,2,4.56E-06,0,0,2
coupled,2,3.67E-06,2,4.56E-06,0,0,1
meister,2,3.67E-06,2,4.56E-06,0,0,2
appears,2,3.67E-06,2,4.56E-06,0,0,2
hershey,2,3.67E-06,2,4.56E-06,0,0,2
loaning,2,3.67E-06,2,4.56E-06,0,0,2
trident,2,3.67E-06,2,4.56E-06,0,0,2
appease,2,3.67E-06,2,4.56E-06,0,0,2
donalds,2,3.67E-06,2,4.56E-06,0,0,2
higgins,2,3.67E-06,2,4.56E-06,0,0,2
upstate,2,3.67E-06,2,4.56E-06,0,0,2
sandman,2,3.67E-06,2,4.56E-06,0,0,2
expired,2,3.67E-06,2,4.56E-06,0,0,2
kurdish,2,3.67E-06,2,4.56E-06,0,0,2
censure,2,3.67E-06,2,4.56E-06,0,0,2
crystal,2,3.67E-06,2,4.56E-06,0,0,2
capture,2,3.67E-06,2,4.56E-06,0,0,2
netflix,2,3.67E-06,2,4.56E-06,0,0,2
tankers,2,3.67E-06,2,4.56E-06,0,0,2
doonbeg,2,3.67E-06,2,4.56E-06,0,0,2
ducking,2,3.67E-06,2,4.56E-06,0,0,2
messiah,2,3.67E-06,2,4.56E-06,0,0,2
boosted,2,3.67E-06,2,4.56E-06,0,0,1
spencer,2,3.67E-06,2,4.56E-06,0,0,2
rescind,2,3.67E-06,2,4.56E-06,0,0,2
impeded,2,3.67E-06,2,4.56E-06,0,0,2
columns,2,3.67E-06,2,4.56E-06,0,0,2
robbing,2,3.67E-06,2,4.56E-06,0,0,2
banking,2,3.67E-06,2,4.56E-06,0,0,2
eastman,2,3.67E-06,2,4.56E-06,0,0,2
shelton,2,3.67E-06,2,4.56E-06,0,0,2
toasted,2,3.67E-06,2,4.56E-06,0,0,1
hegseth,2,3.67E-06,2,4.56E-06,0,0,2
dissect,2,3.67E-06,2,4.56E-06,0,0,2
shafted,2,3.67E-06,2,4.56E-06,0,0,1
nadlers,2,3.67E-06,2,4.56E-06,0,0,2
invaded,2,3.67E-06,2,4.56E-06,0,0,2
tantrum,2,3.67E-06,2,4.56E-06,0,0,2
portman,2,3.67E-06,2,4.56E-06,0,0,2
sucking,2,3.67E-06,2,4.56E-06,0,0,2
tourist,2,3.67E-06,2,4.56E-06,0,0,2
jexodus,2,3.67E-06,2,4.56E-06,0,0,3
perjury,2,3.67E-06,2,4.56E-06,0,0,3
checker,2,3.67E-06,2,4.56E-06,0,0,2
passive,2,3.67E-06,2,4.56E-06,0,0,2
murdock,2,3.67E-06,2,4.56E-06,0,0,2
bighorn,2,3.67E-06,2,4.56E-06,0,0,2
dannys,2,3.67E-06,2,4.56E-06,0,0,2
runners,2,3.67E-06,1,2.28E-06,9.47E-06,1,2
tyranny,2,3.67E-06,0,0,1.89E-05,2,3
manning,2,3.67E-06,2,4.56E-06,0,0,2
kenneth,2,3.67E-06,2,4.56E-06,0,0,2
innings,2,3.67E-06,2,4.56E-06,0,0,2
funnier,2,3.67E-06,2,4.56E-06,0,0,2
kennedys,2,3.67E-06,0,0,1.89E-05,2,3
annually,2,3.67E-06,1,2.28E-06,9.47E-06,1,3
unmanned,2,3.67E-06,2,4.56E-06,0,0,2
donnelly,2,3.67E-06,2,4.56E-06,0,0,3
odonnell,2,3.67E-06,2,4.56E-06,0,0,3
quinnipiac,2,3.67E-06,2,4.56E-06,0,0,3
cunningham,2,3.67E-06,2,4.56E-06,0,0,3
unannounced,2,3.67E-06,2,4.56E-06,0,0,3
till,2,3.67E-06,1,2.28E-06,9.47E-06,1,1
steinbrenner,2,3.67E-06,2,4.56E-06,0,0,3
wholl,2,3.67E-06,0,0,1.89E-05,2,1
grill,2,3.67E-06,1,2.28E-06,9.47E-06,1,1
pennsylvanias,2,3.67E-06,2,4.56E-06,0,0,4
ellis,2,3.67E-06,2,4.56E-06,0,0,2
stall,2,3.67E-06,2,4.56E-06,0,0,1
spell,2,3.67E-06,2,4.56E-06,0,0,1
announcements,2,3.67E-06,2,4.56E-06,0,0,4
pulls,2,3.67E-06,2,4.56E-06,0,0,1
wells,2,3.67E-06,2,4.56E-06,0,0,1
bells,2,3.67E-06,2,4.56E-06,0,0,1
kills,2,3.67E-06,2,4.56E-06,0,0,1
bullet,2,3.67E-06,1,2.28E-06,9.47E-06,1,2
spells,2,3.67E-06,2,4.56E-06,0,0,1
drills,2,3.67E-06,2,4.56E-06,0,0,1
stalled,2,3.67E-06,1,2.28E-06,9.47E-06,1,1
sellers,2,3.67E-06,1,2.28E-06,9.47E-06,1,2
ellipse,2,3.67E-06,2,4.56E-06,0,0,2
putt,2,3.67E-06,2,4.56E-06,0,0,1
nullify,2,3.67E-06,2,4.56E-06,0,0,3
updating,2,3.67E-06,1,2.28E-06,9.47E-06,1,3
scrutiny,2,3.67E-06,1,2.28E-06,9.47E-06,1,3
climbing,2,3.67E-06,1,2.28E-06,9.47E-06,1,2
shoulder,2,3.67E-06,0,0,1.89E-05,2,2
strivers,2,3.67E-06,0,0,1.89E-05,2,2
tangible,2,3.67E-06,0,0,1.89E-05,2,3
gridlock,2,3.67E-06,0,0,1.89E-05,2,2
trickled,2,3.67E-06,0,0,1.89E-05,2,1
anybodys,2,3.67E-06,0,0,1.89E-05,2,4
tweeting,2,3.67E-06,0,0,1.89E-05,2,2
squarely,2,3.67E-06,1,2.28E-06,9.47E-06,1,3
deciding,2,3.67E-06,1,2.28E-06,9.47E-06,1,3
neighbor,2,3.67E-06,1,2.28E-06,9.47E-06,1,2
defining,2,3.67E-06,1,2.28E-06,9.47E-06,1,3
orthodox,2,3.67E-06,1,2.28E-06,9.47E-06,1,3
outpaced,2,3.67E-06,1,2.28E-06,9.47E-06,1,2
uniforms,2,3.67E-06,1,2.28E-06,9.47E-06,1,3
shelters,2,3.67E-06,1,2.28E-06,9.47E-06,1,2
arrivals,2,3.67E-06,0,0,1.89E-05,2,3
dreaming,2,3.67E-06,1,2.28E-06,9.47E-06,1,2
holiness,2,3.67E-06,1,2.28E-06,9.47E-06,1,3
simplest,2,3.67E-06,0,0,1.89E-05,2,2
shifting,2,3.67E-06,1,2.28E-06,9.47E-06,1,2
defiance,2,3.67E-06,1,2.28E-06,9.47E-06,1,2
reasoned,2,3.67E-06,1,2.28E-06,9.47E-06,1,2
responds,2,3.67E-06,0,0,1.89E-05,2,2
afforded,2,3.67E-06,1,2.28E-06,9.47E-06,1,2
reckless,2,3.67E-06,0,0,1.89E-05,2,2
setbacks,2,3.67E-06,1,2.28E-06,9.47E-06,1,2
agendawe,2,3.67E-06,0,0,1.89E-05,2,3
romnesia,2,3.67E-06,0,0,1.89E-05,2,3
mourdock,2,3.67E-06,0,0,1.89E-05,2,2
greeting,2,3.67E-06,1,2.28E-06,9.47E-06,1,2
buckeyes,2,3.67E-06,0,0,1.89E-05,2,3
weekends,2,3.67E-06,1,2.28E-06,9.47E-06,1,2
simplify,2,3.67E-06,0,0,1.89E-05,2,3
christie,2,3.67E-06,1,2.28E-06,9.47E-06,1,2
rational,2,3.67E-06,1,2.28E-06,9.47E-06,1,3
turbines,2,3.67E-06,0,0,1.89E-05,2,2
powering,2,3.67E-06,1,2.28E-06,9.47E-06,1,3
councils,2,3.67E-06,1,2.28E-06,9.47E-06,1,2
weighted,2,3.67E-06,1,2.28E-06,9.47E-06,1,1
guidance,2,3.67E-06,1,2.28E-06,9.47E-06,1,2
excluded,2,3.67E-06,1,2.28E-06,9.47E-06,1,2
adequate,2,3.67E-06,0,0,1.89E-05,2,3
narrated,2,3.67E-06,1,2.28E-06,9.47E-06,1,2
features,2,3.67E-06,1,2.28E-06,9.47E-06,1,2
catching,2,3.67E-06,1,2.28E-06,9.47E-06,1,2
speeding,2,3.67E-06,1,2.28E-06,9.47E-06,1,2
postcard,2,3.67E-06,0,0,1.89E-05,2,2
overview,2,3.67E-06,0,0,1.89E-05,2,3
usually,2,3.67E-06,2,4.56E-06,0,0,3
watchdog,2,3.67E-06,1,2.28E-06,9.47E-06,1,2
spelled,2,3.67E-06,2,4.56E-06,0,0,1
gotta,2,3.67E-06,1,2.28E-06,9.47E-06,1,2
restrict,2,3.67E-06,1,2.28E-06,9.47E-06,1,2
presents,2,3.67E-06,1,2.28E-06,9.47E-06,1,2
advisers,2,3.67E-06,1,2.28E-06,9.47E-06,1,3
outlines,2,3.67E-06,1,2.28E-06,9.47E-06,1,2
avoiding,2,3.67E-06,1,2.28E-06,9.47E-06,1,3
enacting,2,3.67E-06,1,2.28E-06,9.47E-06,1,3
unending,2,3.67E-06,1,2.28E-06,9.47E-06,1,3
embodies,2,3.67E-06,1,2.28E-06,9.47E-06,1,3
injuries,2,3.67E-06,1,2.28E-06,9.47E-06,1,3
overhaul,2,3.67E-06,1,2.28E-06,9.47E-06,1,3
emission,2,3.67E-06,1,2.28E-06,9.47E-06,1,3
cesspool,2,3.67E-06,2,4.56E-06,0,0,2
electors,2,3.67E-06,2,4.56E-06,0,0,3
stripped,2,3.67E-06,2,4.56E-06,0,0,1
predicts,2,3.67E-06,2,4.56E-06,0,0,2
receives,2,3.67E-06,2,4.56E-06,0,0,2
confined,2,3.67E-06,2,4.56E-06,0,0,2
brooklyn,2,3.67E-06,2,4.56E-06,0,0,2
rebuffed,2,3.67E-06,2,4.56E-06,0,0,2
indianas,2,3.67E-06,2,4.56E-06,0,0,3
goodyear,2,3.67E-06,2,4.56E-06,0,0,3
weddings,2,3.67E-06,2,4.56E-06,0,0,2
promoted,2,3.67E-06,2,4.56E-06,0,0,2
poisoned,2,3.67E-06,2,4.56E-06,0,0,2
outsider,2,3.67E-06,2,4.56E-06,0,0,3
governed,2,3.67E-06,2,4.56E-06,0,0,2
insiders,2,3.67E-06,2,4.56E-06,0,0,3
silenced,2,3.67E-06,2,4.56E-06,0,0,2
regarded,2,3.67E-06,2,4.56E-06,0,0,2
defaming,2,3.67E-06,2,4.56E-06,0,0,3
floating,2,3.67E-06,2,4.56E-06,0,0,2
pardoned,2,3.67E-06,2,4.56E-06,0,0,2
ideally,2,3.67E-06,2,4.56E-06,0,0,3
reigning,2,3.67E-06,2,4.56E-06,0,0,2
tractors,2,3.67E-06,2,4.56E-06,0,0,2
utter,2,3.67E-06,2,4.56E-06,0,0,2
herschel,2,3.67E-06,2,4.56E-06,0,0,2
daylight,2,3.67E-06,2,4.56E-06,0,0,2
slowdown,2,3.67E-06,2,4.56E-06,0,0,2
kayleigh,2,3.67E-06,2,4.56E-06,0,0,2
fiercely,2,3.67E-06,2,4.56E-06,0,0,3
averages,2,3.67E-06,2,4.56E-06,0,0,3
flocking,2,3.67E-06,2,4.56E-06,0,0,2
suburbia,2,3.67E-06,2,4.56E-06,0,0,3
smashing,2,3.67E-06,2,4.56E-06,0,0,2
deleting,2,3.67E-06,2,4.56E-06,0,0,3
massacre,2,3.67E-06,2,4.56E-06,0,0,2
honestly,2,3.67E-06,2,4.56E-06,0,0,3
shambles,2,3.67E-06,2,4.56E-06,0,0,2
favoring,2,3.67E-06,2,4.56E-06,0,0,3
troubled,2,3.67E-06,2,4.56E-06,0,0,1
destined,2,3.67E-06,2,4.56E-06,0,0,2
contents,2,3.67E-06,2,4.56E-06,0,0,2
locally,2,3.67E-06,2,4.56E-06,0,0,3
stations,2,3.67E-06,2,4.56E-06,0,0,2
uplifted,2,3.67E-06,2,4.56E-06,0,0,2
scenario,2,3.67E-06,2,4.56E-06,0,0,3
farmersa,2,3.67E-06,2,4.56E-06,0,0,3
equipped,2,3.67E-06,2,4.56E-06,0,0,2
clicking,2,3.67E-06,2,4.56E-06,0,0,2
matts,2,3.67E-06,2,4.56E-06,0,0,1
atkinson,2,3.67E-06,2,4.56E-06,0,0,3
outright,2,3.67E-06,2,4.56E-06,0,0,2
dedicate,2,3.67E-06,2,4.56E-06,0,0,3
deletion,2,3.67E-06,2,4.56E-06,0,0,3
presided,2,3.67E-06,2,4.56E-06,0,0,2
lifelong,2,3.67E-06,2,4.56E-06,0,0,3
confused,2,3.67E-06,2,4.56E-06,0,0,2
gonzales,2,3.67E-06,2,4.56E-06,0,0,3
arranged,2,3.67E-06,2,4.56E-06,0,0,2
goodell,2,3.67E-06,2,4.56E-06,0,0,2
nothings,2,3.67E-06,2,4.56E-06,0,0,2
railroad,2,3.67E-06,2,4.56E-06,0,0,2
indicate,2,3.67E-06,2,4.56E-06,0,0,3
marjorie,2,3.67E-06,2,4.56E-06,0,0,3
benghazi,2,3.67E-06,2,4.56E-06,0,0,3
pullout,2,3.67E-06,2,4.56E-06,0,0,2
relaxing,2,3.67E-06,2,4.56E-06,0,0,3
gruesome,2,3.67E-06,2,4.56E-06,0,0,2
creature,2,3.67E-06,2,4.56E-06,0,0,2
teamwork,2,3.67E-06,2,4.56E-06,0,0,2
drooling,2,3.67E-06,2,4.56E-06,0,0,2
elevated,2,3.67E-06,2,4.56E-06,0,0,3
identify,2,3.67E-06,2,4.56E-06,0,0,4
regulate,2,3.67E-06,2,4.56E-06,0,0,3
stellar,2,3.67E-06,2,4.56E-06,0,0,2
trounced,2,3.67E-06,2,4.56E-06,0,0,1
promptly,2,3.67E-06,2,4.56E-06,0,0,2
delaware,2,3.67E-06,2,4.56E-06,0,0,3
sympathy,2,3.67E-06,2,4.56E-06,0,0,3
resident,2,3.67E-06,2,4.56E-06,0,0,3
offenses,2,3.67E-06,2,4.56E-06,0,0,2
conspire,2,3.67E-06,2,4.56E-06,0,0,2
towering,2,3.67E-06,2,4.56E-06,0,0,3
sterling,2,3.67E-06,2,4.56E-06,0,0,2
ginsburg,2,3.67E-06,2,4.56E-06,0,0,2
appeared,2,3.67E-06,2,4.56E-06,0,0,2
estimate,2,3.67E-06,2,4.56E-06,0,0,3
engaging,2,3.67E-06,2,4.56E-06,0,0,3
rallying,2,3.67E-06,0,0,1.89E-05,2,2
majestic,2,3.67E-06,2,4.56E-06,0,0,3
rotten,2,3.67E-06,2,4.56E-06,0,0,2
bullying,2,3.67E-06,1,2.28E-06,9.47E-06,1,2
pleading,2,3.67E-06,2,4.56E-06,0,0,2
tropical,2,3.67E-06,2,4.56E-06,0,0,3
hoodlums,2,3.67E-06,2,4.56E-06,0,0,2
relevant,2,3.67E-06,2,4.56E-06,0,0,3
airplane,2,3.67E-06,2,4.56E-06,0,0,2
steroids,2,3.67E-06,2,4.56E-06,0,0,2
lovingly,2,3.67E-06,2,4.56E-06,0,0,3
doctored,2,3.67E-06,2,4.56E-06,0,0,2
goldberg,2,3.67E-06,2,4.56E-06,0,0,2
comrades,2,3.67E-06,2,4.56E-06,0,0,2
smearing,2,3.67E-06,2,4.56E-06,0,0,2
reviewed,2,3.67E-06,2,4.56E-06,0,0,2
airspace,2,3.67E-06,2,4.56E-06,0,0,2
gretchen,2,3.67E-06,2,4.56E-06,0,0,2
davidson,2,3.67E-06,2,4.56E-06,0,0,3
presides,2,3.67E-06,2,4.56E-06,0,0,2
ethiopia,2,3.67E-06,2,4.56E-06,0,0,3
fearless,2,3.67E-06,2,4.56E-06,0,0,2
villains,2,3.67E-06,2,4.56E-06,0,0,2
mcmorris,2,3.67E-06,2,4.56E-06,0,0,2
newhouse,2,3.67E-06,2,4.56E-06,0,0,2
samantha,2,3.67E-06,2,4.56E-06,0,0,3
colombia,2,3.67E-06,2,4.56E-06,0,0,3
backbone,2,3.67E-06,2,4.56E-06,0,0,2
quantico,2,3.67E-06,2,4.56E-06,0,0,3
pioneers,2,3.67E-06,2,4.56E-06,0,0,2
unsolved,2,3.67E-06,2,4.56E-06,0,0,2
notching,2,3.67E-06,2,4.56E-06,0,0,2
quarters,2,3.67E-06,2,4.56E-06,0,0,2
analysts,2,3.67E-06,2,4.56E-06,0,0,3
unlocked,2,3.67E-06,2,4.56E-06,0,0,2
broadway,2,3.67E-06,2,4.56E-06,0,0,2
cadillac,2,3.67E-06,2,4.56E-06,0,0,3
freedoms,2,3.67E-06,2,4.56E-06,0,0,2
closures,2,3.67E-06,2,4.56E-06,0,0,2
installs,2,3.67E-06,2,4.56E-06,0,0,2
godspeed,2,3.67E-06,2,4.56E-06,0,0,2
pointing,2,3.67E-06,2,4.56E-06,0,0,2
sweeping,2,3.67E-06,2,4.56E-06,0,0,2
tourists,2,3.67E-06,2,4.56E-06,0,0,2
delaying,2,3.67E-06,2,4.56E-06,0,0,3
remnants,2,3.67E-06,2,4.56E-06,0,0,2
whistles,2,3.67E-06,2,4.56E-06,0,0,2
defenses,2,3.67E-06,2,4.56E-06,0,0,2
golsteyn,2,3.67E-06,2,4.56E-06,0,0,2
overrode,2,3.67E-06,2,4.56E-06,0,0,3
marshall,2,3.67E-06,2,4.56E-06,0,0,2
sullivan,2,3.67E-06,2,4.56E-06,0,0,3
scathing,2,3.67E-06,2,4.56E-06,0,0,2
remedied,2,3.67E-06,2,4.56E-06,0,0,3
activism,2,3.67E-06,2,4.56E-06,0,0,3
barracks,2,3.67E-06,2,4.56E-06,0,0,2
festival,2,3.67E-06,2,4.56E-06,0,0,3
cemetary,2,3.67E-06,2,4.56E-06,0,0,4
coliseum,2,3.67E-06,2,4.56E-06,0,0,3
ballgame,2,3.67E-06,2,4.56E-06,0,0,2
wrecking,2,3.67E-06,2,4.56E-06,0,0,2
missoula,2,3.67E-06,2,4.56E-06,0,0,3
leftists,2,3.67E-06,2,4.56E-06,0,0,2
cherokee,2,3.67E-06,2,4.56E-06,0,0,3
deserted,2,3.67E-06,2,4.56E-06,0,0,2
pharmacy,2,3.67E-06,2,4.56E-06,0,0,3
supplied,2,3.67E-06,2,4.56E-06,0,0,2
abruptly,2,3.67E-06,2,4.56E-06,0,0,3
seizures,2,3.67E-06,2,4.56E-06,0,0,2
implying,2,3.67E-06,2,4.56E-06,0,0,2
bragging,2,3.67E-06,2,4.56E-06,0,0,2
oligarch,2,3.67E-06,2,4.56E-06,0,0,3
proceeds,2,3.67E-06,2,4.56E-06,0,0,2
utilized,2,3.67E-06,2,4.56E-06,0,0,3
distrust,2,3.67E-06,2,4.56E-06,0,0,2
newsroom,2,3.67E-06,2,4.56E-06,0,0,2
servants,2,3.67E-06,2,4.56E-06,0,0,2
rightful,2,3.67E-06,2,4.56E-06,0,0,2
assuming,2,3.67E-06,2,4.56E-06,0,0,3
unforced,2,3.67E-06,2,4.56E-06,0,0,2
bethpage,2,3.67E-06,2,4.56E-06,0,0,2
thinkers,2,3.67E-06,2,4.56E-06,0,0,2
timeless,2,3.67E-06,2,4.56E-06,0,0,3
clifford,2,3.67E-06,2,4.56E-06,0,0,2
freshman,2,3.67E-06,2,4.56E-06,0,0,2
getter,2,3.67E-06,2,4.56E-06,0,0,2
lobbying,2,3.67E-06,2,4.56E-06,0,0,2
contacts,2,3.67E-06,2,4.56E-06,0,0,2
probable,2,3.67E-06,2,4.56E-06,0,0,3
varadkar,2,3.67E-06,2,4.56E-06,0,0,3
mediocre,2,3.67E-06,2,4.56E-06,0,0,2
insecure,2,3.67E-06,2,4.56E-06,0,0,3
declares,2,3.67E-06,2,4.56E-06,0,0,2
decaying,2,3.67E-06,2,4.56E-06,0,0,3
wounding,2,3.67E-06,2,4.56E-06,0,0,2
outreach,2,3.67E-06,2,4.56E-06,0,0,2
trampled,2,3.67E-06,2,4.56E-06,0,0,1
appalled,2,3.67E-06,2,4.56E-06,0,0,2
clearing,2,3.67E-06,2,4.56E-06,0,0,2
wonerful,2,3.67E-06,2,4.56E-06,0,0,3
suspends,2,3.67E-06,2,4.56E-06,0,0,2
globally,2,3.67E-06,2,4.56E-06,0,0,3
electing,2,3.67E-06,2,4.56E-06,0,0,3
policing,2,3.67E-06,2,4.56E-06,0,0,3
socially,2,3.67E-06,2,4.56E-06,0,0,3
incident,2,3.67E-06,2,4.56E-06,0,0,3
investor,2,3.67E-06,2,4.56E-06,0,0,3
bahamian,2,3.67E-06,2,4.56E-06,0,0,3
landfall,2,3.67E-06,2,4.56E-06,0,0,2
giuseppe,2,3.67E-06,2,4.56E-06,0,0,2
wheedled,2,3.67E-06,2,4.56E-06,0,0,1
humanely,2,3.67E-06,2,4.56E-06,0,0,4
unbiased,2,3.67E-06,2,4.56E-06,0,0,2
friedman,2,3.67E-06,2,4.56E-06,0,0,2
relocate,2,3.67E-06,2,4.56E-06,0,0,3
sikorsky,2,3.67E-06,2,4.56E-06,0,0,3
rossello,2,3.67E-06,2,4.56E-06,0,0,3
strained,2,3.67E-06,2,4.56E-06,0,0,1
rainfall,2,3.67E-06,2,4.56E-06,0,0,2
khamenei,2,3.67E-06,2,4.56E-06,0,0,3
swampman,2,3.67E-06,2,4.56E-06,0,0,2
smallest,2,3.67E-06,2,4.56E-06,0,0,2
managing,2,3.67E-06,2,4.56E-06,0,0,3
firemans,2,3.67E-06,2,4.56E-06,0,0,3
obsessed,2,3.67E-06,2,4.56E-06,0,0,2
illusion,2,3.67E-06,2,4.56E-06,0,0,3
calexico,2,3.67E-06,2,4.56E-06,0,0,4
unusable,2,3.67E-06,2,4.56E-06,0,0,4
abramson,2,3.67E-06,2,4.56E-06,0,0,3
cite,2,3.67E-06,2,4.56E-06,0,0,1
units,2,3.67E-06,0,0,1.89E-05,2,2
suits,2,3.67E-06,1,2.28E-06,9.47E-06,1,1
audit,2,3.67E-06,2,4.56E-06,0,0,2
loretta,2,3.67E-06,0,0,1.89E-05,2,3
itbut,2,3.67E-06,2,4.56E-06,0,0,2
items,2,3.67E-06,2,4.56E-06,0,0,2
gutting,2,3.67E-06,1,2.28E-06,9.47E-06,1,2
swalwell,2,3.67E-06,2,4.56E-06,0,0,2
anguilla,2,3.67E-06,2,4.56E-06,0,0,3
split,2,3.67E-06,2,4.56E-06,0,0,1
gitmo,2,3.67E-06,2,4.56E-06,0,0,2
bites,2,3.67E-06,2,4.56E-06,0,0,1
legit,2,3.67E-06,2,4.56E-06,0,0,2
edited,2,3.67E-06,1,2.28E-06,9.47E-06,1,2
marillyn,2,3.67E-06,2,4.56E-06,0,0,3
whites,2,3.67E-06,1,2.28E-06,9.47E-06,1,1
uttered,2,3.67E-06,2,4.56E-06,0,0,2
bellavia,2,3.67E-06,2,4.56E-06,0,0,3
citing,2,3.67E-06,1,2.28E-06,9.47E-06,1,2
tatters,2,3.67E-06,2,4.56E-06,0,0,2
titled,2,3.67E-06,0,0,1.89E-05,2,1
boycott,2,3.67E-06,2,4.56E-06,0,0,2
reddit,2,3.67E-06,0,0,1.89E-05,2,2
glitch,2,3.67E-06,2,4.56E-06,0,0,1
bennett,2,3.67E-06,2,4.56E-06,0,0,2
kuwait,2,3.67E-06,2,4.56E-06,0,0,2
sanity,2,3.67E-06,2,4.56E-06,0,0,3
biting,2,3.67E-06,2,4.56E-06,0,0,2
ballabon,2,3.67E-06,2,4.56E-06,0,0,3
pitched,2,3.67E-06,0,0,1.89E-05,2,1
mariannette,2,3.67E-06,2,4.56E-06,0,0,3
allergies,2,3.67E-06,0,0,1.89E-05,2,3
buffetts,2,3.67E-06,0,0,1.89E-05,2,2
illnesses,2,3.67E-06,2,4.56E-06,0,0,2
churchill,2,3.67E-06,2,4.56E-06,0,0,2
obesity,2,3.67E-06,0,0,1.89E-05,2,4
initial,2,3.67E-06,2,4.56E-06,0,0,3
website,2,3.67E-06,2,4.56E-06,0,0,2
intellect,2,3.67E-06,2,4.56E-06,0,0,3
mattered,2,3.67E-06,2,4.56E-06,0,0,2
traitor,2,3.67E-06,2,4.56E-06,0,0,2
permits,2,3.67E-06,2,4.56E-06,0,0,2
prohibit,2,3.67E-06,1,2.28E-06,9.47E-06,1,3
naturally,2,3.67E-06,2,4.56E-06,0,0,4
limiting,2,3.67E-06,1,2.28E-06,9.47E-06,1,3
slimeball,2,3.67E-06,2,4.56E-06,0,0,3
attached,2,3.67E-06,2,4.56E-06,0,0,2
softballs,2,3.67E-06,2,4.56E-06,0,0,2
travelled,2,3.67E-06,2,4.56E-06,0,0,2
spirited,2,3.67E-06,1,2.28E-06,9.47E-06,1,2
plotting,2,3.67E-06,2,4.56E-06,0,0,2
schuette,2,3.67E-06,2,4.56E-06,0,0,1
collected,2,3.67E-06,2,4.56E-06,0,0,2
billionyr,2,3.67E-06,2,4.56E-06,0,0,3
colluding,2,3.67E-06,2,4.56E-06,0,0,3
collision,2,3.67E-06,2,4.56E-06,0,0,3
writings,2,3.67E-06,1,2.28E-06,9.47E-06,1,2
cellphone,2,3.67E-06,2,4.56E-06,0,0,2
schilling,2,3.67E-06,2,4.56E-06,0,0,2
smollett,2,3.67E-06,2,4.56E-06,0,0,2
ayatollah,2,3.67E-06,2,4.56E-06,0,0,4
visitors,2,3.67E-06,1,2.28E-06,9.47E-06,1,3
withdrew,2,3.67E-06,2,4.56E-06,0,0,2
shuttered,2,3.67E-06,2,4.56E-06,0,0,2
compelling,2,3.67E-06,1,2.28E-06,9.47E-06,1,3
attracted,2,3.67E-06,2,4.56E-06,0,0,2
attkisson,2,3.67E-06,2,4.56E-06,0,0,3
politico,2,3.67E-06,2,4.56E-06,0,0,4
fellowship,2,3.67E-06,0,0,1.89E-05,2,3
switched,2,3.67E-06,2,4.56E-06,0,0,1
unedited,2,3.67E-06,2,4.56E-06,0,0,3
expedite,2,3.67E-06,2,4.56E-06,0,0,3
fatality,2,3.67E-06,2,4.56E-06,0,0,4
surveilled,2,3.67E-06,2,4.56E-06,0,0,2
collection,2,3.67E-06,2,4.56E-06,0,0,3
buttigieg,2,3.67E-06,2,4.56E-06,0,0,3
cancelling,2,3.67E-06,2,4.56E-06,0,0,3
huntsville,2,3.67E-06,2,4.56E-06,0,0,2
shellacked,2,3.67E-06,2,4.56E-06,0,0,2
peacefully,2,3.67E-06,2,4.56E-06,0,0,4
gallaghers,2,3.67E-06,2,4.56E-06,0,0,3
reunited,2,3.67E-06,2,4.56E-06,0,0,2
lafayette,2,3.67E-06,2,4.56E-06,0,0,3
scattered,2,3.67E-06,2,4.56E-06,0,0,2
schitt,2,3.67E-06,2,4.56E-06,0,0,1
aptitude,2,3.67E-06,2,4.56E-06,0,0,3
faithful,2,3.67E-06,2,4.56E-06,0,0,2
resettled,2,3.67E-06,2,4.56E-06,0,0,2
capitals,2,3.67E-06,2,4.56E-06,0,0,3
traitors,2,3.67E-06,2,4.56E-06,0,0,2
alligators,2,3.67E-06,2,4.56E-06,0,0,4
atrocity,2,3.67E-06,2,4.56E-06,0,0,4
haitians,2,3.67E-06,2,4.56E-06,0,0,2
settlement,2,3.67E-06,1,2.28E-06,9.47E-06,1,3
collecting,2,3.67E-06,2,4.56E-06,0,0,3
omitted,2,3.67E-06,1,2.28E-06,9.47E-06,1,2
bullshit,2,3.67E-06,2,4.56E-06,0,0,2
millionaire,2,3.67E-06,0,0,1.89E-05,2,3
marshmallow,2,3.67E-06,0,0,1.89E-05,2,3
shattering,2,3.67E-06,2,4.56E-06,0,0,3
twitters,2,3.67E-06,2,4.56E-06,0,0,2
tallahassee,2,3.67E-06,2,4.56E-06,0,0,4
unilaterally,2,3.67E-06,1,2.28E-06,9.47E-06,1,6
combatting,2,3.67E-06,2,4.56E-06,0,0,3
attributed,2,3.67E-06,2,4.56E-06,0,0,3
unofficially,2,3.67E-06,2,4.56E-06,0,0,5
brigitte,2,3.67E-06,2,4.56E-06,0,0,2
illegality,2,3.67E-06,2,4.56E-06,0,0,5
battlefields,2,3.67E-06,2,4.56E-06,0,0,3
billionmonth,2,3.67E-06,2,4.56E-06,0,0,3
maternity,2,3.67E-06,0,0,1.89E-05,2,4
respectfully,2,3.67E-06,2,4.56E-06,0,0,4
irrationally,2,3.67E-06,2,4.56E-06,0,0,5
ambitious,2,3.67E-06,1,2.28E-06,9.47E-06,1,4
luxuryits,2,3.67E-06,0,0,1.89E-05,2,3
unforgettable,2,3.67E-06,2,4.56E-06,0,0,5
collaboration,2,3.67E-06,1,2.28E-06,9.47E-06,1,5
exceptionally,2,3.67E-06,2,4.56E-06,0,0,5
diplomatically,2,3.67E-06,2,4.56E-06,0,0,6
fortitude,2,3.67E-06,1,2.28E-06,9.47E-06,1,3
benefited,2,3.67E-06,1,2.28E-06,9.47E-06,1,3
solicited,2,3.67E-06,2,4.56E-06,0,0,3
solicitor,2,3.67E-06,2,4.56E-06,0,0,4
pulitzers,2,3.67E-06,2,4.56E-06,0,0,3
additions,2,3.67E-06,2,4.56E-06,0,0,3
depravity,2,3.67E-06,2,4.56E-06,0,0,4
qualities,2,3.67E-06,2,4.56E-06,0,0,3
antitrust,2,3.67E-06,2,4.56E-06,0,0,3
hostility,2,3.67E-06,2,4.56E-06,0,0,4
reiterate,2,3.67E-06,2,4.56E-06,0,0,3
composite,2,3.67E-06,2,4.56E-06,0,0,3
generosity,2,3.67E-06,1,2.28E-06,9.47E-06,1,5
recruiting,2,3.67E-06,0,0,1.89E-05,2,3
neutrality,2,3.67E-06,1,2.28E-06,9.47E-06,1,4
affidavits,2,3.67E-06,2,4.56E-06,0,0,4
revitalize,2,3.67E-06,2,4.56E-06,0,0,4
institutes,2,3.67E-06,2,4.56E-06,0,0,3
facilitate,2,3.67E-06,2,4.56E-06,0,0,4
demolition,2,3.67E-06,2,4.56E-06,0,0,4
charitable,2,3.67E-06,2,4.56E-06,0,0,4
immune,2,3.67E-06,2,4.56E-06,0,0,2
fitzgerald,2,3.67E-06,2,4.56E-06,0,0,3
bother,2,3.67E-06,2,4.56E-06,0,0,2
criticizes,2,3.67E-06,2,4.56E-06,0,0,3
litigation,2,3.67E-06,2,4.56E-06,0,0,4
atrocities,2,3.67E-06,2,4.56E-06,0,0,4
militarily,2,3.67E-06,2,4.56E-06,0,0,5
fictitious,2,3.67E-06,2,4.56E-06,0,0,4
mathew,2,3.67E-06,2,4.56E-06,0,0,2
withdrawal,2,3.67E-06,2,4.56E-06,0,0,3
visibility,2,3.67E-06,2,4.56E-06,0,0,5
capitalist,2,3.67E-06,2,4.56E-06,0,0,4
therapy,2,3.67E-06,1,2.28E-06,9.47E-06,1,3
profitable,2,3.67E-06,2,4.56E-06,0,0,4
territories,2,3.67E-06,1,2.28E-06,9.47E-06,1,4
yovanovitch,2,3.67E-06,2,4.56E-06,0,0,4
criticizing,2,3.67E-06,2,4.56E-06,0,0,4
withdrawing,2,3.67E-06,2,4.56E-06,0,0,3
healthier,2,3.67E-06,1,2.28E-06,9.47E-06,1,2
obtaining,2,3.67E-06,1,2.28E-06,9.47E-06,1,3
mandatory,2,3.67E-06,1,2.28E-06,9.47E-06,1,4
uncertain,2,3.67E-06,0,0,1.89E-05,2,3
combating,2,3.67E-06,1,2.28E-06,9.47E-06,1,3
powerless,2,3.67E-06,1,2.28E-06,9.47E-06,1,3
constitutes,2,3.67E-06,2,4.56E-06,0,0,3
healthbut,2,3.67E-06,0,0,1.89E-05,2,2
capitalized,2,3.67E-06,2,4.56E-06,0,0,4
countdown,2,3.67E-06,0,0,1.89E-05,2,2
reforming,2,3.67E-06,0,0,1.89E-05,2,3
tolerance,2,3.67E-06,0,0,1.89E-05,2,3
struggled,2,3.67E-06,1,2.28E-06,9.47E-06,1,1
borrowers,2,3.67E-06,0,0,1.89E-05,2,3
repealers,2,3.67E-06,0,0,1.89E-05,2,3
realistic,2,3.67E-06,1,2.28E-06,9.47E-06,1,3
punishing,2,3.67E-06,1,2.28E-06,9.47E-06,1,3
contracts,2,3.67E-06,1,2.28E-06,9.47E-06,1,2
priceless,2,3.67E-06,1,2.28E-06,9.47E-06,1,3
groceries,2,3.67E-06,0,0,1.89E-05,2,3
pregnancy,2,3.67E-06,0,0,1.89E-05,2,3
averaging,2,3.67E-06,0,0,1.89E-05,2,4
diagnosed,2,3.67E-06,0,0,1.89E-05,2,2
disrupted,2,3.67E-06,0,0,1.89E-05,2,2
providers,2,3.67E-06,1,2.28E-06,9.47E-06,1,3
pendleton,2,3.67E-06,0,0,1.89E-05,2,3
generated,2,3.67E-06,0,0,1.89E-05,2,3
sidelines,2,3.67E-06,0,0,1.89E-05,2,3
steadfast,2,3.67E-06,1,2.28E-06,9.47E-06,1,2
aftermath,2,3.67E-06,1,2.28E-06,9.47E-06,1,3
unveiling,2,3.67E-06,0,0,1.89E-05,2,3
shrinking,2,3.67E-06,0,0,1.89E-05,2,2
repackage,2,3.67E-06,0,0,1.89E-05,2,3
exploding,2,3.67E-06,0,0,1.89E-05,2,3
dignified,2,3.67E-06,1,2.28E-06,9.47E-06,1,3
statutory,2,3.67E-06,1,2.28E-06,9.47E-06,1,4
debatebut,2,3.67E-06,0,0,1.89E-05,2,4
outlawing,2,3.67E-06,0,0,1.89E-05,2,3
specifics,2,3.67E-06,0,0,1.89E-05,2,3
toughness,2,3.67E-06,1,2.28E-06,9.47E-06,1,2
defensive,2,3.67E-06,1,2.28E-06,9.47E-06,1,3
saturdays,2,3.67E-06,0,0,1.89E-05,2,3
reciprocity,2,3.67E-06,2,4.56E-06,0,0,5
offensive,2,3.67E-06,1,2.28E-06,9.47E-06,1,3
handshake,2,3.67E-06,1,2.28E-06,9.47E-06,1,2
instagram,2,3.67E-06,1,2.28E-06,9.47E-06,1,3
continent,2,3.67E-06,1,2.28E-06,9.47E-06,1,3
stalemate,2,3.67E-06,1,2.28E-06,9.47E-06,1,3
mortgages,2,3.67E-06,0,0,1.89E-05,2,2
severance,2,3.67E-06,0,0,1.89E-05,2,3
persevere,2,3.67E-06,0,0,1.89E-05,2,3
searching,2,3.67E-06,1,2.28E-06,9.47E-06,1,2
enjoyment,2,3.67E-06,1,2.28E-06,9.47E-06,1,3
expenditure,2,3.67E-06,2,4.56E-06,0,0,4
bandwagon,2,3.67E-06,1,2.28E-06,9.47E-06,1,3
candidacy,2,3.67E-06,1,2.28E-06,9.47E-06,1,4
staircase,2,3.67E-06,1,2.28E-06,9.47E-06,1,2
designers,2,3.67E-06,1,2.28E-06,9.47E-06,1,3
chocolate,2,3.67E-06,1,2.28E-06,9.47E-06,1,3
responses,2,3.67E-06,1,2.28E-06,9.47E-06,1,2
nominates,2,3.67E-06,1,2.28E-06,9.47E-06,1,3
norwegian,2,3.67E-06,1,2.28E-06,9.47E-06,1,3
forbidden,2,3.67E-06,1,2.28E-06,9.47E-06,1,3
paychecks,2,3.67E-06,1,2.28E-06,9.47E-06,1,2
stephanie,2,3.67E-06,1,2.28E-06,9.47E-06,1,3
politicized,2,3.67E-06,2,4.56E-06,0,0,4
prospects,2,3.67E-06,1,2.28E-06,9.47E-06,1,2
modernize,2,3.67E-06,1,2.28E-06,9.47E-06,1,3
resulting,2,3.67E-06,1,2.28E-06,9.47E-06,1,3
murkowski,2,3.67E-06,1,2.28E-06,9.47E-06,1,3
advocated,2,3.67E-06,1,2.28E-06,9.47E-06,1,3
prevailed,2,3.67E-06,1,2.28E-06,9.47E-06,1,2
reaffirms,2,3.67E-06,1,2.28E-06,9.47E-06,1,2
guardians,2,3.67E-06,2,4.56E-06,0,0,2
admission,2,3.67E-06,2,4.56E-06,0,0,3
intrusion,2,3.67E-06,2,4.56E-06,0,0,3
protocols,2,3.67E-06,2,4.56E-06,0,0,3
shielding,2,3.67E-06,2,4.56E-06,0,0,2
liberties,2,3.67E-06,2,4.56E-06,0,0,3
travelers,2,3.67E-06,2,4.56E-06,0,0,3
indonesia,2,3.67E-06,2,4.56E-06,0,0,4
assisting,2,3.67E-06,2,4.56E-06,0,0,3
overwhelm,2,3.67E-06,2,4.56E-06,0,0,3
treachery,2,3.67E-06,2,4.56E-06,0,0,3
prosperityor,2,3.67E-06,2,4.56E-06,0,0,4
genevieve,2,3.67E-06,2,4.56E-06,0,0,3
predators,2,3.67E-06,2,4.56E-06,0,0,3
establish,2,3.67E-06,2,4.56E-06,0,0,3
constitutions,2,3.67E-06,2,4.56E-06,0,0,4
monologue,2,3.67E-06,2,4.56E-06,0,0,4
crossfire,2,3.67E-06,2,4.56E-06,0,0,2
henderson,2,3.67E-06,2,4.56E-06,0,0,3
catanzara,2,3.67E-06,2,4.56E-06,0,0,4
petroleum,2,3.67E-06,2,4.56E-06,0,0,3
impulsive,2,3.67E-06,2,4.56E-06,0,0,3
carolinas,2,3.67E-06,2,4.56E-06,0,0,4
streaming,2,3.67E-06,2,4.56E-06,0,0,2
goodstein,2,3.67E-06,2,4.56E-06,0,0,2
unleashes,2,3.67E-06,2,4.56E-06,0,0,2
civilized,2,3.67E-06,2,4.56E-06,0,0,3
protested,2,3.67E-06,2,4.56E-06,0,0,2
inspected,2,3.67E-06,2,4.56E-06,0,0,2
outpacing,2,3.67E-06,2,4.56E-06,0,0,3
denigrate,2,3.67E-06,2,4.56E-06,0,0,3
misquoted,2,3.67E-06,2,4.56E-06,0,0,2
devaluing,2,3.67E-06,2,4.56E-06,0,0,3
presiding,2,3.67E-06,2,4.56E-06,0,0,3
treasurer,2,3.67E-06,2,4.56E-06,0,0,3
caribbean,2,3.67E-06,2,4.56E-06,0,0,3
safeguard,2,3.67E-06,2,4.56E-06,0,0,3
madeleine,2,3.67E-06,2,4.56E-06,0,0,3
practitioners,2,3.67E-06,2,4.56E-06,0,0,4
incumbent,2,3.67E-06,2,4.56E-06,0,0,3
published,2,3.67E-06,2,4.56E-06,0,0,2
broadband,2,3.67E-06,2,4.56E-06,0,0,2
container,2,3.67E-06,2,4.56E-06,0,0,3
confidentiality,2,3.67E-06,2,4.56E-06,0,0,6
tarnished,2,3.67E-06,2,4.56E-06,0,0,2
platforms,2,3.67E-06,2,4.56E-06,0,0,2
confusion,2,3.67E-06,2,4.56E-06,0,0,3
constitutionality,2,3.67E-06,2,4.56E-06,0,0,7
populated,2,3.67E-06,2,4.56E-06,0,0,3
sequester,2,3.67E-06,2,4.56E-06,0,0,3
pardoning,2,3.67E-06,2,4.56E-06,0,0,3
backfired,2,3.67E-06,2,4.56E-06,0,0,2
instincts,2,3.67E-06,2,4.56E-06,0,0,2
stumbling,2,3.67E-06,2,4.56E-06,0,0,2
vengeance,2,3.67E-06,2,4.56E-06,0,0,2
memorials,2,3.67E-06,2,4.56E-06,0,0,3
affirming,2,3.67E-06,2,4.56E-06,0,0,3
chinatown,2,3.67E-06,2,4.56E-06,0,0,3
vandalize,2,3.67E-06,2,4.56E-06,0,0,3
transform,2,3.67E-06,2,4.56E-06,0,0,2
explosive,2,3.67E-06,2,4.56E-06,0,0,3
jefferson,2,3.67E-06,2,4.56E-06,0,0,3
adversary,2,3.67E-06,2,4.56E-06,0,0,4
execution,2,3.67E-06,2,4.56E-06,0,0,4
purchased,2,3.67E-06,2,4.56E-06,0,0,2
mongering,2,3.67E-06,2,4.56E-06,0,0,3
sarcastic,2,3.67E-06,2,4.56E-06,0,0,3
computers,2,3.67E-06,2,4.56E-06,0,0,3
clarified,2,3.67E-06,2,4.56E-06,0,0,3
described,2,3.67E-06,2,4.56E-06,0,0,2
weinstein,2,3.67E-06,2,4.56E-06,0,0,2
cutreform,2,3.67E-06,2,4.56E-06,0,0,3
surviving,2,3.67E-06,2,4.56E-06,0,0,3
recording,2,3.67E-06,2,4.56E-06,0,0,3
chemistry,2,3.67E-06,2,4.56E-06,0,0,3
craziness,2,3.67E-06,2,4.56E-06,0,0,3
elevation,2,3.67E-06,2,4.56E-06,0,0,4
inventing,2,3.67E-06,2,4.56E-06,0,0,3
analyzing,2,3.67E-06,2,4.56E-06,0,0,4
reluctant,2,3.67E-06,2,4.56E-06,0,0,3
conquests,2,3.67E-06,2,4.56E-06,0,0,2
ushistory,2,3.67E-06,2,4.56E-06,0,0,4
defrauded,2,3.67E-06,2,4.56E-06,0,0,2
indignant,2,3.67E-06,2,4.56E-06,0,0,3
poisoning,2,3.67E-06,2,4.56E-06,0,0,3
belichick,2,3.67E-06,2,4.56E-06,0,0,3
spotlight,2,3.67E-06,2,4.56E-06,0,0,2
groveling,2,3.67E-06,2,4.56E-06,0,0,3
weakening,2,3.67E-06,2,4.56E-06,0,0,3
residence,2,3.67E-06,2,4.56E-06,0,0,3
partisans,2,3.67E-06,2,4.56E-06,0,0,3
sebastian,2,3.67E-06,2,4.56E-06,0,0,3
buddhists,2,3.67E-06,2,4.56E-06,0,0,2
headaches,2,3.67E-06,2,4.56E-06,0,0,2
blackburn,2,3.67E-06,2,4.56E-06,0,0,2
consulate,2,3.67E-06,2,4.56E-06,0,0,3
panhandle,2,3.67E-06,2,4.56E-06,0,0,3
screamers,2,3.67E-06,2,4.56E-06,0,0,2
greetings,2,3.67E-06,2,4.56E-06,0,0,2
deporting,2,3.67E-06,2,4.56E-06,0,0,3
loyalists,2,3.67E-06,2,4.56E-06,0,0,3
assistant,2,3.67E-06,2,4.56E-06,0,0,3
magnified,2,3.67E-06,2,4.56E-06,0,0,3
emotional,2,3.67E-06,2,4.56E-06,0,0,4
tarkanian,2,3.67E-06,2,4.56E-06,0,0,3
tolerated,2,3.67E-06,2,4.56E-06,0,0,3
structure,2,3.67E-06,2,4.56E-06,0,0,2
procedure,2,3.67E-06,2,4.56E-06,0,0,3
adjusting,2,3.67E-06,2,4.56E-06,0,0,3
reversing,2,3.67E-06,2,4.56E-06,0,0,3
successor,2,3.67E-06,2,4.56E-06,0,0,3
whereupon,2,3.67E-06,2,4.56E-06,0,0,3
reseached,2,3.67E-06,2,4.56E-06,0,0,2
ambiguous,2,3.67E-06,2,4.56E-06,0,0,4
showtrial,2,3.67E-06,2,4.56E-06,0,0,2
sidewalks,2,3.67E-06,2,4.56E-06,0,0,3
resigning,2,3.67E-06,2,4.56E-06,0,0,3
lexington,2,3.67E-06,2,4.56E-06,0,0,3
disposing,2,3.67E-06,2,4.56E-06,0,0,3
smuggling,2,3.67E-06,2,4.56E-06,0,0,2
europeans,2,3.67E-06,2,4.56E-06,0,0,3
quicksand,2,3.67E-06,2,4.56E-06,0,0,2
mcaleenan,2,3.67E-06,2,4.56E-06,0,0,3
schweizer,2,3.67E-06,2,4.56E-06,0,0,2
pertained,2,3.67E-06,2,4.56E-06,0,0,2
fairytale,2,3.67E-06,2,4.56E-06,0,0,4
suppliers,2,3.67E-06,2,4.56E-06,0,0,2
oligarchs,2,3.67E-06,2,4.56E-06,0,0,3
deceiving,2,3.67E-06,2,4.56E-06,0,0,3
brazilian,2,3.67E-06,2,4.56E-06,0,0,3
scenarios,2,3.67E-06,2,4.56E-06,0,0,3
columnist,2,3.67E-06,2,4.56E-06,0,0,3
importers,2,3.67E-06,2,4.56E-06,0,0,3
explosion,2,3.67E-06,2,4.56E-06,0,0,3
miserable,2,3.67E-06,2,4.56E-06,0,0,4
jamestown,2,3.67E-06,2,4.56E-06,0,0,3
consuming,2,3.67E-06,2,4.56E-06,0,0,3
aerospace,2,3.67E-06,2,4.56E-06,0,0,3
escalator,2,3.67E-06,2,4.56E-06,0,0,4
formation,2,3.67E-06,2,4.56E-06,0,0,3
worthless,2,3.67E-06,2,4.56E-06,0,0,2
suspected,2,3.67E-06,2,4.56E-06,0,0,2
subjected,2,3.67E-06,2,4.56E-06,0,0,2
smoother,2,3.67E-06,2,4.56E-06,0,0,2
imminent,2,3.67E-06,1,2.28E-06,9.47E-06,1,3
actthen,2,3.67E-06,0,0,1.89E-05,2,2
pathetically,2,3.67E-06,2,4.56E-06,0,0,5
southerner,2,3.67E-06,2,4.56E-06,0,0,3
commonly,2,3.67E-06,2,4.56E-06,0,0,3
hammered,2,3.67E-06,2,4.56E-06,0,0,2
communism,2,3.67E-06,2,4.56E-06,0,0,3
grandfather,2,3.67E-06,1,2.28E-06,9.47E-06,1,3
plummeting,2,3.67E-06,2,4.56E-06,0,0,3
commemoration,2,3.67E-06,1,2.28E-06,9.47E-06,1,5
commissioning,2,3.67E-06,2,4.56E-06,0,0,4
strengthened,2,3.67E-06,2,4.56E-06,0,0,2
principled,2,3.67E-06,0,0,1.89E-05,2,2
appearance,2,3.67E-06,0,0,1.89E-05,2,3
punishment,2,3.67E-06,1,2.28E-06,9.47E-06,1,3
completing,2,3.67E-06,1,2.28E-06,9.47E-06,1,3
determines,2,3.67E-06,0,0,1.89E-05,2,3
cumulative,2,3.67E-06,1,2.28E-06,9.47E-06,1,4
derailment,2,3.67E-06,1,2.28E-06,9.47E-06,1,3
atmosphere,2,3.67E-06,0,0,1.89E-05,2,3
passionate,2,3.67E-06,0,0,1.89E-05,2,3
resurgence,2,3.67E-06,0,0,1.89E-05,2,3
americorps,2,3.67E-06,0,0,1.89E-05,2,4
scientific,2,3.67E-06,0,0,1.89E-05,2,3
statistics,2,3.67E-06,1,2.28E-06,9.47E-06,1,3
furloughed,2,3.67E-06,0,0,1.89E-05,2,2
economists,2,3.67E-06,1,2.28E-06,9.47E-06,1,4
terrorized,2,3.67E-06,0,0,1.89E-05,2,3
empowering,2,3.67E-06,1,2.28E-06,9.47E-06,1,4
quicklybut,2,3.67E-06,1,2.28E-06,9.47E-06,1,3
canvassing,2,3.67E-06,0,0,1.89E-05,2,3
decimating,2,3.67E-06,1,2.28E-06,9.47E-06,1,4
gymnastics,2,3.67E-06,0,0,1.89E-05,2,3
prospering,2,3.67E-06,1,2.28E-06,9.47E-06,1,3
distorting,2,3.67E-06,1,2.28E-06,9.47E-06,1,3
disclosure,2,3.67E-06,1,2.28E-06,9.47E-06,1,3
eisenhower,2,3.67E-06,0,0,1.89E-05,2,4
bankruptcy,2,3.67E-06,0,0,1.89E-05,2,3
safeguards,2,3.67E-06,1,2.28E-06,9.47E-06,1,3
convenient,2,3.67E-06,1,2.28E-06,9.47E-06,1,3
georgetown,2,3.67E-06,1,2.28E-06,9.47E-06,1,3
backtracks,2,3.67E-06,0,0,1.89E-05,2,2
contacting,2,3.67E-06,0,0,1.89E-05,2,3
principals,2,3.67E-06,1,2.28E-06,9.47E-06,1,3
accelerate,2,3.67E-06,1,2.28E-06,9.47E-06,1,4
approaches,2,3.67E-06,1,2.28E-06,9.47E-06,1,2
emboldened,2,3.67E-06,2,4.56E-06,0,0,3
canvassers,2,3.67E-06,2,4.56E-06,0,0,3
disturbing,2,3.67E-06,2,4.56E-06,0,0,3
thundering,2,3.67E-06,2,4.56E-06,0,0,3
americanow,2,3.67E-06,2,4.56E-06,0,0,5
relatively,2,3.67E-06,2,4.56E-06,0,0,5
staggering,2,3.67E-06,2,4.56E-06,0,0,3
punishable,2,3.67E-06,2,4.56E-06,0,0,4
adjustment,2,3.67E-06,2,4.56E-06,0,0,3
flagrantly,2,3.67E-06,2,4.56E-06,0,0,3
extinguish,2,3.67E-06,2,4.56E-06,0,0,3
accordance,2,3.67E-06,2,4.56E-06,0,0,3
dispatched,2,3.67E-06,2,4.56E-06,0,0,2
submission,2,3.67E-06,2,4.56E-06,0,0,3
locational,2,3.67E-06,2,4.56E-06,0,0,4
senatorial,2,3.67E-06,2,4.56E-06,0,0,4
laundering,2,3.67E-06,2,4.56E-06,0,0,3
imprisoned,2,3.67E-06,2,4.56E-06,0,0,3
fracturing,2,3.67E-06,2,4.56E-06,0,0,3
prediction,2,3.67E-06,2,4.56E-06,0,0,3
sleazebags,2,3.67E-06,2,4.56E-06,0,0,3
physicians,2,3.67E-06,2,4.56E-06,0,0,3
resounding,2,3.67E-06,2,4.56E-06,0,0,3
westerhout,2,3.67E-06,2,4.56E-06,0,0,3
passengers,2,3.67E-06,2,4.56E-06,0,0,3
coordinate,2,3.67E-06,2,4.56E-06,0,0,3
xenophobic,2,3.67E-06,2,4.56E-06,0,0,4
impression,2,3.67E-06,2,4.56E-06,0,0,3
endangered,2,3.67E-06,2,4.56E-06,0,0,3
socialized,2,3.67E-06,2,4.56E-06,0,0,3
unexpected,2,3.67E-06,2,4.56E-06,0,0,3
bounceback,2,3.67E-06,2,4.56E-06,0,0,3
apoplectic,2,3.67E-06,2,4.56E-06,0,0,4
distracted,2,3.67E-06,2,4.56E-06,0,0,2
dismantled,2,3.67E-06,2,4.56E-06,0,0,2
deliveries,2,3.67E-06,2,4.56E-06,0,0,4
ideologies,2,3.67E-06,2,4.56E-06,0,0,4
portsmouth,2,3.67E-06,2,4.56E-06,0,0,2
domination,2,3.67E-06,2,4.56E-06,0,0,4
untalented,2,3.67E-06,2,4.56E-06,0,0,3
surrounded,2,3.67E-06,2,4.56E-06,0,0,2
operatives,2,3.67E-06,2,4.56E-06,0,0,4
wilmington,2,3.67E-06,2,4.56E-06,0,0,3
undercover,2,3.67E-06,2,4.56E-06,0,0,4
overstated,2,3.67E-06,2,4.56E-06,0,0,3
inherently,2,3.67E-06,2,4.56E-06,0,0,4
advantages,2,3.67E-06,2,4.56E-06,0,0,3
enterprise,2,3.67E-06,2,4.56E-06,0,0,3
contribute,2,3.67E-06,2,4.56E-06,0,0,3
suggestion,2,3.67E-06,2,4.56E-06,0,0,3
intimating,2,3.67E-06,2,4.56E-06,0,0,4
milestones,2,3.67E-06,2,4.56E-06,0,0,3
prototypes,2,3.67E-06,2,4.56E-06,0,0,3
respecting,2,3.67E-06,2,4.56E-06,0,0,3
poroshenko,2,3.67E-06,2,4.56E-06,0,0,4
jobsborder,2,3.67E-06,2,4.56E-06,0,0,3
huntington,2,3.67E-06,2,4.56E-06,0,0,3
youngstown,2,3.67E-06,2,4.56E-06,0,0,2
tournament,2,3.67E-06,2,4.56E-06,0,0,3
encouraged,2,3.67E-06,2,4.56E-06,0,0,3
recordings,2,3.67E-06,2,4.56E-06,0,0,3
electronic,2,3.67E-06,2,4.56E-06,0,0,4
countering,2,3.67E-06,2,4.56E-06,0,0,3
seperation,2,3.67E-06,2,4.56E-06,0,0,4
restricted,2,3.67E-06,2,4.56E-06,0,0,2
correction,2,3.67E-06,2,4.56E-06,0,0,3
biological,2,3.67E-06,2,4.56E-06,0,0,4
indicators,2,3.67E-06,2,4.56E-06,0,0,4
recklessly,2,3.67E-06,2,4.56E-06,0,0,3
underneath,2,3.67E-06,2,4.56E-06,0,0,3
influenced,2,3.67E-06,2,4.56E-06,0,0,2
correcting,2,3.67E-06,2,4.56E-06,0,0,3
dissension,2,3.67E-06,2,4.56E-06,0,0,3
whimpering,2,3.67E-06,2,4.56E-06,0,0,3
serviceman,2,3.67E-06,2,4.56E-06,0,0,4
informants,2,3.67E-06,2,4.56E-06,0,0,3
reinstated,2,3.67E-06,2,4.56E-06,0,0,2
reflective,2,3.67E-06,2,4.56E-06,0,0,3
perfection,2,3.67E-06,2,4.56E-06,0,0,3
accusation,2,3.67E-06,2,4.56E-06,0,0,4
vindicated,2,3.67E-06,2,4.56E-06,0,0,3
victimized,2,3.67E-06,2,4.56E-06,0,0,3
vindicates,2,3.67E-06,2,4.56E-06,0,0,3
trumppence,2,3.67E-06,2,4.56E-06,0,0,2
decisively,2,3.67E-06,2,4.56E-06,0,0,5
recreation,2,3.67E-06,2,4.56E-06,0,0,3
ukrainians,2,3.67E-06,2,4.56E-06,0,0,3
skirmishes,2,3.67E-06,2,4.56E-06,0,0,2
respective,2,3.67E-06,2,4.56E-06,0,0,3
morgenthau,2,3.67E-06,2,4.56E-06,0,0,3
emoluments,2,3.67E-06,2,4.56E-06,0,0,4
anticipate,2,3.67E-06,2,4.56E-06,0,0,4
repression,2,3.67E-06,2,4.56E-06,0,0,3
developers,2,3.67E-06,2,4.56E-06,0,0,4
negotiator,2,3.67E-06,2,4.56E-06,0,0,4
comprehend,2,3.67E-06,2,4.56E-06,0,0,3
progressbut,2,3.67E-06,0,0,1.89E-05,2,3
exploration,2,3.67E-06,1,2.28E-06,9.47E-06,1,4
populations,2,3.67E-06,1,2.28E-06,9.47E-06,1,4
gatekeepers,2,3.67E-06,1,2.28E-06,9.47E-06,1,4
engineering,2,3.67E-06,0,0,1.89E-05,2,4
contractors,2,3.67E-06,1,2.28E-06,9.47E-06,1,3
enterprises,2,3.67E-06,1,2.28E-06,9.47E-06,1,3
researchers,2,3.67E-06,1,2.28E-06,9.47E-06,1,3
disfunction,2,3.67E-06,1,2.28E-06,9.47E-06,1,3
transferred,2,3.67E-06,1,2.28E-06,9.47E-06,1,2
springsteen,2,3.67E-06,0,0,1.89E-05,2,2
comfortable,2,3.67E-06,1,2.28E-06,9.47E-06,1,4
cosponsored,2,3.67E-06,0,0,1.89E-05,2,3
countryfind,2,3.67E-06,0,0,1.89E-05,2,3
outsourcers,2,3.67E-06,0,0,1.89E-05,2,3
electronics,2,3.67E-06,1,2.28E-06,9.47E-06,1,4
internships,2,3.67E-06,0,0,1.89E-05,2,3
skyrocketed,2,3.67E-06,1,2.28E-06,9.47E-06,1,3
foreclosure,2,3.67E-06,0,0,1.89E-05,2,4
interpreted,2,3.67E-06,1,2.28E-06,9.47E-06,1,3
refinancing,2,3.67E-06,1,2.28E-06,9.47E-06,1,4
inexcusable,2,3.67E-06,1,2.28E-06,9.47E-06,1,5
manufacture,2,3.67E-06,0,0,1.89E-05,2,4
livelihoods,2,3.67E-06,0,0,1.89E-05,2,4
detrimental,2,3.67E-06,1,2.28E-06,9.47E-06,1,4
maneuvering,2,3.67E-06,1,2.28E-06,9.47E-06,1,4
entertainer,2,3.67E-06,1,2.28E-06,9.47E-06,1,4
statutorily,2,3.67E-06,2,4.56E-06,0,0,5
bureaucracy,2,3.67E-06,2,4.56E-06,0,0,5
statistical,2,3.67E-06,2,4.56E-06,0,0,4
discrepancy,2,3.67E-06,2,4.56E-06,0,0,4
unaccounted,2,3.67E-06,2,4.56E-06,0,0,3
inspections,2,3.67E-06,2,4.56E-06,0,0,3
cheerleader,2,3.67E-06,2,4.56E-06,0,0,3
intervening,2,3.67E-06,2,4.56E-06,0,0,4
questioning,2,3.67E-06,2,4.56E-06,0,0,3
proceedings,2,3.67E-06,2,4.56E-06,0,0,3
exaggerated,2,3.67E-06,2,4.56E-06,0,0,4
maintaining,2,3.67E-06,2,4.56E-06,0,0,3
remembering,2,3.67E-06,2,4.56E-06,0,0,4
unthinkably,2,3.67E-06,2,4.56E-06,0,0,4
automobiles,2,3.67E-06,2,4.56E-06,0,0,5
unprotected,2,3.67E-06,2,4.56E-06,0,0,3
elimination,2,3.67E-06,2,4.56E-06,0,0,5
complainers,2,3.67E-06,2,4.56E-06,0,0,3
rebroadcast,2,3.67E-06,2,4.56E-06,0,0,3
progressive,2,3.67E-06,2,4.56E-06,0,0,3
supervision,2,3.67E-06,2,4.56E-06,0,0,4
compilation,2,3.67E-06,2,4.56E-06,0,0,4
neutralized,2,3.67E-06,2,4.56E-06,0,0,3
unwarranted,2,3.67E-06,2,4.56E-06,0,0,3
unrelenting,2,3.67E-06,2,4.56E-06,0,0,4
underserved,2,3.67E-06,2,4.56E-06,0,0,3
intimidated,2,3.67E-06,2,4.56E-06,0,0,4
slaughtered,2,3.67E-06,2,4.56E-06,0,0,2
suggestions,2,3.67E-06,2,4.56E-06,0,0,3
unequivocal,2,3.67E-06,2,4.56E-06,0,0,5
projections,2,3.67E-06,2,4.56E-06,0,0,3
unqualified,2,3.67E-06,2,4.56E-06,0,0,4
apologizing,2,3.67E-06,2,4.56E-06,0,0,5
provocative,2,3.67E-06,2,4.56E-06,0,0,4
terminating,2,3.67E-06,2,4.56E-06,0,0,4
delegations,2,3.67E-06,2,4.56E-06,0,0,4
exonerating,2,3.67E-06,2,4.56E-06,0,0,5
fascinating,2,3.67E-06,2,4.56E-06,0,0,4
transgender,2,3.67E-06,2,4.56E-06,0,0,3
constructed,2,3.67E-06,2,4.56E-06,0,0,2
functioning,2,3.67E-06,2,4.56E-06,0,0,3
proportions,2,3.67E-06,2,4.56E-06,0,0,3
distraction,2,3.67E-06,2,4.56E-06,0,0,3
secretaries,2,3.67E-06,2,4.56E-06,0,0,4
examination,2,3.67E-06,2,4.56E-06,0,0,5
accordingly,2,3.67E-06,2,4.56E-06,0,0,4
suppressing,2,3.67E-06,2,4.56E-06,0,0,3
forwardthis,2,3.67E-06,2,4.56E-06,0,0,3
autoworkers,2,3.67E-06,2,4.56E-06,0,0,4
proactively,2,3.67E-06,2,4.56E-06,0,0,4
exclusively,2,3.67E-06,2,4.56E-06,0,0,5
infestation,2,3.67E-06,2,4.56E-06,0,0,4
surrendered,2,3.67E-06,2,4.56E-06,0,0,3
nonexistent,2,3.67E-06,2,4.56E-06,0,0,4
importation,2,3.67E-06,2,4.56E-06,0,0,4
malpractice,2,3.67E-06,2,4.56E-06,0,0,3
irreparable,2,3.67E-06,2,4.56E-06,0,0,5
conflicting,2,3.67E-06,2,4.56E-06,0,0,3
medications,2,3.67E-06,2,4.56E-06,0,0,4
permissible,2,3.67E-06,2,4.56E-06,0,0,4
bureaucrats,2,3.67E-06,2,4.56E-06,0,0,4
fabricating,2,3.67E-06,2,4.56E-06,0,0,4
contradicts,2,3.67E-06,2,4.56E-06,0,0,3
electrified,2,3.67E-06,2,4.56E-06,0,0,4
corporation,2,3.67E-06,2,4.56E-06,0,0,4
correctness,2,3.67E-06,2,4.56E-06,0,0,3
conclusions,2,3.67E-06,2,4.56E-06,0,0,3
incarcerated,2,3.67E-06,0,0,1.89E-05,2,4
intensifying,2,3.67E-06,1,2.28E-06,9.47E-06,1,4
volunteering,2,3.67E-06,0,0,1.89E-05,2,4
americansnot,2,3.67E-06,0,0,1.89E-05,2,5
considerably,2,3.67E-06,1,2.28E-06,9.47E-06,1,5
inconvenient,2,3.67E-06,0,0,1.89E-05,2,4
foreclosures,2,3.67E-06,0,0,1.89E-05,2,4
contributing,2,3.67E-06,1,2.28E-06,9.47E-06,1,4
conveniently,2,3.67E-06,1,2.28E-06,9.47E-06,1,4
transforming,2,3.67E-06,1,2.28E-06,9.47E-06,1,3
compensation,2,3.67E-06,1,2.28E-06,9.47E-06,1,4
personalized,2,3.67E-06,0,0,1.89E-05,2,4
demonstrated,2,3.67E-06,1,2.28E-06,9.47E-06,1,3
partisanship,2,3.67E-06,1,2.28E-06,9.47E-06,1,4
impenetrable,2,3.67E-06,2,4.56E-06,0,0,5
unsuspecting,2,3.67E-06,2,4.56E-06,0,0,4
aggressively,2,3.67E-06,2,4.56E-06,0,0,5
continuously,2,3.67E-06,2,4.56E-06,0,0,5
bureaucratic,2,3.67E-06,2,4.56E-06,0,0,5
perpetrating,2,3.67E-06,2,4.56E-06,0,0,4
impeachments,2,3.67E-06,2,4.56E-06,0,0,3
broadcasting,2,3.67E-06,2,4.56E-06,0,0,3
entertaining,2,3.67E-06,2,4.56E-06,0,0,4
photoshopped,2,3.67E-06,2,4.56E-06,0,0,3
rescheduling,2,3.67E-06,2,4.56E-06,0,0,4
evangelicals,2,3.67E-06,2,4.56E-06,0,0,5
investigator,2,3.67E-06,2,4.56E-06,0,0,5
distributors,2,3.67E-06,2,4.56E-06,0,0,4
preservation,2,3.67E-06,2,4.56E-06,0,0,4
manipulating,2,3.67E-06,2,4.56E-06,0,0,5
depreciation,2,3.67E-06,2,4.56E-06,0,0,4
redesignates,2,3.67E-06,2,4.56E-06,0,0,4
sympathizers,2,3.67E-06,2,4.56E-06,0,0,4
lightweights,2,3.67E-06,2,4.56E-06,0,0,2
appreciative,2,3.67E-06,2,4.56E-06,0,0,4
hickenlooper,2,3.67E-06,2,4.56E-06,0,0,4
enhancements,2,3.67E-06,2,4.56E-06,0,0,4
satisfaction,2,3.67E-06,2,4.56E-06,0,0,4
coordinating,2,3.67E-06,2,4.56E-06,0,0,4
restrictions,2,3.67E-06,2,4.56E-06,0,0,3
designations,2,3.67E-06,2,4.56E-06,0,0,4
participated,2,3.67E-06,2,4.56E-06,0,0,4
accumulation,2,3.67E-06,2,4.56E-06,0,0,5
transferring,2,3.67E-06,2,4.56E-06,0,0,3
begrudgingly,2,3.67E-06,2,4.56E-06,0,0,4
deficiencies,2,3.67E-06,2,4.56E-06,0,0,4
inaccessible,2,3.67E-06,2,4.56E-06,0,0,5
compromising,2,3.67E-06,2,4.56E-06,0,0,4
infiltrating,2,3.67E-06,2,4.56E-06,0,0,4
experimental,2,3.67E-06,2,4.56E-06,0,0,5
arrangements,2,3.67E-06,2,4.56E-06,0,0,4
exaggeration,2,3.67E-06,2,4.56E-06,0,0,5
drunkdrugged,2,3.67E-06,2,4.56E-06,0,0,2
barriersalso,2,3.67E-06,2,4.56E-06,0,0,4
insufficient,2,3.67E-06,2,4.56E-06,0,0,4
increasingly,2,3.67E-06,2,4.56E-06,0,0,4
democratfake,2,3.67E-06,2,4.56E-06,0,0,4
conservatism,2,3.67E-06,2,4.56E-06,0,0,4
celebrations,2,3.67E-06,2,4.56E-06,0,0,4
diversionary,2,3.67E-06,2,4.56E-06,0,0,5
contradicted,2,3.67E-06,2,4.56E-06,0,0,3
neighborhoods,2,3.67E-06,1,2.28E-06,9.47E-06,1,3
contraceptive,2,3.67E-06,0,0,1.89E-05,2,4
irresponsible,2,3.67E-06,1,2.28E-06,9.47E-06,1,5
retroactively,2,3.67E-06,1,2.28E-06,9.47E-06,1,5
disappointing,2,3.67E-06,1,2.28E-06,9.47E-06,1,4
proliferation,2,3.67E-06,1,2.28E-06,9.47E-06,1,5
normalization,2,3.67E-06,2,4.56E-06,0,0,5
indoctrinated,2,3.67E-06,2,4.56E-06,0,0,4
disqualifying,2,3.67E-06,2,4.56E-06,0,0,4
interruptions,2,3.67E-06,2,4.56E-06,0,0,4
insubordinate,2,3.67E-06,2,4.56E-06,0,0,5
complimentary,2,3.67E-06,2,4.56E-06,0,0,5
grandstanding,2,3.67E-06,2,4.56E-06,0,0,3
assassination,2,3.67E-06,2,4.56E-06,0,0,5
ramifications,2,3.67E-06,2,4.56E-06,0,0,5
registrations,2,3.67E-06,2,4.56E-06,0,0,4
modernization,2,3.67E-06,2,4.56E-06,0,0,5
misstatements,2,3.67E-06,2,4.56E-06,0,0,4
acknowledging,2,3.67E-06,2,4.56E-06,0,0,4
jurisdictions,2,3.67E-06,2,4.56E-06,0,0,4
confrontation,2,3.67E-06,2,4.56E-06,0,0,4
impersonation,2,3.67E-06,2,4.56E-06,0,0,5
recrimination,2,3.67E-06,2,4.56E-06,0,0,5
troublemakers,2,3.67E-06,2,4.56E-06,0,0,4
concentration,2,3.67E-06,2,4.56E-06,0,0,4
participation,2,3.67E-06,2,4.56E-06,0,0,5
congratulated,2,3.67E-06,2,4.56E-06,0,0,4
demonstrations,2,3.67E-06,2,4.56E-06,0,0,4
disappointment,2,3.67E-06,2,4.56E-06,0,0,4
represenatives,2,3.67E-06,2,4.56E-06,0,0,5
pharmaceutical,2,3.67E-06,2,4.56E-06,0,0,5
philanthropist,2,3.67E-06,2,4.56E-06,0,0,4
understatement,2,3.67E-06,2,4.56E-06,0,0,5
congratulation,2,3.67E-06,2,4.56E-06,0,0,5
considerations,2,3.67E-06,2,4.56E-06,0,0,5
expropriations,2,3.67E-06,2,4.56E-06,0,0,4
misrepresented,2,3.67E-06,2,4.56E-06,0,0,4
simultaneously,2,3.67E-06,2,4.56E-06,0,0,6
reconstruction,2,3.67E-06,2,4.56E-06,0,0,4
extraordinarily,2,3.67E-06,2,4.56E-06,0,0,6
unsubstantiated,2,3.67E-06,2,4.56E-06,0,0,4
indiscriminately,2,3.67E-06,2,4.56E-06,0,0,7
disproportionate,2,3.67E-06,2,4.56E-06,0,0,5
mit,1,1.84E-06,1,2.28E-06,0,0,1
fits,1,1.84E-06,0,0,9.47E-06,1,1
dull,1,1.84E-06,1,2.28E-06,0,0,1
kits,1,1.84E-06,1,2.28E-06,0,0,1
spit,1,1.84E-06,1,2.28E-06,0,0,1
bait,1,1.84E-06,1,2.28E-06,0,0,1
eid,1,1.84E-06,0,0,9.47E-06,1,1
pie,1,1.84E-06,0,0,9.47E-06,1,1
lew,1,1.84E-06,0,0,9.47E-06,1,1
dim,1,1.84E-06,0,0,9.47E-06,1,1
ash,1,1.84E-06,0,0,9.47E-06,1,1
eva,1,1.84E-06,0,0,9.47E-06,1,1
jan,1,1.84E-06,0,0,9.47E-06,1,1
vip,1,1.84E-06,0,0,9.47E-06,1,1
mei,1,1.84E-06,0,0,9.47E-06,1,1
gab,1,1.84E-06,0,0,9.47E-06,1,1
med,1,1.84E-06,0,0,9.47E-06,1,1
fab,1,1.84E-06,0,0,9.47E-06,1,1
mea,1,1.84E-06,0,0,9.47E-06,1,1
ama,1,1.84E-06,0,0,9.47E-06,1,1
mpg,1,1.84E-06,0,0,9.47E-06,1,1
gut,1,1.84E-06,0,0,9.47E-06,1,1
tab,1,1.84E-06,0,0,9.47E-06,1,1
ina,1,1.84E-06,0,0,9.47E-06,1,1
cue,1,1.84E-06,0,0,9.47E-06,1,1
mas,1,1.84E-06,0,0,9.47E-06,1,1
iva,1,1.84E-06,0,0,9.47E-06,1,1
gst,1,1.84E-06,0,0,9.47E-06,1,1
zoe,1,1.84E-06,0,0,9.47E-06,1,1
lin,1,1.84E-06,0,0,9.47E-06,1,1
pop,1,1.84E-06,0,0,9.47E-06,1,1
kal,1,1.84E-06,0,0,9.47E-06,1,1
msg,1,1.84E-06,0,0,9.47E-06,1,1
chu,1,1.84E-06,0,0,9.47E-06,1,1
fog,1,1.84E-06,1,2.28E-06,0,0,1
bum,1,1.84E-06,1,2.28E-06,0,0,1
rbg,1,1.84E-06,1,2.28E-06,0,0,1
doa,1,1.84E-06,1,2.28E-06,0,0,1
vey,1,1.84E-06,1,2.28E-06,0,0,1
foe,1,1.84E-06,1,2.28E-06,0,0,1
dip,1,1.84E-06,1,2.28E-06,0,0,1
ode,1,1.84E-06,1,2.28E-06,0,0,1
ags,1,1.84E-06,1,2.28E-06,0,0,1
fop,1,1.84E-06,1,2.28E-06,0,0,1
toe,1,1.84E-06,1,2.28E-06,0,0,1
dcs,1,1.84E-06,1,2.28E-06,0,0,1
goa,1,1.84E-06,1,2.28E-06,0,0,1
hub,1,1.84E-06,1,2.28E-06,0,0,1
ent,1,1.84E-06,1,2.28E-06,0,0,1
nan,1,1.84E-06,1,2.28E-06,0,0,1
mbs,1,1.84E-06,1,2.28E-06,0,0,1
mvp,1,1.84E-06,1,2.28E-06,0,0,1
msc,1,1.84E-06,1,2.28E-06,0,0,1
mop,1,1.84E-06,1,2.28E-06,0,0,1
edt,1,1.84E-06,1,2.28E-06,0,0,1
hcq,1,1.84E-06,1,2.28E-06,0,0,1
ppe,1,1.84E-06,1,2.28E-06,0,0,1
uae,1,1.84E-06,1,2.28E-06,0,0,1
ems,1,1.84E-06,1,2.28E-06,0,0,1
tba,1,1.84E-06,1,2.28E-06,0,0,1
ere,1,1.84E-06,1,2.28E-06,0,0,1
fay,1,1.84E-06,1,2.28E-06,0,0,1
ned,1,1.84E-06,1,2.28E-06,0,0,1
ioc,1,1.84E-06,1,2.28E-06,0,0,1
rcp,1,1.84E-06,1,2.28E-06,0,0,1
jar,1,1.84E-06,1,2.28E-06,0,0,1
kat,1,1.84E-06,1,2.28E-06,0,0,1
ore,1,1.84E-06,1,2.28E-06,0,0,1
est,1,1.84E-06,1,2.28E-06,0,0,1
tel,1,1.84E-06,1,2.28E-06,0,0,1
cea,1,1.84E-06,1,2.28E-06,0,0,1
dai,1,1.84E-06,1,2.28E-06,0,0,1
zoo,1,1.84E-06,1,2.28E-06,0,0,1
ipo,1,1.84E-06,1,2.28E-06,0,0,1
rev,1,1.84E-06,1,2.28E-06,0,0,1
tan,1,1.84E-06,1,2.28E-06,0,0,1
hqs,1,1.84E-06,1,2.28E-06,0,0,1
okd,1,1.84E-06,1,2.28E-06,0,0,1
yrs,1,1.84E-06,1,2.28E-06,0,0,1
ins,1,1.84E-06,1,2.28E-06,0,0,1
nsc,1,1.84E-06,1,2.28E-06,0,0,1
nhl,1,1.84E-06,1,2.28E-06,0,0,1
grt,1,1.84E-06,1,2.28E-06,0,0,1
les,1,1.84E-06,1,2.28E-06,0,0,1
ene,1,1.84E-06,1,2.28E-06,0,0,1
scs,1,1.84E-06,1,2.28E-06,0,0,1
wag,1,1.84E-06,1,2.28E-06,0,0,1
hel,1,1.84E-06,1,2.28E-06,0,0,1
eos,1,1.84E-06,1,2.28E-06,0,0,1
fro,1,1.84E-06,1,2.28E-06,0,0,1
aya,1,1.84E-06,1,2.28E-06,0,0,1
peo,1,1.84E-06,1,2.28E-06,0,0,1
fla,1,1.84E-06,1,2.28E-06,0,0,1
mic,1,1.84E-06,1,2.28E-06,0,0,1
thr,1,1.84E-06,1,2.28E-06,0,0,1
bmw,1,1.84E-06,1,2.28E-06,0,0,1
gem,1,1.84E-06,1,2.28E-06,0,0,1
cal,1,1.84E-06,1,2.28E-06,0,0,1
ret,1,1.84E-06,1,2.28E-06,0,0,1
cat,1,1.84E-06,1,2.28E-06,0,0,1
pfc,1,1.84E-06,1,2.28E-06,0,0,1
pad,1,1.84E-06,1,2.28E-06,0,0,1
gwu,1,1.84E-06,1,2.28E-06,0,0,1
mdt,1,1.84E-06,1,2.28E-06,0,0,1
kyl,1,1.84E-06,1,2.28E-06,0,0,1
vat,1,1.84E-06,1,2.28E-06,0,0,1
ige,1,1.84E-06,1,2.28E-06,0,0,1
adp,1,1.84E-06,1,2.28E-06,0,0,1
jam,1,1.84E-06,1,2.28E-06,0,0,1
vfw,1,1.84E-06,1,2.28E-06,0,0,1
soy,1,1.84E-06,1,2.28E-06,0,0,1
gig,1,1.84E-06,1,2.28E-06,0,0,1
hen,1,1.84E-06,1,2.28E-06,0,0,1
ric,1,1.84E-06,1,2.28E-06,0,0,1
rvs,1,1.84E-06,1,2.28E-06,0,0,1
mia,1,1.84E-06,1,2.28E-06,0,0,1
bee,1,1.84E-06,1,2.28E-06,0,0,1
vow,1,1.84E-06,1,2.28E-06,0,0,1
den,1,1.84E-06,1,2.28E-06,0,0,1
hon,1,1.84E-06,1,2.28E-06,0,0,1
dod,1,1.84E-06,1,2.28E-06,0,0,1
fiu,1,1.84E-06,1,2.28E-06,0,0,1
sid,1,1.84E-06,1,2.28E-06,0,0,1
hid,1,1.84E-06,1,2.28E-06,0,0,1
crs,1,1.84E-06,1,2.28E-06,0,0,1
hsi,1,1.84E-06,1,2.28E-06,0,0,1
ero,1,1.84E-06,1,2.28E-06,0,0,1
inf,1,1.84E-06,1,2.28E-06,0,0,1
nas,1,1.84E-06,1,2.28E-06,0,0,1
omb,1,1.84E-06,1,2.28E-06,0,0,1
ame,1,1.84E-06,1,2.28E-06,0,0,1
tad,1,1.84E-06,1,2.28E-06,0,0,1
pai,1,1.84E-06,1,2.28E-06,0,0,1
aim,1,1.84E-06,1,2.28E-06,0,0,1
fac,1,1.84E-06,1,2.28E-06,0,0,1
rio,1,1.84E-06,1,2.28E-06,0,0,1
rad,1,1.84E-06,1,2.28E-06,0,0,1
igs,1,1.84E-06,1,2.28E-06,0,0,1
slv,1,1.84E-06,1,2.28E-06,0,0,1
saf,1,1.84E-06,1,2.28E-06,0,0,1
ele,1,1.84E-06,1,2.28E-06,0,0,1
mid,1,1.84E-06,1,2.28E-06,0,0,1
bug,1,1.84E-06,1,2.28E-06,0,0,1
nyt,1,1.84E-06,1,2.28E-06,0,0,1
uns,1,1.84E-06,1,2.28E-06,0,0,1
frm,1,1.84E-06,1,2.28E-06,0,0,1
dax,1,1.84E-06,1,2.28E-06,0,0,1
ecb,1,1.84E-06,1,2.28E-06,0,0,1
ble,1,1.84E-06,1,2.28E-06,0,0,1
bjp,1,1.84E-06,1,2.28E-06,0,0,1
hip,1,1.84E-06,1,2.28E-06,0,0,1
pal,1,1.84E-06,1,2.28E-06,0,0,1
fdn,1,1.84E-06,1,2.28E-06,0,0,1
wil,1,1.84E-06,1,2.28E-06,0,0,1
asd,1,1.84E-06,1,2.28E-06,0,0,1
del,1,1.84E-06,1,2.28E-06,0,0,1
res,1,1.84E-06,1,2.28E-06,0,0,1
von,1,1.84E-06,1,2.28E-06,0,0,1
pga,1,1.84E-06,1,2.28E-06,0,0,1
gou,1,1.84E-06,1,2.28E-06,0,0,1
dug,1,1.84E-06,1,2.28E-06,0,0,1
acu,1,1.84E-06,1,2.28E-06,0,0,1
lbj,1,1.84E-06,1,2.28E-06,0,0,1
cns,1,1.84E-06,1,2.28E-06,0,0,1
pbs,1,1.84E-06,1,2.28E-06,0,0,1
toll,1,1.84E-06,1,2.28E-06,0,0,1
shit,1,1.84E-06,1,2.28E-06,0,0,1
bull,1,1.84E-06,1,2.28E-06,0,0,1
bell,1,1.84E-06,1,2.28E-06,0,0,1
pill,1,1.84E-06,1,2.28E-06,0,0,1
coll,1,1.84E-06,1,2.28E-06,0,0,1
tully,1,1.84E-06,0,0,9.47E-06,1,2
gills,1,1.84E-06,1,2.28E-06,0,0,1
brit,1,1.84E-06,1,2.28E-06,0,0,1
lite,1,1.84E-06,1,2.28E-06,0,0,1
shell,1,1.84E-06,1,2.28E-06,0,0,1
balls,1,1.84E-06,1,2.28E-06,0,0,1
upits,1,1.84E-06,0,0,9.47E-06,1,2
canit,1,1.84E-06,0,0,9.47E-06,1,2
fills,1,1.84E-06,1,2.28E-06,0,0,1
vitally,1,1.84E-06,1,2.28E-06,0,0,3
allyn,1,1.84E-06,1,2.28E-06,0,0,2
halls,1,1.84E-06,1,2.28E-06,0,0,1
bully,1,1.84E-06,1,2.28E-06,0,0,2
fuller,1,1.84E-06,0,0,9.47E-06,1,2
ditch,1,1.84E-06,0,0,9.47E-06,1,1
scroll,1,1.84E-06,0,0,9.47E-06,1,1
collar,1,1.84E-06,0,0,9.47E-06,1,2
cites,1,1.84E-06,1,2.28E-06,0,0,1
quits,1,1.84E-06,1,2.28E-06,0,0,1
wallet,1,1.84E-06,0,0,9.47E-06,1,2
lend,1,1.84E-06,0,0,9.47E-06,1,1
bees,1,1.84E-06,0,0,9.47E-06,1,1
pine,1,1.84E-06,0,0,9.47E-06,1,1
cake,1,1.84E-06,0,0,9.47E-06,1,1
ditzy,1,1.84E-06,1,2.28E-06,0,0,2
slip,1,1.84E-06,0,0,9.47E-06,1,1
lois,1,1.84E-06,0,0,9.47E-06,1,1
acne,1,1.84E-06,0,0,9.47E-06,1,1
dome,1,1.84E-06,0,0,9.47E-06,1,1
sikh,1,1.84E-06,0,0,9.47E-06,1,1
enda,1,1.84E-06,0,0,9.47E-06,1,2
wout,1,1.84E-06,0,0,9.47E-06,1,1
adas,1,1.84E-06,0,0,9.47E-06,1,2
pats,1,1.84E-06,0,0,9.47E-06,1,1
joys,1,1.84E-06,0,0,9.47E-06,1,1
melt,1,1.84E-06,0,0,9.47E-06,1,1
gila,1,1.84E-06,0,0,9.47E-06,1,2
jose,1,1.84E-06,0,0,9.47E-06,1,1
blitz,1,1.84E-06,1,2.28E-06,0,0,1
flaw,1,1.84E-06,0,0,9.47E-06,1,1
usto,1,1.84E-06,0,0,9.47E-06,1,2
ipod,1,1.84E-06,0,0,9.47E-06,1,2
jeep,1,1.84E-06,0,0,9.47E-06,1,1
pint,1,1.84E-06,0,0,9.47E-06,1,1
meto,1,1.84E-06,0,0,9.47E-06,1,2
elmo,1,1.84E-06,0,0,9.47E-06,1,2
moly,1,1.84E-06,0,0,9.47E-06,1,2
fads,1,1.84E-06,0,0,9.47E-06,1,1
tees,1,1.84E-06,0,0,9.47E-06,1,1
jean,1,1.84E-06,0,0,9.47E-06,1,1
swim,1,1.84E-06,0,0,9.47E-06,1,1
mint,1,1.84E-06,0,0,9.47E-06,1,1
rsvp,1,1.84E-06,0,0,9.47E-06,1,#ERROR!
luzs,1,1.84E-06,0,0,9.47E-06,1,1
dade,1,1.84E-06,0,0,9.47E-06,1,1
tuck,1,1.84E-06,0,0,9.47E-06,1,1
rack,1,1.84E-06,0,0,9.47E-06,1,1
elie,1,1.84E-06,0,0,9.47E-06,1,2
goas,1,1.84E-06,0,0,9.47E-06,1,1
asne,1,1.84E-06,0,0,9.47E-06,1,1
bark,1,1.84E-06,0,0,9.47E-06,1,1
bake,1,1.84E-06,0,0,9.47E-06,1,1
perk,1,1.84E-06,0,0,9.47E-06,1,1
skip,1,1.84E-06,0,0,9.47E-06,1,1
sing,1,1.84E-06,0,0,9.47E-06,1,1
pacs,1,1.84E-06,0,0,9.47E-06,1,1
pose,1,1.84E-06,0,0,9.47E-06,1,1
sang,1,1.84E-06,0,0,9.47E-06,1,1
coin,1,1.84E-06,0,0,9.47E-06,1,1
soda,1,1.84E-06,0,0,9.47E-06,1,2
fran,1,1.84E-06,0,0,9.47E-06,1,1
trim,1,1.84E-06,0,0,9.47E-06,1,1
dads,1,1.84E-06,0,0,9.47E-06,1,1
dadt,1,1.84E-06,0,0,9.47E-06,1,1
echo,1,1.84E-06,0,0,9.47E-06,1,2
lena,1,1.84E-06,0,0,9.47E-06,1,2
daya,1,1.84E-06,0,0,9.47E-06,1,2
arne,1,1.84E-06,0,0,9.47E-06,1,1
anew,1,1.84E-06,0,0,9.47E-06,1,2
plug,1,1.84E-06,0,0,9.47E-06,1,1
sunk,1,1.84E-06,1,2.28E-06,0,0,1
buck,1,1.84E-06,1,2.28E-06,0,0,1
espy,1,1.84E-06,1,2.28E-06,0,0,2
warp,1,1.84E-06,1,2.28E-06,0,0,1
pave,1,1.84E-06,1,2.28E-06,0,0,1
sullen,1,1.84E-06,1,2.28E-06,0,0,2
nanny,1,1.84E-06,0,0,9.47E-06,1,2
joko,1,1.84E-06,1,2.28E-06,0,0,2
trus,1,1.84E-06,1,2.28E-06,0,0,1
lest,1,1.84E-06,1,2.28E-06,0,0,1
sens,1,1.84E-06,1,2.28E-06,0,0,1
norm,1,1.84E-06,1,2.28E-06,0,0,1
jody,1,1.84E-06,1,2.28E-06,0,0,2
damn,1,1.84E-06,1,2.28E-06,0,0,1
pens,1,1.84E-06,1,2.28E-06,0,0,1
newt,1,1.84E-06,1,2.28E-06,0,0,1
Ø¨Ø±,1,1.84E-06,1,2.28E-06,0,0,#ERROR!
lwcf,1,1.84E-06,1,2.28E-06,0,0,#ERROR!
reno,1,1.84E-06,1,2.28E-06,0,0,2
lick,1,1.84E-06,1,2.28E-06,0,0,1
doom,1,1.84E-06,1,2.28E-06,0,0,1
mend,1,1.84E-06,1,2.28E-06,0,0,1
mops,1,1.84E-06,1,2.28E-06,0,0,1
junk,1,1.84E-06,1,2.28E-06,0,0,1
dart,1,1.84E-06,1,2.28E-06,0,0,1
nycs,1,1.84E-06,1,2.28E-06,0,0,1
niel,1,1.84E-06,1,2.28E-06,0,0,1
hose,1,1.84E-06,1,2.28E-06,0,0,1
fuse,1,1.84E-06,1,2.28E-06,0,0,1
kent,1,1.84E-06,1,2.28E-06,0,0,1
bath,1,1.84E-06,1,2.28E-06,0,0,1
feud,1,1.84E-06,1,2.28E-06,0,0,1
rena,1,1.84E-06,1,2.28E-06,0,0,2
bitter,1,1.84E-06,1,2.28E-06,0,0,2
evan,1,1.84E-06,1,2.28E-06,0,0,2
horn,1,1.84E-06,1,2.28E-06,0,0,1
ahya,1,1.84E-06,1,2.28E-06,0,0,2
aoun,1,1.84E-06,1,2.28E-06,0,0,2
fume,1,1.84E-06,1,2.28E-06,0,0,1
crop,1,1.84E-06,1,2.28E-06,0,0,1
meat,1,1.84E-06,1,2.28E-06,0,0,1
dock,1,1.84E-06,1,2.28E-06,0,0,1
fore,1,1.84E-06,1,2.28E-06,0,0,1
conf,1,1.84E-06,1,2.28E-06,0,0,1
limp,1,1.84E-06,1,2.28E-06,0,0,1
vail,1,1.84E-06,1,2.28E-06,0,0,1
asst,1,1.84E-06,1,2.28E-06,0,0,1
secy,1,1.84E-06,1,2.28E-06,0,0,2
gaps,1,1.84E-06,1,2.28E-06,0,0,1
ripe,1,1.84E-06,1,2.28E-06,0,0,1
peek,1,1.84E-06,1,2.28E-06,0,0,1
suga,1,1.84E-06,1,2.28E-06,0,0,2
scjs,1,1.84E-06,1,2.28E-06,0,0,#ERROR!
aced,1,1.84E-06,1,2.28E-06,0,0,1
beth,1,1.84E-06,1,2.28E-06,0,0,1
fist,1,1.84E-06,1,2.28E-06,0,0,1
hern,1,1.84E-06,1,2.28E-06,0,0,1
spur,1,1.84E-06,1,2.28E-06,0,0,1
feat,1,1.84E-06,1,2.28E-06,0,0,1
logo,1,1.84E-06,1,2.28E-06,0,0,2
dial,1,1.84E-06,1,2.28E-06,0,0,1
afar,1,1.84E-06,1,2.28E-06,0,0,2
rood,1,1.84E-06,1,2.28E-06,0,0,1
icon,1,1.84E-06,1,2.28E-06,0,0,2
peak,1,1.84E-06,1,2.28E-06,0,0,1
ochs,1,1.84E-06,1,2.28E-06,0,0,1
sect,1,1.84E-06,1,2.28E-06,0,0,1
hank,1,1.84E-06,1,2.28E-06,0,0,1
chen,1,1.84E-06,1,2.28E-06,0,0,1
cent,1,1.84E-06,1,2.28E-06,0,0,1
pool,1,1.84E-06,1,2.28E-06,0,0,1
bins,1,1.84E-06,1,2.28E-06,0,0,1
nynj,1,1.84E-06,1,2.28E-06,0,0,1
mode,1,1.84E-06,1,2.28E-06,0,0,1
dorn,1,1.84E-06,1,2.28E-06,0,0,1
rode,1,1.84E-06,1,2.28E-06,0,0,1
simi,1,1.84E-06,1,2.28E-06,0,0,2
carl,1,1.84E-06,1,2.28E-06,0,0,1
thug,1,1.84E-06,1,2.28E-06,0,0,1
hoti,1,1.84E-06,1,2.28E-06,0,0,2
thud,1,1.84E-06,1,2.28E-06,0,0,1
ustr,1,1.84E-06,1,2.28E-06,0,0,1
anwr,1,1.84E-06,1,2.28E-06,0,0,1
hitter,1,1.84E-06,1,2.28E-06,0,0,2
zika,1,1.84E-06,1,2.28E-06,0,0,2
pent,1,1.84E-06,1,2.28E-06,0,0,1
spas,1,1.84E-06,1,2.28E-06,0,0,1
weli,1,1.84E-06,1,2.28E-06,0,0,2
scan,1,1.84E-06,1,2.28E-06,0,0,1
grim,1,1.84E-06,1,2.28E-06,0,0,1
mgmt,1,1.84E-06,1,2.28E-06,0,0,#ERROR!
twin,1,1.84E-06,1,2.28E-06,0,0,1
bass,1,1.84E-06,1,2.28E-06,0,0,1
citys,1,1.84E-06,1,2.28E-06,0,0,2
fdrs,1,1.84E-06,1,2.28E-06,0,0,#ERROR!
maze,1,1.84E-06,1,2.28E-06,0,0,1
aviv,1,1.84E-06,1,2.28E-06,0,0,2
glum,1,1.84E-06,1,2.28E-06,0,0,1
pipe,1,1.84E-06,1,2.28E-06,0,0,1
nfls,1,1.84E-06,1,2.28E-06,0,0,#ERROR!
boos,1,1.84E-06,1,2.28E-06,0,0,1
tran,1,1.84E-06,1,2.28E-06,0,0,1
gala,1,1.84E-06,1,2.28E-06,0,0,2
natl,1,1.84E-06,1,2.28E-06,0,0,1
hock,1,1.84E-06,1,2.28E-06,0,0,1
fest,1,1.84E-06,1,2.28E-06,0,0,1
orgs,1,1.84E-06,1,2.28E-06,0,0,1
cred,1,1.84E-06,1,2.28E-06,0,0,#ERROR!
czar,1,1.84E-06,1,2.28E-06,0,0,1
tues,1,1.84E-06,1,2.28E-06,0,0,1
bolt,1,1.84E-06,1,2.28E-06,0,0,1
owed,1,1.84E-06,1,2.28E-06,0,0,1
luke,1,1.84E-06,1,2.28E-06,0,0,1
govs,1,1.84E-06,1,2.28E-06,0,0,1
sung,1,1.84E-06,1,2.28E-06,0,0,1
hyun,1,1.84E-06,1,2.28E-06,0,0,1
rust,1,1.84E-06,1,2.28E-06,0,0,1
belt,1,1.84E-06,1,2.28E-06,0,0,1
nuke,1,1.84E-06,1,2.28E-06,0,0,1
thru,1,1.84E-06,1,2.28E-06,0,0,1
impt,1,1.84E-06,1,2.28E-06,0,0,1
usss,1,1.84E-06,1,2.28E-06,0,0,1
peac,1,1.84E-06,1,2.28E-06,0,0,1
indv,1,1.84E-06,1,2.28E-06,0,0,1
lars,1,1.84E-06,1,2.28E-06,0,0,1
jaws,1,1.84E-06,1,2.28E-06,0,0,1
grea,1,1.84E-06,1,2.28E-06,0,0,1
tapp,1,1.84E-06,1,2.28E-06,0,0,1
ambs,1,1.84E-06,1,2.28E-06,0,0,1
grip,1,1.84E-06,1,2.28E-06,0,0,1
hail,1,1.84E-06,1,2.28E-06,0,0,1
mrxi,1,1.84E-06,1,2.28E-06,0,0,1
serv,1,1.84E-06,1,2.28E-06,0,0,1
airs,1,1.84E-06,1,2.28E-06,0,0,1
muir,1,1.84E-06,1,2.28E-06,0,0,1
bean,1,1.84E-06,1,2.28E-06,0,0,1
nast,1,1.84E-06,1,2.28E-06,0,0,1
baja,1,1.84E-06,1,2.28E-06,0,0,2
trek,1,1.84E-06,1,2.28E-06,0,0,1
asad,1,1.84E-06,1,2.28E-06,0,0,2
slat,1,1.84E-06,1,2.28E-06,0,0,1
rave,1,1.84E-06,1,2.28E-06,0,0,1
cats,1,1.84E-06,1,2.28E-06,0,0,1
lazy,1,1.84E-06,1,2.28E-06,0,0,2
leap,1,1.84E-06,1,2.28E-06,0,0,1
pops,1,1.84E-06,1,2.28E-06,0,0,1
wren,1,1.84E-06,1,2.28E-06,0,0,1
jair,1,1.84E-06,1,2.28E-06,0,0,1
budd,1,1.84E-06,1,2.28E-06,0,0,1
faso,1,1.84E-06,1,2.28E-06,0,0,2
elko,1,1.84E-06,1,2.28E-06,0,0,2
pawn,1,1.84E-06,1,2.28E-06,0,0,1
glen,1,1.84E-06,1,2.28E-06,0,0,1
leos,1,1.84E-06,1,2.28E-06,0,0,1
rows,1,1.84E-06,1,2.28E-06,0,0,1
deem,1,1.84E-06,1,2.28E-06,0,0,1
nash,1,1.84E-06,1,2.28E-06,0,0,1
buoy,1,1.84E-06,1,2.28E-06,0,0,2
cmte,1,1.84E-06,1,2.28E-06,0,0,#ERROR!
dojs,1,1.84E-06,1,2.28E-06,0,0,1
gong,1,1.84E-06,1,2.28E-06,0,0,1
leah,1,1.84E-06,1,2.28E-06,0,0,1
lira,1,1.84E-06,1,2.28E-06,0,0,2
yoho,1,1.84E-06,1,2.28E-06,0,0,2
taxi,1,1.84E-06,1,2.28E-06,0,0,2
cabs,1,1.84E-06,1,2.28E-06,0,0,1
lapd,1,1.84E-06,1,2.28E-06,0,0,1
thai,1,1.84E-06,1,2.28E-06,0,0,1
pore,1,1.84E-06,1,2.28E-06,0,0,1
murl,1,1.84E-06,1,2.28E-06,0,0,1
aura,1,1.84E-06,1,2.28E-06,0,0,2
foil,1,1.84E-06,1,2.28E-06,0,0,1
tusk,1,1.84E-06,1,2.28E-06,0,0,1
meek,1,1.84E-06,1,2.28E-06,0,0,1
mild,1,1.84E-06,1,2.28E-06,0,0,1
awan,1,1.84E-06,1,2.28E-06,0,0,2
pale,1,1.84E-06,1,2.28E-06,0,0,2
chol,1,1.84E-06,1,2.28E-06,0,0,1
cart,1,1.84E-06,1,2.28E-06,0,0,1
jung,1,1.84E-06,1,2.28E-06,0,0,1
dodd,1,1.84E-06,1,2.28E-06,0,0,1
boot,1,1.84E-06,1,2.28E-06,0,0,1
tomi,1,1.84E-06,1,2.28E-06,0,0,2
onso,1,1.84E-06,1,2.28E-06,0,0,2
habit,1,1.84E-06,1,2.28E-06,0,0,2
stat,1,1.84E-06,1,2.28E-06,0,0,1
prey,1,1.84E-06,1,2.28E-06,0,0,1
tend,1,1.84E-06,1,2.28E-06,0,0,1
dire,1,1.84E-06,1,2.28E-06,0,0,1
lord,1,1.84E-06,1,2.28E-06,0,0,1
unto,1,1.84E-06,1,2.28E-06,0,0,2
cope,1,1.84E-06,1,2.28E-06,0,0,1
suvs,1,1.84E-06,1,2.28E-06,0,0,1
erna,1,1.84E-06,1,2.28E-06,0,0,2
fown,1,1.84E-06,1,2.28E-06,0,0,1
logs,1,1.84E-06,1,2.28E-06,0,0,1
saga,1,1.84E-06,1,2.28E-06,0,0,2
turf,1,1.84E-06,1,2.28E-06,0,0,1
slum,1,1.84E-06,1,2.28E-06,0,0,1
carr,1,1.84E-06,1,2.28E-06,0,0,1
apec,1,1.84E-06,1,2.28E-06,0,0,2
rots,1,1.84E-06,1,2.28E-06,0,0,1
wags,1,1.84E-06,1,2.28E-06,0,0,1
dans,1,1.84E-06,1,2.28E-06,0,0,1
wrap,1,1.84E-06,1,2.28E-06,0,0,1
kerr,1,1.84E-06,1,2.28E-06,0,0,1
uber,1,1.84E-06,1,2.28E-06,0,0,2
quos,1,1.84E-06,1,2.28E-06,0,0,1
cited,1,1.84E-06,1,2.28E-06,0,0,1
wash,1,1.84E-06,1,2.28E-06,0,0,1
hugh,1,1.84E-06,1,2.28E-06,0,0,1
moot,1,1.84E-06,1,2.28E-06,0,0,1
peop,1,1.84E-06,1,2.28E-06,0,0,1
yoga,1,1.84E-06,1,2.28E-06,0,0,2
brits,1,1.84E-06,1,2.28E-06,0,0,1
amen,1,1.84E-06,1,2.28E-06,0,0,2
grey,1,1.84E-06,1,2.28E-06,0,0,1
surp,1,1.84E-06,1,2.28E-06,0,0,1
papa,1,1.84E-06,1,2.28E-06,0,0,2
maps,1,1.84E-06,1,2.28E-06,0,0,1
nbcs,1,1.84E-06,1,2.28E-06,0,0,#ERROR!
shoe,1,1.84E-06,1,2.28E-06,0,0,1
corn,1,1.84E-06,1,2.28E-06,0,0,1
snhu,1,1.84E-06,1,2.28E-06,0,0,1
trum,1,1.84E-06,1,2.28E-06,0,0,1
yoes,1,1.84E-06,1,2.28E-06,0,0,1
stre,1,1.84E-06,1,2.28E-06,0,0,#ERROR!
neck,1,1.84E-06,1,2.28E-06,0,0,1
befall,1,1.84E-06,1,2.28E-06,0,0,2
chin,1,1.84E-06,1,2.28E-06,0,0,1
bone,1,1.84E-06,1,2.28E-06,0,0,1
bulb,1,1.84E-06,1,2.28E-06,0,0,1
slim,1,1.84E-06,1,2.28E-06,0,0,1
ieds,1,1.84E-06,1,2.28E-06,0,0,1
efps,1,1.84E-06,1,2.28E-06,0,0,1
defy,1,1.84E-06,1,2.28E-06,0,0,2
harp,1,1.84E-06,1,2.28E-06,0,0,1
loco,1,1.84E-06,1,2.28E-06,0,0,2
sumo,1,1.84E-06,1,2.28E-06,0,0,2
toms,1,1.84E-06,1,2.28E-06,0,0,1
heap,1,1.84E-06,1,2.28E-06,0,0,1
shin,1,1.84E-06,1,2.28E-06,0,0,1
lmao,1,1.84E-06,1,2.28E-06,0,0,1
thos,1,1.84E-06,1,2.28E-06,0,0,1
yuge,1,1.84E-06,1,2.28E-06,0,0,1
peep,1,1.84E-06,1,2.28E-06,0,0,1
bosa,1,1.84E-06,1,2.28E-06,0,0,2
puff,1,1.84E-06,1,2.28E-06,0,0,1
wsjs,1,1.84E-06,1,2.28E-06,0,0,#ERROR!
lima,1,1.84E-06,1,2.28E-06,0,0,2
dash,1,1.84E-06,1,2.28E-06,0,0,1
vest,1,1.84E-06,1,2.28E-06,0,0,1
anti,1,1.84E-06,1,2.28E-06,0,0,2
hans,1,1.84E-06,1,2.28E-06,0,0,1
phuc,1,1.84E-06,1,2.28E-06,0,0,1
hoda,1,1.84E-06,1,2.28E-06,0,0,2
obey,1,1.84E-06,1,2.28E-06,0,0,2
sims,1,1.84E-06,1,2.28E-06,0,0,1
usitc,1,1.84E-06,1,2.28E-06,0,0,2
jens,1,1.84E-06,1,2.28E-06,0,0,1
sotu,1,1.84E-06,1,2.28E-06,0,0,2
oppo,1,1.84E-06,1,2.28E-06,0,0,2
skin,1,1.84E-06,1,2.28E-06,0,0,1
rugs,1,1.84E-06,1,2.28E-06,0,0,1
bozo,1,1.84E-06,1,2.28E-06,0,0,2
nade,1,1.84E-06,1,2.28E-06,0,0,1
wasq,1,1.84E-06,1,2.28E-06,0,0,1
bitten,1,1.84E-06,1,2.28E-06,0,0,2
pitfalls,1,1.84E-06,1,2.28E-06,0,0,2
fittest,1,1.84E-06,0,0,9.47E-06,1,2
stroll,1,1.84E-06,1,2.28E-06,0,0,1
muller,1,1.84E-06,1,2.28E-06,0,0,2
fitting,1,1.84E-06,1,2.28E-06,0,0,2
yelled,1,1.84E-06,1,2.28E-06,0,0,1
digits,1,1.84E-06,0,0,9.47E-06,1,2
uswith,1,1.84E-06,0,0,9.47E-06,1,2
rallied,1,1.84E-06,0,0,9.47E-06,1,2
downit,1,1.84E-06,0,0,9.47E-06,1,2
openit,1,1.84E-06,0,0,9.47E-06,1,3
forits,1,1.84E-06,0,0,9.47E-06,1,2
suited,1,1.84E-06,0,0,9.47E-06,1,1
entity,1,1.84E-06,0,0,9.47E-06,1,3
equity,1,1.84E-06,0,0,9.47E-06,1,3
capita,1,1.84E-06,0,0,9.47E-06,1,3
ferrell,1,1.84E-06,0,0,9.47E-06,1,2
areits,1,1.84E-06,0,0,9.47E-06,1,2
scrolls,1,1.84E-06,0,0,9.47E-06,1,1
satellite,1,1.84E-06,1,2.28E-06,0,0,3
faiths,1,1.84E-06,0,0,9.47E-06,1,1
lititz,1,1.84E-06,1,2.28E-06,0,0,2
mitchs,1,1.84E-06,1,2.28E-06,0,0,1
emmys,1,1.84E-06,1,2.28E-06,0,0,2
sitcom,1,1.84E-06,1,2.28E-06,0,0,2
fellows,1,1.84E-06,0,0,9.47E-06,1,2
summon,1,1.84E-06,0,0,9.47E-06,1,2
bullied,1,1.84E-06,0,0,9.47E-06,1,2
loyally,1,1.84E-06,1,2.28E-06,0,0,3
capito,1,1.84E-06,1,2.28E-06,0,0,3
pillage,1,1.84E-06,1,2.28E-06,0,0,2
allianz,1,1.84E-06,1,2.28E-06,0,0,2
install,1,1.84E-06,1,2.28E-06,0,0,2
littlest,1,1.84E-06,0,0,9.47E-06,1,2
summed,1,1.84E-06,1,2.28E-06,0,0,1
incite,1,1.84E-06,1,2.28E-06,0,0,2
follows,1,1.84E-06,1,2.28E-06,0,0,2
deceit,1,1.84E-06,1,2.28E-06,0,0,2
sellout,1,1.84E-06,1,2.28E-06,0,0,2
collect,1,1.84E-06,1,2.28E-06,0,0,2
gallons,1,1.84E-06,1,2.28E-06,0,0,2
pillars,1,1.84E-06,1,2.28E-06,0,0,2
ballard,1,1.84E-06,1,2.28E-06,0,0,2
pinned,1,1.84E-06,1,2.28E-06,0,0,1
littered,1,1.84E-06,1,2.28E-06,0,0,2
penned,1,1.84E-06,1,2.28E-06,0,0,1
falwell,1,1.84E-06,1,2.28E-06,0,0,2
whitsett,1,1.84E-06,1,2.28E-06,0,0,2
ignite,1,1.84E-06,1,2.28E-06,0,0,2
kellogg,1,1.84E-06,1,2.28E-06,0,0,2
corolla,1,1.84E-06,1,2.28E-06,0,0,3
fruits,1,1.84E-06,1,2.28E-06,0,0,1
bullets,1,1.84E-06,1,2.28E-06,0,0,2
fatally,1,1.84E-06,1,2.28E-06,0,0,3
aideit,1,1.84E-06,1,2.28E-06,0,0,2
recite,1,1.84E-06,1,2.28E-06,0,0,2
strait,1,1.84E-06,1,2.28E-06,0,0,1
collier,1,1.84E-06,1,2.28E-06,0,0,2
phillip,1,1.84E-06,1,2.28E-06,0,0,2
quitters,1,1.84E-06,1,2.28E-06,0,0,2
grenell,1,1.84E-06,1,2.28E-06,0,0,2
fallout,1,1.84E-06,1,2.28E-06,0,0,2
attire,1,1.84E-06,0,0,9.47E-06,1,2
guitar,1,1.84E-06,1,2.28E-06,0,0,2
crummy,1,1.84E-06,1,2.28E-06,0,0,2
polite,1,1.84E-06,1,2.28E-06,0,0,2
littlewe,1,1.84E-06,1,2.28E-06,0,0,2
polar,1,1.84E-06,0,0,9.47E-06,1,2
whale,1,1.84E-06,0,0,9.47E-06,1,2
sixty,1,1.84E-06,0,0,9.47E-06,1,2
illicitly,1,1.84E-06,1,2.28E-06,0,0,4
avert,1,1.84E-06,0,0,9.47E-06,1,2
hawks,1,1.84E-06,0,0,9.47E-06,1,1
blues,1,1.84E-06,0,0,9.47E-06,1,1
nerdy,1,1.84E-06,0,0,9.47E-06,1,2
nimoy,1,1.84E-06,0,0,9.47E-06,1,2
freer,1,1.84E-06,0,0,9.47E-06,1,1
cubis,1,1.84E-06,0,0,9.47E-06,1,2
wedge,1,1.84E-06,0,0,9.47E-06,1,1
lions,1,1.84E-06,0,0,9.47E-06,1,1
doris,1,1.84E-06,0,0,9.47E-06,1,2
usnot,1,1.84E-06,0,0,9.47E-06,1,2
warms,1,1.84E-06,0,0,9.47E-06,1,1
genie,1,1.84E-06,0,0,9.47E-06,1,2
noise,1,1.84E-06,0,0,9.47E-06,1,1
fewwe,1,1.84E-06,0,0,9.47E-06,1,1
warns,1,1.84E-06,0,0,9.47E-06,1,1
teami,1,1.84E-06,0,0,9.47E-06,1,2
slice,1,1.84E-06,0,0,9.47E-06,1,1
fafsa,1,1.84E-06,0,0,9.47E-06,1,2
youwe,1,1.84E-06,0,0,9.47E-06,1,1
eager,1,1.84E-06,0,0,9.47E-06,1,2
nowim,1,1.84E-06,0,0,9.47E-06,1,2
refitted,1,1.84E-06,1,2.28E-06,0,0,2
texan,1,1.84E-06,0,0,9.47E-06,1,2
shrek,1,1.84E-06,0,0,9.47E-06,1,1
opted,1,1.84E-06,0,0,9.47E-06,1,1
wether,1,1.84E-06,1,2.28E-06,0,0,2
twain,1,1.84E-06,0,0,9.47E-06,1,1
subcommittee,1,1.84E-06,1,2.28E-06,0,0,4
gases,1,1.84E-06,0,0,9.47E-06,1,1
skyfall,1,1.84E-06,1,2.28E-06,0,0,2
cadet,1,1.84E-06,0,0,9.47E-06,1,2
jrotc,1,1.84E-06,0,0,9.47E-06,1,1
wears,1,1.84E-06,0,0,9.47E-06,1,1
timea,1,1.84E-06,0,0,9.47E-06,1,2
rungs,1,1.84E-06,0,0,9.47E-06,1,1
helen,1,1.84E-06,0,0,9.47E-06,1,2
berry,1,1.84E-06,0,0,9.47E-06,1,2
snack,1,1.84E-06,0,0,9.47E-06,1,1
acquitted,1,1.84E-06,1,2.28E-06,0,0,2
adapt,1,1.84E-06,0,0,9.47E-06,1,2
nowto,1,1.84E-06,0,0,9.47E-06,1,2
dayto,1,1.84E-06,0,0,9.47E-06,1,2
cincy,1,1.84E-06,0,0,9.47E-06,1,2
blade,1,1.84E-06,0,0,9.47E-06,1,1
guyhe,1,1.84E-06,0,0,9.47E-06,1,1
arlen,1,1.84E-06,0,0,9.47E-06,1,2
equip,1,1.84E-06,0,0,9.47E-06,1,2
faithfully,1,1.84E-06,1,2.28E-06,0,0,3
stark,1,1.84E-06,0,0,9.47E-06,1,1
coops,1,1.84E-06,0,0,9.47E-06,1,1
aisle,1,1.84E-06,0,0,9.47E-06,1,2
mebut,1,1.84E-06,0,0,9.47E-06,1,2
react,1,1.84E-06,0,0,9.47E-06,1,1
dayif,1,1.84E-06,0,0,9.47E-06,1,2
swoop,1,1.84E-06,0,0,9.47E-06,1,1
submittal,1,1.84E-06,1,2.28E-06,0,0,3
deval,1,1.84E-06,0,0,9.47E-06,1,2
truei,1,1.84E-06,0,0,9.47E-06,1,2
akins,1,1.84E-06,0,0,9.47E-06,1,2
knots,1,1.84E-06,0,0,9.47E-06,1,1
circa,1,1.84E-06,0,0,9.47E-06,1,2
iowas,1,1.84E-06,0,0,9.47E-06,1,2
cones,1,1.84E-06,0,0,9.47E-06,1,1
pants,1,1.84E-06,0,0,9.47E-06,1,1
fairy,1,1.84E-06,0,0,9.47E-06,1,2
rover,1,1.84E-06,0,0,9.47E-06,1,2
fives,1,1.84E-06,0,0,9.47E-06,1,1
barns,1,1.84E-06,0,0,9.47E-06,1,1
yourt,1,1.84E-06,0,0,9.47E-06,1,1
scout,1,1.84E-06,0,0,9.47E-06,1,1
doers,1,1.84E-06,0,0,9.47E-06,1,1
recap,1,1.84E-06,0,0,9.47E-06,1,2
expel,1,1.84E-06,0,0,9.47E-06,1,2
shoes,1,1.84E-06,0,0,9.47E-06,1,1
faris,1,1.84E-06,0,0,9.47E-06,1,2
repay,1,1.84E-06,0,0,9.47E-06,1,2
vibes,1,1.84E-06,0,0,9.47E-06,1,1
fares,1,1.84E-06,0,0,9.47E-06,1,1
julia,1,1.84E-06,0,0,9.47E-06,1,2
banka,1,1.84E-06,0,0,9.47E-06,1,2
abyss,1,1.84E-06,0,0,9.47E-06,1,2
seder,1,1.84E-06,0,0,9.47E-06,1,2
pokey,1,1.84E-06,0,0,9.47E-06,1,2
admittance,1,1.84E-06,1,2.28E-06,0,0,3
kiddo,1,1.84E-06,0,0,9.47E-06,1,2
hanks,1,1.84E-06,0,0,9.47E-06,1,1
fluke,1,1.84E-06,0,0,9.47E-06,1,1
chips,1,1.84E-06,0,0,9.47E-06,1,1
draws,1,1.84E-06,0,0,9.47E-06,1,1
ounce,1,1.84E-06,0,0,9.47E-06,1,1
excel,1,1.84E-06,0,0,9.47E-06,1,2
seoul,1,1.84E-06,0,0,9.47E-06,1,2
bosss,1,1.84E-06,0,0,9.47E-06,1,1
frees,1,1.84E-06,0,0,9.47E-06,1,1
wilco,1,1.84E-06,0,0,9.47E-06,1,2
waned,1,1.84E-06,0,0,9.47E-06,1,1
rings,1,1.84E-06,0,0,9.47E-06,1,1
hiked,1,1.84E-06,0,0,9.47E-06,1,1
dined,1,1.84E-06,0,0,9.47E-06,1,1
merch,1,1.84E-06,0,0,9.47E-06,1,1
colon,1,1.84E-06,0,0,9.47E-06,1,2
shela,1,1.84E-06,0,0,9.47E-06,1,2
wendi,1,1.84E-06,0,0,9.47E-06,1,2
shiny,1,1.84E-06,0,0,9.47E-06,1,2
scanned,1,1.84E-06,1,2.28E-06,0,0,1
lapel,1,1.84E-06,0,0,9.47E-06,1,2
meyer,1,1.84E-06,0,0,9.47E-06,1,2
tenth,1,1.84E-06,0,0,9.47E-06,1,1
apron,1,1.84E-06,0,0,9.47E-06,1,2
hilda,1,1.84E-06,0,0,9.47E-06,1,2
solis,1,1.84E-06,0,0,9.47E-06,1,2
label,1,1.84E-06,0,0,9.47E-06,1,2
marta,1,1.84E-06,0,0,9.47E-06,1,2
bolts,1,1.84E-06,0,0,9.47E-06,1,1
donow,1,1.84E-06,0,0,9.47E-06,1,2
forgo,1,1.84E-06,0,0,9.47E-06,1,2
lifts,1,1.84E-06,0,0,9.47E-06,1,1
upare,1,1.84E-06,0,0,9.47E-06,1,2
aunts,1,1.84E-06,0,0,9.47E-06,1,1
quran,1,1.84E-06,0,0,9.47E-06,1,2
iraqi,1,1.84E-06,0,0,9.47E-06,1,3
slips,1,1.84E-06,0,0,9.47E-06,1,1
byrds,1,1.84E-06,0,0,9.47E-06,1,1
fuels,1,1.84E-06,0,0,9.47E-06,1,1
backi,1,1.84E-06,0,0,9.47E-06,1,2
horne,1,1.84E-06,0,0,9.47E-06,1,1
stirs,1,1.84E-06,0,0,9.47E-06,1,1
canal,1,1.84E-06,0,0,9.47E-06,1,2
youon,1,1.84E-06,0,0,9.47E-06,1,2
souza,1,1.84E-06,0,0,9.47E-06,1,2
singh,1,1.84E-06,0,0,9.47E-06,1,1
ankle,1,1.84E-06,0,0,9.47E-06,1,2
cairo,1,1.84E-06,0,0,9.47E-06,1,2
megyn,1,1.84E-06,1,2.28E-06,0,0,2
hotly,1,1.84E-06,1,2.28E-06,0,0,2
raked,1,1.84E-06,1,2.28E-06,0,0,1
nikol,1,1.84E-06,1,2.28E-06,0,0,2
ilham,1,1.84E-06,1,2.28E-06,0,0,2
grammys,1,1.84E-06,0,0,9.47E-06,1,2
fleet,1,1.84E-06,1,2.28E-06,0,0,1
ghost,1,1.84E-06,1,2.28E-06,0,0,1
alter,1,1.84E-06,1,2.28E-06,0,0,2
salem,1,1.84E-06,1,2.28E-06,0,0,2
baris,1,1.84E-06,1,2.28E-06,0,0,2
shuts,1,1.84E-06,1,2.28E-06,0,0,1
rakes,1,1.84E-06,1,2.28E-06,0,0,1
slack,1,1.84E-06,1,2.28E-06,0,0,1
chele,1,1.84E-06,1,2.28E-06,0,0,2
fking,1,1.84E-06,1,2.28E-06,0,0,1
nehls,1,1.84E-06,1,2.28E-06,0,0,1
rosen,1,1.84E-06,1,2.28E-06,0,0,2
todos,1,1.84E-06,1,2.28E-06,0,0,2
doses,1,1.84E-06,1,2.28E-06,0,0,1
tonys,1,1.84E-06,1,2.28E-06,0,0,2
poles,1,1.84E-06,1,2.28E-06,0,0,2
arise,1,1.84E-06,1,2.28E-06,0,0,2
thune,1,1.84E-06,1,2.28E-06,0,0,1
thick,1,1.84E-06,1,2.28E-06,0,0,1
flips,1,1.84E-06,1,2.28E-06,0,0,1
submitting,1,1.84E-06,1,2.28E-06,0,0,3
shawn,1,1.84E-06,1,2.28E-06,0,0,1
junge,1,1.84E-06,1,2.28E-06,0,0,1
ernst,1,1.84E-06,1,2.28E-06,0,0,1
steep,1,1.84E-06,1,2.28E-06,0,0,1
pumps,1,1.84E-06,1,2.28E-06,0,0,1
blend,1,1.84E-06,1,2.28E-06,0,0,1
brawl,1,1.84E-06,1,2.28E-06,0,0,1
recommits,1,1.84E-06,1,2.28E-06,0,0,3
bullard,1,1.84E-06,1,2.28E-06,0,0,2
amash,1,1.84E-06,1,2.28E-06,0,0,2
ossof,1,1.84E-06,1,2.28E-06,0,0,2
waver,1,1.84E-06,1,2.28E-06,0,0,2
joyce,1,1.84E-06,1,2.28E-06,0,0,1
sneak,1,1.84E-06,1,2.28E-06,0,0,1
rabid,1,1.84E-06,1,2.28E-06,0,0,2
claen,1,1.84E-06,1,2.28E-06,0,0,1
heals,1,1.84E-06,1,2.28E-06,0,0,1
uncle,1,1.84E-06,1,2.28E-06,0,0,2
bryce,1,1.84E-06,1,2.28E-06,0,0,1
gaunt,1,1.84E-06,1,2.28E-06,0,0,1
clyde,1,1.84E-06,1,2.28E-06,0,0,1
gowns,1,1.84E-06,1,2.28E-06,0,0,1
timer,1,1.84E-06,1,2.28E-06,0,0,2
forge,1,1.84E-06,1,2.28E-06,0,0,1
edged,1,1.84E-06,1,2.28E-06,0,0,1
cache,1,1.84E-06,1,2.28E-06,0,0,1
forks,1,1.84E-06,1,2.28E-06,0,0,1
nightit,1,1.84E-06,0,0,9.47E-06,1,2
itwhich,1,1.84E-06,0,0,9.47E-06,1,2
dagen,1,1.84E-06,1,2.28E-06,0,0,2
conor,1,1.84E-06,1,2.28E-06,0,0,2
deven,1,1.84E-06,1,2.28E-06,0,0,2
optic,1,1.84E-06,1,2.28E-06,0,0,2
puget,1,1.84E-06,1,2.28E-06,0,0,2
links,1,1.84E-06,1,2.28E-06,0,0,1
poker,1,1.84E-06,1,2.28E-06,0,0,2
stats,1,1.84E-06,1,2.28E-06,0,0,1
usurp,1,1.84E-06,1,2.28E-06,0,0,2
exhibit,1,1.84E-06,0,0,9.47E-06,1,3
waldo,1,1.84E-06,1,2.28E-06,0,0,2
tours,1,1.84E-06,1,2.28E-06,0,0,1
erick,1,1.84E-06,1,2.28E-06,0,0,2
thier,1,1.84E-06,1,2.28E-06,0,0,1
clubs,1,1.84E-06,1,2.28E-06,0,0,1
rifle,1,1.84E-06,1,2.28E-06,0,0,2
hakes,1,1.84E-06,1,2.28E-06,0,0,1
clint,1,1.84E-06,1,2.28E-06,0,0,1
ogden,1,1.84E-06,1,2.28E-06,0,0,2
vague,1,1.84E-06,1,2.28E-06,0,0,2
bored,1,1.84E-06,1,2.28E-06,0,0,1
sucks,1,1.84E-06,1,2.28E-06,0,0,1
debts,1,1.84E-06,1,2.28E-06,0,0,1
elder,1,1.84E-06,1,2.28E-06,0,0,2
hazel,1,1.84E-06,1,2.28E-06,0,0,2
brief,1,1.84E-06,1,2.28E-06,0,0,1
peaks,1,1.84E-06,1,2.28E-06,0,0,1
swore,1,1.84E-06,1,2.28E-06,0,0,1
haven,1,1.84E-06,1,2.28E-06,0,0,2
orrin,1,1.84E-06,1,2.28E-06,0,0,2
hatch,1,1.84E-06,1,2.28E-06,0,0,1
crist,1,1.84E-06,1,2.28E-06,0,0,1
metal,1,1.84E-06,1,2.28E-06,0,0,2
pease,1,1.84E-06,1,2.28E-06,0,0,1
eaten,1,1.84E-06,1,2.28E-06,0,0,2
shari,1,1.84E-06,1,2.28E-06,0,0,2
macys,1,1.84E-06,1,2.28E-06,0,0,2
meter,1,1.84E-06,1,2.28E-06,0,0,2
wired,1,1.84E-06,1,2.28E-06,0,0,1
furor,1,1.84E-06,1,2.28E-06,0,0,2
miner,1,1.84E-06,1,2.28E-06,0,0,2
spoof,1,1.84E-06,1,2.28E-06,0,0,1
navid,1,1.84E-06,1,2.28E-06,0,0,2
wings,1,1.84E-06,1,2.28E-06,0,0,1
juror,1,1.84E-06,1,2.28E-06,0,0,2
morse,1,1.84E-06,1,2.28E-06,0,0,1
piers,1,1.84E-06,1,2.28E-06,0,0,1
seige,1,1.84E-06,1,2.28E-06,0,0,1
codes,1,1.84E-06,1,2.28E-06,0,0,1
humor,1,1.84E-06,1,2.28E-06,0,0,2
stoke,1,1.84E-06,1,2.28E-06,0,0,1
aided,1,1.84E-06,1,2.28E-06,0,0,1
casco,1,1.84E-06,1,2.28E-06,0,0,2
trees,1,1.84E-06,1,2.28E-06,0,0,1
frisk,1,1.84E-06,1,2.28E-06,0,0,1
givng,1,1.84E-06,1,2.28E-06,0,0,1
reyes,1,1.84E-06,1,2.28E-06,0,0,2
gravy,1,1.84E-06,1,2.28E-06,0,0,2
posey,1,1.84E-06,1,2.28E-06,0,0,2
commodity,1,1.84E-06,1,2.28E-06,0,0,4
rivas,1,1.84E-06,1,2.28E-06,0,0,2
arson,1,1.84E-06,1,2.28E-06,0,0,2
nayib,1,1.84E-06,1,2.28E-06,0,0,2
shops,1,1.84E-06,1,2.28E-06,0,0,1
welch,1,1.84E-06,1,2.28E-06,0,0,1
ahmed,1,1.84E-06,1,2.28E-06,0,0,1
timid,1,1.84E-06,1,2.28E-06,0,0,2
flown,1,1.84E-06,1,2.28E-06,0,0,1
stollen,1,1.84E-06,1,2.28E-06,0,0,2
idled,1,1.84E-06,1,2.28E-06,0,0,1
gripe,1,1.84E-06,1,2.28E-06,0,0,1
patio,1,1.84E-06,1,2.28E-06,0,0,2
gaffe,1,1.84E-06,1,2.28E-06,0,0,1
latter,1,1.84E-06,1,2.28E-06,0,0,2
wanda,1,1.84E-06,1,2.28E-06,0,0,2
shedd,1,1.84E-06,1,2.28E-06,0,0,1
juanita,1,1.84E-06,0,0,9.47E-06,1,3
jobsits,1,1.84E-06,0,0,9.47E-06,1,2
crook,1,1.84E-06,1,2.28E-06,0,0,1
fines,1,1.84E-06,1,2.28E-06,0,0,1
skies,1,1.84E-06,1,2.28E-06,0,0,1
utahs,1,1.84E-06,1,2.28E-06,0,0,2
felon,1,1.84E-06,1,2.28E-06,0,0,2
organ,1,1.84E-06,1,2.28E-06,0,0,2
linea,1,1.84E-06,1,2.28E-06,0,0,2
shift,1,1.84E-06,1,2.28E-06,0,0,1
inlet,1,1.84E-06,1,2.28E-06,0,0,2
zinke,1,1.84E-06,1,2.28E-06,0,0,1
indiv,1,1.84E-06,1,2.28E-06,0,0,2
quang,1,1.84E-06,1,2.28E-06,0,0,1
fatal,1,1.84E-06,1,2.28E-06,0,0,2
skilled,1,1.84E-06,1,2.28E-06,0,0,1
widow,1,1.84E-06,1,2.28E-06,0,0,2
hails,1,1.84E-06,1,2.28E-06,0,0,1
hides,1,1.84E-06,1,2.28E-06,0,0,1
guise,1,1.84E-06,1,2.28E-06,0,0,1
looms,1,1.84E-06,1,2.28E-06,0,0,1
leaps,1,1.84E-06,1,2.28E-06,0,0,1
ricky,1,1.84E-06,1,2.28E-06,0,0,2
docks,1,1.84E-06,1,2.28E-06,0,0,1
usain,1,1.84E-06,1,2.28E-06,0,0,2
yulin,1,1.84E-06,1,2.28E-06,0,0,2
etcwe,1,1.84E-06,1,2.28E-06,0,0,1
nflor,1,1.84E-06,1,2.28E-06,0,0,1
curry,1,1.84E-06,1,2.28E-06,0,0,2
summary,1,1.84E-06,0,0,9.47E-06,1,3
payer,1,1.84E-06,1,2.28E-06,0,0,2
curse,1,1.84E-06,1,2.28E-06,0,0,1
haunt,1,1.84E-06,1,2.28E-06,0,0,1
najib,1,1.84E-06,1,2.28E-06,0,0,2
abdul,1,1.84E-06,1,2.28E-06,0,0,2
razak,1,1.84E-06,1,2.28E-06,0,0,2
repub,1,1.84E-06,1,2.28E-06,0,0,2
wayif,1,1.84E-06,1,2.28E-06,0,0,2
weary,1,1.84E-06,1,2.28E-06,0,0,2
rains,1,1.84E-06,1,2.28E-06,0,0,1
staes,1,1.84E-06,1,2.28E-06,0,0,1
whope,1,1.84E-06,1,2.28E-06,0,0,1
heros,1,1.84E-06,1,2.28E-06,0,0,2
shine,1,1.84E-06,1,2.28E-06,0,0,1
sewer,1,1.84E-06,1,2.28E-06,0,0,2
screg,1,1.84E-06,1,2.28E-06,0,0,1
slate,1,1.84E-06,1,2.28E-06,0,0,1
bared,1,1.84E-06,1,2.28E-06,0,0,1
moons,1,1.84E-06,1,2.28E-06,0,0,1
sugar,1,1.84E-06,1,2.28E-06,0,0,2
choke,1,1.84E-06,1,2.28E-06,0,0,1
pavlo,1,1.84E-06,1,2.28E-06,0,0,2
rosie,1,1.84E-06,1,2.28E-06,0,0,2
awada,1,1.84E-06,1,2.28E-06,0,0,3
paolo,1,1.84E-06,1,2.28E-06,0,0,2
betwe,1,1.84E-06,1,2.28E-06,0,0,1
folds,1,1.84E-06,1,2.28E-06,0,0,1
irony,1,1.84E-06,1,2.28E-06,0,0,3
irish,1,1.84E-06,1,2.28E-06,0,0,2
exxon,1,1.84E-06,1,2.28E-06,0,0,2
mobil,1,1.84E-06,1,2.28E-06,0,0,2
wires,1,1.84E-06,1,2.28E-06,0,0,1
aetna,1,1.84E-06,1,2.28E-06,0,0,2
assoc,1,1.84E-06,1,2.28E-06,0,0,2
dudes,1,1.84E-06,1,2.28E-06,0,0,1
bayer,1,1.84E-06,1,2.28E-06,0,0,2
bushs,1,1.84E-06,1,2.28E-06,0,0,1
meare,1,1.84E-06,1,2.28E-06,0,0,1
meryl,1,1.84E-06,1,2.28E-06,0,0,2
conde,1,1.84E-06,1,2.28E-06,0,0,1
album,1,1.84E-06,1,2.28E-06,0,0,2
scrap,1,1.84E-06,1,2.28E-06,0,0,1
chevy,1,1.84E-06,1,2.28E-06,0,0,2
cruze,1,1.84E-06,1,2.28E-06,0,0,1
usaor,1,1.84E-06,1,2.28E-06,0,0,2
amuck,1,1.84E-06,1,2.28E-06,0,0,2
yahoo,1,1.84E-06,1,2.28E-06,0,0,2
dopey,1,1.84E-06,1,2.28E-06,0,0,2
bleed,1,1.84E-06,1,2.28E-06,0,0,1
vying,1,1.84E-06,1,2.28E-06,0,0,1
shunned,1,1.84E-06,1,2.28E-06,0,0,1
ayers,1,1.84E-06,1,2.28E-06,0,0,2
dicks,1,1.84E-06,1,2.28E-06,0,0,1
blair,1,1.84E-06,1,2.28E-06,0,0,1
taxis,1,1.84E-06,1,2.28E-06,0,0,2
aires,1,1.84E-06,1,2.28E-06,0,0,1
whiff,1,1.84E-06,1,2.28E-06,0,0,1
garza,1,1.84E-06,1,2.28E-06,0,0,2
waged,1,1.84E-06,1,2.28E-06,0,0,1
hindu,1,1.84E-06,1,2.28E-06,0,0,2
elias,1,1.84E-06,1,2.28E-06,0,0,2
hugin,1,1.84E-06,1,2.28E-06,0,0,2
radar,1,1.84E-06,1,2.28E-06,0,0,2
mines,1,1.84E-06,1,2.28E-06,0,0,1
polis,1,1.84E-06,1,2.28E-06,0,0,2
clone,1,1.84E-06,1,2.28E-06,0,0,1
thief,1,1.84E-06,1,2.28E-06,0,0,1
flame,1,1.84E-06,1,2.28E-06,0,0,1
loose,1,1.84E-06,1,2.28E-06,0,0,1
slows,1,1.84E-06,1,2.28E-06,0,0,1
blimp,1,1.84E-06,1,2.28E-06,0,0,1
lowly,1,1.84E-06,1,2.28E-06,0,0,2
spate,1,1.84E-06,1,2.28E-06,0,0,1
biggs,1,1.84E-06,1,2.28E-06,0,0,1
wpost,1,1.84E-06,1,2.28E-06,0,0,1
trish,1,1.84E-06,1,2.28E-06,0,0,1
regan,1,1.84E-06,1,2.28E-06,0,0,2
bride,1,1.84E-06,1,2.28E-06,0,0,1
algae,1,1.84E-06,1,2.28E-06,0,0,2
soros,1,1.84E-06,1,2.28E-06,0,0,2
charm,1,1.84E-06,1,2.28E-06,0,0,1
brock,1,1.84E-06,1,2.28E-06,0,0,1
snuck,1,1.84E-06,1,2.28E-06,0,0,1
shana,1,1.84E-06,1,2.28E-06,0,0,2
feats,1,1.84E-06,1,2.28E-06,0,0,1
gutted,1,1.84E-06,1,2.28E-06,0,0,1
lacky,1,1.84E-06,1,2.28E-06,0,0,2
scary,1,1.84E-06,1,2.28E-06,0,0,2
kenya,1,1.84E-06,1,2.28E-06,0,0,2
ducey,1,1.84E-06,1,2.28E-06,0,0,2
raves,1,1.84E-06,1,2.28E-06,0,0,1
overt,1,1.84E-06,1,2.28E-06,0,0,2
ohios,1,1.84E-06,1,2.28E-06,0,0,2
duerk,1,1.84E-06,1,2.28E-06,0,0,1
taped,1,1.84E-06,1,2.28E-06,0,0,1
butas,1,1.84E-06,1,2.28E-06,0,0,2
yoder,1,1.84E-06,1,2.28E-06,0,0,2
gates,1,1.84E-06,1,2.28E-06,0,0,1
gaetz,1,1.84E-06,1,2.28E-06,0,0,1
layer,1,1.84E-06,1,2.28E-06,0,0,2
beans,1,1.84E-06,1,2.28E-06,0,0,1
seals,1,1.84E-06,1,2.28E-06,0,0,1
sweat,1,1.84E-06,1,2.28E-06,0,0,1
patton,1,1.84E-06,1,2.28E-06,0,0,2
grasp,1,1.84E-06,1,2.28E-06,0,0,1
sousa,1,1.84E-06,1,2.28E-06,0,0,2
rants,1,1.84E-06,1,2.28E-06,0,0,1
huntp,1,1.84E-06,1,2.28E-06,0,0,1
kaine,1,1.84E-06,1,2.28E-06,0,0,1
hsien,1,1.84E-06,1,2.28E-06,0,0,1
loong,1,1.84E-06,1,2.28E-06,0,0,1
bigwe,1,1.84E-06,1,2.28E-06,0,0,1
irwin,1,1.84E-06,1,2.28E-06,0,0,2
swept,1,1.84E-06,1,2.28E-06,0,0,1
artie,1,1.84E-06,1,2.28E-06,0,0,2
setter,1,1.84E-06,1,2.28E-06,0,0,2
alway,1,1.84E-06,1,2.28E-06,0,0,2
magoo,1,1.84E-06,1,2.28E-06,0,0,2
wendy,1,1.84E-06,1,2.28E-06,0,0,2
depth,1,1.84E-06,1,2.28E-06,0,0,1
whack,1,1.84E-06,1,2.28E-06,0,0,1
botch,1,1.84E-06,1,2.28E-06,0,0,1
skype,1,1.84E-06,1,2.28E-06,0,0,1
perks,1,1.84E-06,1,2.28E-06,0,0,1
zuker,1,1.84E-06,1,2.28E-06,0,0,2
korus,1,1.84E-06,1,2.28E-06,0,0,2
urged,1,1.84E-06,1,2.28E-06,0,0,1
hegar,1,1.84E-06,1,2.28E-06,0,0,2
straw,1,1.84E-06,1,2.28E-06,0,0,1
lasts,1,1.84E-06,1,2.28E-06,0,0,1
brody,1,1.84E-06,1,2.28E-06,0,0,2
asses,1,1.84E-06,1,2.28E-06,0,0,1
pound,1,1.84E-06,1,2.28E-06,0,0,1
usher,1,1.84E-06,1,2.28E-06,0,0,2
oksen,1,1.84E-06,1,2.28E-06,0,0,2
dicky,1,1.84E-06,1,2.28E-06,0,0,2
crisp,1,1.84E-06,1,2.28E-06,0,0,1
teeth,1,1.84E-06,1,2.28E-06,0,0,1
haitian,1,1.84E-06,0,0,9.47E-06,1,2
gigot,1,1.84E-06,1,2.28E-06,0,0,2
prays,1,1.84E-06,1,2.28E-06,0,0,1
agnes,1,1.84E-06,1,2.28E-06,0,0,1
yesrs,1,1.84E-06,1,2.28E-06,0,0,1
enact,1,1.84E-06,1,2.28E-06,0,0,2
cookl,1,1.84E-06,1,2.28E-06,0,0,1
womem,1,1.84E-06,1,2.28E-06,0,0,2
juicy,1,1.84E-06,1,2.28E-06,0,0,2
marie,1,1.84E-06,1,2.28E-06,0,0,2
filth,1,1.84E-06,1,2.28E-06,0,0,1
vadym,1,1.84E-06,1,2.28E-06,0,0,2
lowry,1,1.84E-06,1,2.28E-06,0,0,2
nails,1,1.84E-06,1,2.28E-06,0,0,1
cetra,1,1.84E-06,1,2.28E-06,0,0,2
wimps,1,1.84E-06,1,2.28E-06,0,0,1
freak,1,1.84E-06,1,2.28E-06,0,0,1
conan,1,1.84E-06,1,2.28E-06,0,0,2
nunez,1,1.84E-06,1,2.28E-06,0,0,2
swipe,1,1.84E-06,1,2.28E-06,0,0,1
proce,1,1.84E-06,1,2.28E-06,0,0,1
lefty,1,1.84E-06,1,2.28E-06,0,0,2
turks,1,1.84E-06,1,2.28E-06,0,0,1
drunk,1,1.84E-06,1,2.28E-06,0,0,1
daddy,1,1.84E-06,1,2.28E-06,0,0,2
wirch,1,1.84E-06,1,2.28E-06,0,0,1
ferrells,1,1.84E-06,0,0,9.47E-06,1,2
gerry,1,1.84E-06,1,2.28E-06,0,0,2
ketay,1,1.84E-06,1,2.28E-06,0,0,2
versa,1,1.84E-06,1,2.28E-06,0,0,2
zaino,1,1.84E-06,1,2.28E-06,0,0,2
wenti,1,1.84E-06,1,2.28E-06,0,0,2
aloud,1,1.84E-06,1,2.28E-06,0,0,2
duffy,1,1.84E-06,1,2.28E-06,0,0,2
bound,1,1.84E-06,1,2.28E-06,0,0,1
slush,1,1.84E-06,1,2.28E-06,0,0,1
clash,1,1.84E-06,1,2.28E-06,0,0,1
hajec,1,1.84E-06,1,2.28E-06,0,0,2
debra,1,1.84E-06,1,2.28E-06,0,0,2
ambro,1,1.84E-06,1,2.28E-06,0,0,2
safir,1,1.84E-06,1,2.28E-06,0,0,2
giddy,1,1.84E-06,1,2.28E-06,0,0,2
zogby,1,1.84E-06,1,2.28E-06,0,0,2
tense,1,1.84E-06,1,2.28E-06,0,0,1
powel,1,1.84E-06,1,2.28E-06,0,0,2
cousy,1,1.84E-06,1,2.28E-06,0,0,2
sloan,1,1.84E-06,1,2.28E-06,0,0,1
tattoo,1,1.84E-06,1,2.28E-06,0,0,2
elton,1,1.84E-06,1,2.28E-06,0,0,2
negop,1,1.84E-06,1,2.28E-06,0,0,2
colby,1,1.84E-06,1,2.28E-06,0,0,2
shook,1,1.84E-06,1,2.28E-06,0,0,1
juice,1,1.84E-06,1,2.28E-06,0,0,1
nowor,1,1.84E-06,1,2.28E-06,0,0,2
misty,1,1.84E-06,1,2.28E-06,0,0,2
fulfills,1,1.84E-06,0,0,9.47E-06,1,2
vouch,1,1.84E-06,1,2.28E-06,0,0,1
boxer,1,1.84E-06,1,2.28E-06,0,0,2
thiel,1,1.84E-06,1,2.28E-06,0,0,1
fword,1,1.84E-06,1,2.28E-06,0,0,1
pauls,1,1.84E-06,1,2.28E-06,0,0,1
derco,1,1.84E-06,1,2.28E-06,0,0,2
lurch,1,1.84E-06,1,2.28E-06,0,0,1
citadel,1,1.84E-06,1,2.28E-06,0,0,3
doocy,1,1.84E-06,1,2.28E-06,0,0,2
cline,1,1.84E-06,1,2.28E-06,0,0,1
bands,1,1.84E-06,1,2.28E-06,0,0,1
tanks,1,1.84E-06,1,2.28E-06,0,0,1
spine,1,1.84E-06,1,2.28E-06,0,0,1
garys,1,1.84E-06,1,2.28E-06,0,0,2
wannabe,1,1.84E-06,1,2.28E-06,0,0,2
wales,1,1.84E-06,1,2.28E-06,0,0,2
agata,1,1.84E-06,1,2.28E-06,0,0,3
dagan,1,1.84E-06,1,2.28E-06,0,0,2
bates,1,1.84E-06,1,2.28E-06,0,0,1
flops,1,1.84E-06,1,2.28E-06,0,0,1
amway,1,1.84E-06,1,2.28E-06,0,0,2
pinto,1,1.84E-06,1,2.28E-06,0,0,2
simon,1,1.84E-06,1,2.28E-06,0,0,2
chiba,1,1.84E-06,1,2.28E-06,0,0,2
bidan,1,1.84E-06,1,2.28E-06,0,0,2
wthis,1,1.84E-06,1,2.28E-06,0,0,1
batch,1,1.84E-06,1,2.28E-06,0,0,1
brain,1,1.84E-06,1,2.28E-06,0,0,1
cattle,1,1.84E-06,1,2.28E-06,0,0,2
baton,1,1.84E-06,1,2.28E-06,0,0,2
decli,1,1.84E-06,1,2.28E-06,0,0,2
critcal,1,1.84E-06,1,2.28E-06,0,0,2
trace,1,1.84E-06,1,2.28E-06,0,0,1
gazan,1,1.84E-06,1,2.28E-06,0,0,2
hamas,1,1.84E-06,1,2.28E-06,0,0,2
jihad,1,1.84E-06,1,2.28E-06,0,0,2
borne,1,1.84E-06,1,2.28E-06,0,0,1
grips,1,1.84E-06,1,2.28E-06,0,0,1
rabbi,1,1.84E-06,1,2.28E-06,0,0,2
cheif,1,1.84E-06,1,2.28E-06,0,0,1
costa,1,1.84E-06,1,2.28E-06,0,0,2
glove,1,1.84E-06,1,2.28E-06,0,0,1
ranil,1,1.84E-06,1,2.28E-06,0,0,2
retry,1,1.84E-06,1,2.28E-06,0,0,2
craig,1,1.84E-06,1,2.28E-06,0,0,1
cueto,1,1.84E-06,1,2.28E-06,0,0,2
timed,1,1.84E-06,1,2.28E-06,0,0,1
amend,1,1.84E-06,1,2.28E-06,0,0,2
lucia,1,1.84E-06,1,2.28E-06,0,0,2
caves,1,1.84E-06,1,2.28E-06,0,0,1
fades,1,1.84E-06,1,2.28E-06,0,0,1
vigor,1,1.84E-06,1,2.28E-06,0,0,2
lists,1,1.84E-06,1,2.28E-06,0,0,1
coumo,1,1.84E-06,1,2.28E-06,0,0,2
pipko,1,1.84E-06,1,2.28E-06,0,0,2
cured,1,1.84E-06,1,2.28E-06,0,0,1
ilhan,1,1.84E-06,1,2.28E-06,0,0,2
diary,1,1.84E-06,1,2.28E-06,0,0,2
bottle,1,1.84E-06,1,2.28E-06,0,0,2
trong,1,1.84E-06,1,2.28E-06,0,0,1
burch,1,1.84E-06,1,2.28E-06,0,0,1
relax,1,1.84E-06,1,2.28E-06,0,0,2
brass,1,1.84E-06,1,2.28E-06,0,0,1
gifts,1,1.84E-06,1,2.28E-06,0,0,1
gofer,1,1.84E-06,1,2.28E-06,0,0,2
teens,1,1.84E-06,1,2.28E-06,0,0,1
corke,1,1.84E-06,1,2.28E-06,0,0,1
lawns,1,1.84E-06,1,2.28E-06,0,0,1
fakes,1,1.84E-06,1,2.28E-06,0,0,1
jamal,1,1.84E-06,1,2.28E-06,0,0,2
ritchie,1,1.84E-06,1,2.28E-06,0,0,2
arbiter,1,1.84E-06,1,2.28E-06,0,0,3
cotton,1,1.84E-06,1,2.28E-06,0,0,2
follower,1,1.84E-06,1,2.28E-06,0,0,3
stunner,1,1.84E-06,1,2.28E-06,0,0,2
putted,1,1.84E-06,1,2.28E-06,0,0,1
freitas,1,1.84E-06,1,2.28E-06,0,0,2
rosetta,1,1.84E-06,0,0,9.47E-06,1,3
ballroom,1,1.84E-06,1,2.28E-06,0,0,2
permitting,1,1.84E-06,1,2.28E-06,0,0,3
inherit,1,1.84E-06,1,2.28E-06,0,0,3
revisit,1,1.84E-06,1,2.28E-06,0,0,3
pennies,1,1.84E-06,1,2.28E-06,0,0,2
editors,1,1.84E-06,1,2.28E-06,0,0,3
battery,1,1.84E-06,0,0,9.47E-06,1,3
kimmels,1,1.84E-06,1,2.28E-06,0,0,2
scanner,1,1.84E-06,1,2.28E-06,0,0,2
grilling,1,1.84E-06,1,2.28E-06,0,0,2
dilemma,1,1.84E-06,1,2.28E-06,0,0,3
politic,1,1.84E-06,1,2.28E-06,0,0,3
cumming,1,1.84E-06,1,2.28E-06,0,0,2
remittance,1,1.84E-06,1,2.28E-06,0,0,3
mutually,1,1.84E-06,1,2.28E-06,0,0,3
buttons,1,1.84E-06,0,0,9.47E-06,1,2
unfunny,1,1.84E-06,1,2.28E-06,0,0,3
bastille,1,1.84E-06,1,2.28E-06,0,0,2
rewrite,1,1.84E-06,1,2.28E-06,0,0,2
chatter,1,1.84E-06,1,2.28E-06,0,0,2
cellular,1,1.84E-06,1,2.28E-06,0,0,3
goodwill,1,1.84E-06,1,2.28E-06,0,0,2
channel,1,1.84E-06,1,2.28E-06,0,0,2
clarity,1,1.84E-06,1,2.28E-06,0,0,3
callshes,1,1.84E-06,1,2.28E-06,0,0,1
bitterness,1,1.84E-06,1,2.28E-06,0,0,3
phillips,1,1.84E-06,1,2.28E-06,0,0,2
rattled,1,1.84E-06,1,2.28E-06,0,0,1
uniting,1,1.84E-06,1,2.28E-06,0,0,3
hallmark,1,1.84E-06,1,2.28E-06,0,0,2
billings,1,1.84E-06,1,2.28E-06,0,0,2
utterly,1,1.84E-06,1,2.28E-06,0,0,3
clarita,1,1.84E-06,1,2.28E-06,0,0,3
culprit,1,1.84E-06,1,2.28E-06,0,0,2
bitcoin,1,1.84E-06,1,2.28E-06,0,0,2
dennard,1,1.84E-06,1,2.28E-06,0,0,2
payrolls,1,1.84E-06,1,2.28E-06,0,0,2
alluding,1,1.84E-06,1,2.28E-06,0,0,3
handwritten,1,1.84E-06,0,0,9.47E-06,1,3
communites,1,1.84E-06,1,2.28E-06,0,0,3
shatter,1,1.84E-06,1,2.28E-06,0,0,2
timewell,1,1.84E-06,1,2.28E-06,0,0,3
illegitimately,1,1.84E-06,1,2.28E-06,0,0,7
militia,1,1.84E-06,1,2.28E-06,0,0,3
transmitted,1,1.84E-06,1,2.28E-06,0,0,2
stallone,1,1.84E-06,1,2.28E-06,0,0,2
unfilled,1,1.84E-06,1,2.28E-06,0,0,2
demswill,1,1.84E-06,1,2.28E-06,0,0,2
turnbull,1,1.84E-06,1,2.28E-06,0,0,2
safefull,1,1.84E-06,1,2.28E-06,0,0,3
twitterhappy,1,1.84E-06,0,0,9.47E-06,1,4
pittsburghers,1,1.84E-06,1,2.28E-06,0,0,3
happyits,1,1.84E-06,0,0,9.47E-06,1,2
expelled,1,1.84E-06,1,2.28E-06,0,0,2
annoyed,1,1.84E-06,1,2.28E-06,0,0,2
batting,1,1.84E-06,1,2.28E-06,0,0,2
pinning,1,1.84E-06,1,2.28E-06,0,0,2
humming,1,1.84E-06,1,2.28E-06,0,0,2
bullnext,1,1.84E-06,1,2.28E-06,0,0,2
pizzella,1,1.84E-06,1,2.28E-06,0,0,3
inequity,1,1.84E-06,0,0,9.47E-06,1,4
revisits,1,1.84E-06,0,0,9.47E-06,1,3
souther,1,1.84E-06,1,2.28E-06,0,0,2
crimeits,1,1.84E-06,0,0,9.47E-06,1,2
mobility,1,1.84E-06,0,0,9.47E-06,1,4
audition,1,1.84E-06,0,0,9.47E-06,1,3
fallujah,1,1.84E-06,1,2.28E-06,0,0,3
pullback,1,1.84E-06,1,2.28E-06,0,0,2
voiceits,1,1.84E-06,0,0,9.47E-06,1,2
trolling,1,1.84E-06,1,2.28E-06,0,0,2
mugswith,1,1.84E-06,0,0,9.47E-06,1,2
griffith,1,1.84E-06,0,0,9.47E-06,1,2
hallberg,1,1.84E-06,1,2.28E-06,0,0,2
houseits,1,1.84E-06,0,0,9.47E-06,1,2
todayits,1,1.84E-06,0,0,9.47E-06,1,3
deposits,1,1.84E-06,0,0,9.47E-06,1,3
dummies,1,1.84E-06,1,2.28E-06,0,0,2
hassett,1,1.84E-06,1,2.28E-06,0,0,2
profited,1,1.84E-06,1,2.28E-06,0,0,2
platter,1,1.84E-06,1,2.28E-06,0,0,2
innuendo,1,1.84E-06,1,2.28E-06,0,0,3
scammer,1,1.84E-06,1,2.28E-06,0,0,2
rosettas,1,1.84E-06,0,0,9.47E-06,1,3
commodities,1,1.84E-06,1,2.28E-06,0,0,4
breathe,1,1.84E-06,1,2.28E-06,0,0,1
knoxville,1,1.84E-06,0,0,9.47E-06,1,2
selleryou,1,1.84E-06,0,0,9.47E-06,1,4
decrepit,1,1.84E-06,1,2.28E-06,0,0,3
nonwhite,1,1.84E-06,1,2.28E-06,0,0,2
michelles,1,1.84E-06,0,0,9.47E-06,1,3
unneeded,1,1.84E-06,1,2.28E-06,0,0,2
clutch,1,1.84E-06,0,0,9.47E-06,1,1
arctic,1,1.84E-06,0,0,9.47E-06,1,2
brunch,1,1.84E-06,0,0,9.47E-06,1,1
denali,1,1.84E-06,0,0,9.47E-06,1,3
ranger,1,1.84E-06,0,0,9.47E-06,1,2
velocity,1,1.84E-06,1,2.28E-06,0,0,4
surely,1,1.84E-06,0,0,9.47E-06,1,3
strife,1,1.84E-06,0,0,9.47E-06,1,1
warned,1,1.84E-06,0,0,9.47E-06,1,1
buzzer,1,1.84E-06,0,0,9.47E-06,1,2
beater,1,1.84E-06,0,0,9.47E-06,1,2
hadnot,1,1.84E-06,0,0,9.47E-06,1,2
amtrak,1,1.84E-06,0,0,9.47E-06,1,2
ensues,1,1.84E-06,0,0,9.47E-06,1,2
aspire,1,1.84E-06,0,0,9.47E-06,1,2
cecily,1,1.84E-06,0,0,9.47E-06,1,3
surest,1,1.84E-06,0,0,9.47E-06,1,2
actbut,1,1.84E-06,0,0,9.47E-06,1,2
hesitate,1,1.84E-06,1,2.28E-06,0,0,3
metric,1,1.84E-06,0,0,9.47E-06,1,2
youour,1,1.84E-06,0,0,9.47E-06,1,2
funkes,1,1.84E-06,0,0,9.47E-06,1,1
menino,1,1.84E-06,0,0,9.47E-06,1,3
malala,1,1.84E-06,0,0,9.47E-06,1,3
upshow,1,1.84E-06,0,0,9.47E-06,1,2
militant,1,1.84E-06,1,2.28E-06,0,0,3
scores,1,1.84E-06,0,0,9.47E-06,1,1
earths,1,1.84E-06,0,0,9.47E-06,1,1
debtgo,1,1.84E-06,0,0,9.47E-06,1,2
airman,1,1.84E-06,0,0,9.47E-06,1,2
wastes,1,1.84E-06,0,0,9.47E-06,1,1
seeker,1,1.84E-06,0,0,9.47E-06,1,2
thatin,1,1.84E-06,0,0,9.47E-06,1,2
snooze,1,1.84E-06,0,0,9.47E-06,1,1
bloody,1,1.84E-06,0,0,9.47E-06,1,2
metals,1,1.84E-06,0,0,9.47E-06,1,2
driest,1,1.84E-06,0,0,9.47E-06,1,1
steals,1,1.84E-06,0,0,9.47E-06,1,1
flavor,1,1.84E-06,0,0,9.47E-06,1,2
coptic,1,1.84E-06,0,0,9.47E-06,1,2
outadd,1,1.84E-06,0,0,9.47E-06,1,2
shrunk,1,1.84E-06,0,0,9.47E-06,1,1
dental,1,1.84E-06,0,0,9.47E-06,1,2
fungus,1,1.84E-06,0,0,9.47E-06,1,2
trivia,1,1.84E-06,0,0,9.47E-06,1,2
celiac,1,1.84E-06,0,0,9.47E-06,1,2
battered,1,1.84E-06,0,0,9.47E-06,1,2
halted,1,1.84E-06,0,0,9.47E-06,1,1
ransom,1,1.84E-06,0,0,9.47E-06,1,2
kitchens,1,1.84E-06,1,2.28E-06,0,0,2
object,1,1.84E-06,0,0,9.47E-06,1,2
mauser,1,1.84E-06,0,0,9.47E-06,1,2
ericas,1,1.84E-06,0,0,9.47E-06,1,3
enrolling,1,1.84E-06,0,0,9.47E-06,1,3
susies,1,1.84E-06,0,0,9.47E-06,1,2
ladder,1,1.84E-06,0,0,9.47E-06,1,2
lyndon,1,1.84E-06,0,0,9.47E-06,1,2
selfie,1,1.84E-06,0,0,9.47E-06,1,2
timewe,1,1.84E-06,0,0,9.47E-06,1,2
scorer,1,1.84E-06,0,0,9.47E-06,1,2
encore,1,1.84E-06,0,0,9.47E-06,1,2
valued,1,1.84E-06,0,0,9.47E-06,1,2
outset,1,1.84E-06,0,0,9.47E-06,1,2
funder,1,1.84E-06,0,0,9.47E-06,1,2
faizan,1,1.84E-06,0,0,9.47E-06,1,2
dealer,1,1.84E-06,0,0,9.47E-06,1,2
dougie,1,1.84E-06,0,0,9.47E-06,1,2
calvin,1,1.84E-06,0,0,9.47E-06,1,2
tipped,1,1.84E-06,0,0,9.47E-06,1,1
magana,1,1.84E-06,0,0,9.47E-06,1,3
guides,1,1.84E-06,0,0,9.47E-06,1,1
hinder,1,1.84E-06,0,0,9.47E-06,1,2
inouye,1,1.84E-06,0,0,9.47E-06,1,3
amanda,1,1.84E-06,0,0,9.47E-06,1,3
ladens,1,1.84E-06,0,0,9.47E-06,1,2
propel,1,1.84E-06,0,0,9.47E-06,1,2
sturdy,1,1.84E-06,0,0,9.47E-06,1,2
leftno,1,1.84E-06,0,0,9.47E-06,1,2
dayyou,1,1.84E-06,0,0,9.47E-06,1,3
sandys,1,1.84E-06,0,0,9.47E-06,1,2
hoarse,1,1.84E-06,0,0,9.47E-06,1,1
resubmit,1,1.84E-06,1,2.28E-06,0,0,3
delray,1,1.84E-06,0,0,9.47E-06,1,2
jobsin,1,1.84E-06,0,0,9.47E-06,1,2
afghan,1,1.84E-06,0,0,9.47E-06,1,2
calamity,1,1.84E-06,1,2.28E-06,0,0,4
scored,1,1.84E-06,0,0,9.47E-06,1,1
binder,1,1.84E-06,0,0,9.47E-06,1,2
siding,1,1.84E-06,0,0,9.47E-06,1,2
tissue,1,1.84E-06,0,0,9.47E-06,1,2
pushes,1,1.84E-06,0,0,9.47E-06,1,1
jobsim,1,1.84E-06,0,0,9.47E-06,1,2
younot,1,1.84E-06,0,0,9.47E-06,1,2
poster,1,1.84E-06,0,0,9.47E-06,1,2
lshana,1,1.84E-06,0,0,9.47E-06,1,2
bidder,1,1.84E-06,0,0,9.47E-06,1,2
shaken,1,1.84E-06,0,0,9.47E-06,1,2
enlist,1,1.84E-06,0,0,9.47E-06,1,2
trusts,1,1.84E-06,0,0,9.47E-06,1,1
muscle,1,1.84E-06,0,0,9.47E-06,1,2
grayer,1,1.84E-06,0,0,9.47E-06,1,2
phelps,1,1.84E-06,0,0,9.47E-06,1,1
deduct,1,1.84E-06,0,0,9.47E-06,1,2
costco,1,1.84E-06,0,0,9.47E-06,1,2
sedition,1,1.84E-06,1,2.28E-06,0,0,3
static,1,1.84E-06,0,0,9.47E-06,1,2
okrent,1,1.84E-06,0,0,9.47E-06,1,2
kinkos,1,1.84E-06,0,0,9.47E-06,1,2
howfor,1,1.84E-06,0,0,9.47E-06,1,2
uplets,1,1.84E-06,0,0,9.47E-06,1,2
hikeor,1,1.84E-06,0,0,9.47E-06,1,2
sashas,1,1.84E-06,0,0,9.47E-06,1,2
expels,1,1.84E-06,0,0,9.47E-06,1,2
clocks,1,1.84E-06,0,0,9.47E-06,1,1
copies,1,1.84E-06,0,0,9.47E-06,1,2
metime,1,1.84E-06,0,0,9.47E-06,1,2
malena,1,1.84E-06,0,0,9.47E-06,1,3
semonite,1,1.84E-06,1,2.28E-06,0,0,3
marion,1,1.84E-06,0,0,9.47E-06,1,2
awaiting,1,1.84E-06,1,2.28E-06,0,0,3
merged,1,1.84E-06,0,0,9.47E-06,1,1
dayget,1,1.84E-06,0,0,9.47E-06,1,2
rowing,1,1.84E-06,0,0,9.47E-06,1,2
capped,1,1.84E-06,0,0,9.47E-06,1,1
lowyet,1,1.84E-06,0,0,9.47E-06,1,2
wiesel,1,1.84E-06,0,0,9.47E-06,1,2
adsbut,1,1.84E-06,0,0,9.47E-06,1,2
stored,1,1.84E-06,0,0,9.47E-06,1,1
kendra,1,1.84E-06,0,0,9.47E-06,1,2
bayard,1,1.84E-06,0,0,9.47E-06,1,2
rustin,1,1.84E-06,0,0,9.47E-06,1,2
paddys,1,1.84E-06,0,0,9.47E-06,1,2
herean,1,1.84E-06,0,0,9.47E-06,1,2
marked,1,1.84E-06,0,0,9.47E-06,1,1
regina,1,1.84E-06,0,0,9.47E-06,1,3
circuits,1,1.84E-06,1,2.28E-06,0,0,2
colleague,1,1.84E-06,0,0,9.47E-06,1,3
someto,1,1.84E-06,0,0,9.47E-06,1,3
leaner,1,1.84E-06,0,0,9.47E-06,1,2
canyon,1,1.84E-06,0,0,9.47E-06,1,2
prints,1,1.84E-06,0,0,9.47E-06,1,1
kathie,1,1.84E-06,0,0,9.47E-06,1,2
heitkamp,1,1.84E-06,1,2.28E-06,0,0,2
iowans,1,1.84E-06,0,0,9.47E-06,1,2
coupon,1,1.84E-06,0,0,9.47E-06,1,2
bowant,1,1.84E-06,0,0,9.47E-06,1,2
flotus,1,1.84E-06,0,0,9.47E-06,1,2
grinch,1,1.84E-06,0,0,9.47E-06,1,1
cheers,1,1.84E-06,0,0,9.47E-06,1,1
tumblr,1,1.84E-06,0,0,9.47E-06,1,1
wayone,1,1.84E-06,0,0,9.47E-06,1,2
pickup,1,1.84E-06,0,0,9.47E-06,1,2
buffet,1,1.84E-06,0,0,9.47E-06,1,2
oneget,1,1.84E-06,0,0,9.47E-06,1,3
melody,1,1.84E-06,0,0,9.47E-06,1,3
collapsed,1,1.84E-06,1,2.28E-06,0,0,2
hochul,1,1.84E-06,0,0,9.47E-06,1,2
dowhat,1,1.84E-06,0,0,9.47E-06,1,2
magically,1,1.84E-06,1,2.28E-06,0,0,4
voteif,1,1.84E-06,0,0,9.47E-06,1,2
uncles,1,1.84E-06,0,0,9.47E-06,1,2
apathy,1,1.84E-06,0,0,9.47E-06,1,3
relive,1,1.84E-06,0,0,9.47E-06,1,2
partwe,1,1.84E-06,0,0,9.47E-06,1,1
gamble,1,1.84E-06,0,0,9.47E-06,1,2
gratuity,1,1.84E-06,1,2.28E-06,0,0,3
desert,1,1.84E-06,0,0,9.47E-06,1,2
dreary,1,1.84E-06,0,0,9.47E-06,1,2
fossil,1,1.84E-06,0,0,9.47E-06,1,2
ordeal,1,1.84E-06,0,0,9.47E-06,1,2
staked,1,1.84E-06,0,0,9.47E-06,1,1
duncan,1,1.84E-06,0,0,9.47E-06,1,2
preval,1,1.84E-06,0,0,9.47E-06,1,2
eluded,1,1.84E-06,0,0,9.47E-06,1,2
rhodes,1,1.84E-06,0,0,9.47E-06,1,1
stakes,1,1.84E-06,0,0,9.47E-06,1,1
youbut,1,1.84E-06,0,0,9.47E-06,1,2
thwart,1,1.84E-06,1,2.28E-06,0,0,1
upload,1,1.84E-06,1,2.28E-06,0,0,2
toying,1,1.84E-06,1,2.28E-06,0,0,2
dogged,1,1.84E-06,1,2.28E-06,0,0,1
aliyev,1,1.84E-06,1,2.28E-06,0,0,3
adhere,1,1.84E-06,1,2.28E-06,0,0,2
biegun,1,1.84E-06,1,2.28E-06,0,0,2
drtony,1,1.84E-06,1,2.28E-06,0,0,2
luster,1,1.84E-06,1,2.28E-06,0,0,2
lahood,1,1.84E-06,1,2.28E-06,0,0,2
cindys,1,1.84E-06,1,2.28E-06,0,0,2
riding,1,1.84E-06,1,2.28E-06,0,0,2
fruition,1,1.84E-06,1,2.28E-06,0,0,2
awhile,1,1.84E-06,1,2.28E-06,0,0,3
sealed,1,1.84E-06,1,2.28E-06,0,0,1
stench,1,1.84E-06,1,2.28E-06,0,0,1
joecks,1,1.84E-06,1,2.28E-06,0,0,1
morano,1,1.84E-06,1,2.28E-06,0,0,3
herald,1,1.84E-06,1,2.28E-06,0,0,2
lufkin,1,1.84E-06,1,2.28E-06,0,0,2
alyssa,1,1.84E-06,1,2.28E-06,0,0,3
nullified,1,1.84E-06,1,2.28E-06,0,0,3
bowers,1,1.84E-06,1,2.28E-06,0,0,2
sticks,1,1.84E-06,1,2.28E-06,0,0,1
ascend,1,1.84E-06,1,2.28E-06,0,0,2
widodo,1,1.84E-06,1,2.28E-06,0,0,3
curate,1,1.84E-06,1,2.28E-06,0,0,2
creepy,1,1.84E-06,1,2.28E-06,0,0,2
edward,1,1.84E-06,1,2.28E-06,0,0,2
suburb,1,1.84E-06,1,2.28E-06,0,0,2
darren,1,1.84E-06,1,2.28E-06,0,0,2
reinstall,1,1.84E-06,1,2.28E-06,0,0,2
troupe,1,1.84E-06,1,2.28E-06,0,0,1
asheville,1,1.84E-06,1,2.28E-06,0,0,3
devine,1,1.84E-06,1,2.28E-06,0,0,2
booths,1,1.84E-06,1,2.28E-06,0,0,1
refilling,1,1.84E-06,1,2.28E-06,0,0,3
butler,1,1.84E-06,1,2.28E-06,0,0,2
turtle,1,1.84E-06,1,2.28E-06,0,0,2
negron,1,1.84E-06,1,2.28E-06,0,0,2
empire,1,1.84E-06,1,2.28E-06,0,0,2
caters,1,1.84E-06,1,2.28E-06,0,0,2
hustle,1,1.84E-06,1,2.28E-06,0,0,2
tamper,1,1.84E-06,1,2.28E-06,0,0,2
apoyar,1,1.84E-06,1,2.28E-06,0,0,3
induce,1,1.84E-06,1,2.28E-06,0,0,2
murtha,1,1.84E-06,1,2.28E-06,0,0,2
dodges,1,1.84E-06,1,2.28E-06,0,0,1
marias,1,1.84E-06,1,2.28E-06,0,0,2
rotate,1,1.84E-06,1,2.28E-06,0,0,2
render,1,1.84E-06,1,2.28E-06,0,0,2
mititary,1,1.84E-06,1,2.28E-06,0,0,4
compel,1,1.84E-06,1,2.28E-06,0,0,2
outran,1,1.84E-06,1,2.28E-06,0,0,2
morass,1,1.84E-06,1,2.28E-06,0,0,2
vested,1,1.84E-06,1,2.28E-06,0,0,1
kristi,1,1.84E-06,1,2.28E-06,0,0,2
sabato,1,1.84E-06,1,2.28E-06,0,0,3
mugged,1,1.84E-06,1,2.28E-06,0,0,1
reside,1,1.84E-06,1,2.28E-06,0,0,2
exodus,1,1.84E-06,1,2.28E-06,0,0,3
Ø¨Ø®Ø´,1,1.84E-06,1,2.28E-06,0,0,#ERROR!
Ø¨Ø´Ø±,1,1.84E-06,1,2.28E-06,0,0,#ERROR!
winred,1,1.84E-06,1,2.28E-06,0,0,1
choker,1,1.84E-06,1,2.28E-06,0,0,2
rename,1,1.84E-06,1,2.28E-06,0,0,2
cuting,1,1.84E-06,1,2.28E-06,0,0,2
wooden,1,1.84E-06,1,2.28E-06,0,0,2
sinful,1,1.84E-06,1,2.28E-06,0,0,2
toting,1,1.84E-06,1,2.28E-06,0,0,2
tedros,1,1.84E-06,1,2.28E-06,0,0,2
carpet,1,1.84E-06,1,2.28E-06,0,0,2
borderit,1,1.84E-06,1,2.28E-06,0,0,3
laughs,1,1.84E-06,1,2.28E-06,0,0,1
exacty,1,1.84E-06,1,2.28E-06,0,0,3
cavuto,1,1.84E-06,1,2.28E-06,0,0,3
droned,1,1.84E-06,1,2.28E-06,0,0,1
thirds,1,1.84E-06,1,2.28E-06,0,0,1
meuser,1,1.84E-06,1,2.28E-06,0,0,2
malign,1,1.84E-06,1,2.28E-06,0,0,2
extort,1,1.84E-06,1,2.28E-06,0,0,2
auburn,1,1.84E-06,1,2.28E-06,0,0,2
aiding,1,1.84E-06,1,2.28E-06,0,0,2
newark,1,1.84E-06,1,2.28E-06,0,0,2
portal,1,1.84E-06,1,2.28E-06,0,0,2
militsry,1,1.84E-06,1,2.28E-06,0,0,3
placer,1,1.84E-06,1,2.28E-06,0,0,2
Ú©Ø±Ø¯,1,1.84E-06,1,2.28E-06,0,0,#ERROR!
Ø´Ø¯Øª,1,1.84E-06,1,2.28E-06,0,0,#ERROR!
ØªØ­Øª,1,1.84E-06,1,2.28E-06,0,0,#ERROR!
kristy,1,1.84E-06,1,2.28E-06,0,0,2
audrey,1,1.84E-06,1,2.28E-06,0,0,2
midway,1,1.84E-06,1,2.28E-06,0,0,2
uptick,1,1.84E-06,1,2.28E-06,0,0,2
ceased,1,1.84E-06,1,2.28E-06,0,0,1
philip,1,1.84E-06,1,2.28E-06,0,0,2
greene,1,1.84E-06,1,2.28E-06,0,0,1
gloves,1,1.84E-06,1,2.28E-06,0,0,1
galvin,1,1.84E-06,1,2.28E-06,0,0,2
weaver,1,1.84E-06,1,2.28E-06,0,0,2
copied,1,1.84E-06,1,2.28E-06,0,0,2
sheryl,1,1.84E-06,1,2.28E-06,0,0,2
chetan,1,1.84E-06,1,2.28E-06,0,0,2
thirty,1,1.84E-06,1,2.28E-06,0,0,2
settling,1,1.84E-06,0,0,9.47E-06,1,2
teeing,1,1.84E-06,1,2.28E-06,0,0,2
chapel,1,1.84E-06,1,2.28E-06,0,0,2
msdncs,1,1.84E-06,1,2.28E-06,0,0,#ERROR!
meaner,1,1.84E-06,1,2.28E-06,0,0,2
esposito,1,1.84E-06,1,2.28E-06,0,0,4
mortal,1,1.84E-06,1,2.28E-06,0,0,2
grades,1,1.84E-06,1,2.28E-06,0,0,1
succes,1,1.84E-06,1,2.28E-06,0,0,1
caving,1,1.84E-06,1,2.28E-06,0,0,2
sophie,1,1.84E-06,1,2.28E-06,0,0,2
enable,1,1.84E-06,1,2.28E-06,0,0,3
oilgas,1,1.84E-06,1,2.28E-06,0,0,2
asleep,1,1.84E-06,1,2.28E-06,0,0,2
ahmari,1,1.84E-06,1,2.28E-06,0,0,3
pebble,1,1.84E-06,1,2.28E-06,0,0,2
kerens,1,1.84E-06,1,2.28E-06,0,0,2
bypass,1,1.84E-06,1,2.28E-06,0,0,2
castle,1,1.84E-06,1,2.28E-06,0,0,2
fiasco,1,1.84E-06,1,2.28E-06,0,0,2
oxford,1,1.84E-06,1,2.28E-06,0,0,2
lonoke,1,1.84E-06,1,2.28E-06,0,0,2
ramsey,1,1.84E-06,1,2.28E-06,0,0,2
punted,1,1.84E-06,1,2.28E-06,0,0,1
fulfil,1,1.84E-06,1,2.28E-06,0,0,2
feared,1,1.84E-06,1,2.28E-06,0,0,1
newsom,1,1.84E-06,1,2.28E-06,0,0,2
candor,1,1.84E-06,1,2.28E-06,0,0,2
purdue,1,1.84E-06,1,2.28E-06,0,0,2
rental,1,1.84E-06,1,2.28E-06,0,0,2
carlos,1,1.84E-06,1,2.28E-06,0,0,2
irving,1,1.84E-06,1,2.28E-06,0,0,2
scamming,1,1.84E-06,1,2.28E-06,0,0,2
albany,1,1.84E-06,1,2.28E-06,0,0,3
momentto,1,1.84E-06,0,0,9.47E-06,1,3
medically,1,1.84E-06,1,2.28E-06,0,0,4
intact,1,1.84E-06,1,2.28E-06,0,0,2
stones,1,1.84E-06,1,2.28E-06,0,0,1
revoke,1,1.84E-06,1,2.28E-06,0,0,2
gidley,1,1.84E-06,1,2.28E-06,0,0,2
gifted,1,1.84E-06,1,2.28E-06,0,0,1
frisky,1,1.84E-06,1,2.28E-06,0,0,2
prescott,1,1.84E-06,1,2.28E-06,0,0,2
minded,1,1.84E-06,1,2.28E-06,0,0,1
uneven,1,1.84E-06,1,2.28E-06,0,0,3
actioncommit,1,1.84E-06,0,0,9.47E-06,1,4
graces,1,1.84E-06,1,2.28E-06,0,0,1
horace,1,1.84E-06,1,2.28E-06,0,0,2
foment,1,1.84E-06,1,2.28E-06,0,0,2
embers,1,1.84E-06,1,2.28E-06,0,0,2
frieda,1,1.84E-06,1,2.28E-06,0,0,2
rocker,1,1.84E-06,1,2.28E-06,0,0,2
oppidite,1,1.84E-06,1,2.28E-06,0,0,3
hungry,1,1.84E-06,1,2.28E-06,0,0,2
adolph,1,1.84E-06,1,2.28E-06,0,0,2
monson,1,1.84E-06,1,2.28E-06,0,0,2
stinks,1,1.84E-06,1,2.28E-06,0,0,1
mercer,1,1.84E-06,1,2.28E-06,0,0,2
tapper,1,1.84E-06,1,2.28E-06,0,0,2
junior,1,1.84E-06,1,2.28E-06,0,0,2
nissan,1,1.84E-06,1,2.28E-06,0,0,2
vassal,1,1.84E-06,1,2.28E-06,0,0,2
nimble,1,1.84E-06,1,2.28E-06,0,0,2
humans,1,1.84E-06,1,2.28E-06,0,0,2
racket,1,1.84E-06,1,2.28E-06,0,0,2
panels,1,1.84E-06,1,2.28E-06,0,0,2
overal,1,1.84E-06,1,2.28E-06,0,0,3
marshalls,1,1.84E-06,1,2.28E-06,0,0,2
affirm,1,1.84E-06,1,2.28E-06,0,0,2
palmer,1,1.84E-06,1,2.28E-06,0,0,2
sadder,1,1.84E-06,1,2.28E-06,0,0,2
nicest,1,1.84E-06,1,2.28E-06,0,0,2
casket,1,1.84E-06,1,2.28E-06,0,0,2
massie,1,1.84E-06,1,2.28E-06,0,0,2
zurich,1,1.84E-06,1,2.28E-06,0,0,2
prized,1,1.84E-06,1,2.28E-06,0,0,1
pantry,1,1.84E-06,1,2.28E-06,0,0,2
curtis,1,1.84E-06,1,2.28E-06,0,0,2
lunacy,1,1.84E-06,1,2.28E-06,0,0,3
sanitary,1,1.84E-06,1,2.28E-06,0,0,4
welker,1,1.84E-06,1,2.28E-06,0,0,2
salons,1,1.84E-06,1,2.28E-06,0,0,2
ricketts,1,1.84E-06,1,2.28E-06,0,0,2
advent,1,1.84E-06,1,2.28E-06,0,0,2
blazer,1,1.84E-06,1,2.28E-06,0,0,2
medgar,1,1.84E-06,1,2.28E-06,0,0,2
nobles,1,1.84E-06,1,2.28E-06,0,0,2
diners,1,1.84E-06,1,2.28E-06,0,0,2
taunts,1,1.84E-06,1,2.28E-06,0,0,1
comply,1,1.84E-06,1,2.28E-06,0,0,2
squirm,1,1.84E-06,1,2.28E-06,0,0,1
phases,1,1.84E-06,1,2.28E-06,0,0,1
jacked,1,1.84E-06,1,2.28E-06,0,0,1
looney,1,1.84E-06,1,2.28E-06,0,0,2
mooney,1,1.84E-06,1,2.28E-06,0,0,2
danced,1,1.84E-06,1,2.28E-06,0,0,1
amodei,1,1.84E-06,1,2.28E-06,0,0,3
burgum,1,1.84E-06,1,2.28E-06,0,0,2
innocence,1,1.84E-06,1,2.28E-06,0,0,3
dampen,1,1.84E-06,1,2.28E-06,0,0,2
ricans,1,1.84E-06,1,2.28E-06,0,0,2
shoved,1,1.84E-06,1,2.28E-06,0,0,1
gugino,1,1.84E-06,1,2.28E-06,0,0,3
scammers,1,1.84E-06,1,2.28E-06,0,0,2
gloria,1,1.84E-06,1,2.28E-06,0,0,2
adored,1,1.84E-06,1,2.28E-06,0,0,2
plasma,1,1.84E-06,1,2.28E-06,0,0,2
cought,1,1.84E-06,1,2.28E-06,0,0,1
pillaging,1,1.84E-06,1,2.28E-06,0,0,3
trojan,1,1.84E-06,1,2.28E-06,0,0,2
bognet,1,1.84E-06,1,2.28E-06,0,0,2
garced,1,1.84E-06,1,2.28E-06,0,0,1
bomber,1,1.84E-06,1,2.28E-06,0,0,2
evades,1,1.84E-06,1,2.28E-06,0,0,2
faucis,1,1.84E-06,1,2.28E-06,0,0,2
mcgurn,1,1.84E-06,1,2.28E-06,0,0,1
morals,1,1.84E-06,1,2.28E-06,0,0,2
poorer,1,1.84E-06,1,2.28E-06,0,0,2
bundle,1,1.84E-06,1,2.28E-06,0,0,2
dreamt,1,1.84E-06,1,2.28E-06,0,0,1
jamess,1,1.84E-06,1,2.28E-06,0,0,2
racing,1,1.84E-06,1,2.28E-06,0,0,2
winour,1,1.84E-06,1,2.28E-06,0,0,2
meadia,1,1.84E-06,1,2.28E-06,0,0,2
oceans,1,1.84E-06,1,2.28E-06,0,0,2
modify,1,1.84E-06,1,2.28E-06,0,0,3
explicit,1,1.84E-06,1,2.28E-06,0,0,3
majotity,1,1.84E-06,1,2.28E-06,0,0,4
guerrilla,1,1.84E-06,1,2.28E-06,0,0,3
abound,1,1.84E-06,1,2.28E-06,0,0,2
lavars,1,1.84E-06,1,2.28E-06,0,0,2
britains,1,1.84E-06,1,2.28E-06,0,0,2
upping,1,1.84E-06,1,2.28E-06,0,0,2
admins,1,1.84E-06,1,2.28E-06,0,0,2
hideki,1,1.84E-06,1,2.28E-06,0,0,3
aramco,1,1.84E-06,1,2.28E-06,0,0,3
skorea,1,1.84E-06,1,2.28E-06,0,0,2
depths,1,1.84E-06,1,2.28E-06,0,0,1
fewest,1,1.84E-06,1,2.28E-06,0,0,2
reptom,1,1.84E-06,1,2.28E-06,0,0,2
marino,1,1.84E-06,1,2.28E-06,0,0,3
sharyl,1,1.84E-06,1,2.28E-06,0,0,2
jemele,1,1.84E-06,1,2.28E-06,0,0,3
ricodo,1,1.84E-06,1,2.28E-06,0,0,3
carmen,1,1.84E-06,1,2.28E-06,0,0,2
booing,1,1.84E-06,1,2.28E-06,0,0,2
echoes,1,1.84E-06,1,2.28E-06,0,0,2
madman,1,1.84E-06,1,2.28E-06,0,0,2
ashraf,1,1.84E-06,1,2.28E-06,0,0,2
mandan,1,1.84E-06,1,2.28E-06,0,0,2
hereos,1,1.84E-06,1,2.28E-06,0,0,2
yougod,1,1.84E-06,1,2.28E-06,0,0,2
arpaio,1,1.84E-06,1,2.28E-06,0,0,3
elaine,1,1.84E-06,1,2.28E-06,0,0,2
onward,1,1.84E-06,1,2.28E-06,0,0,2
oncont,1,1.84E-06,1,2.28E-06,0,0,2
wstate,1,1.84E-06,1,2.28E-06,0,0,1
wowdem,1,1.84E-06,1,2.28E-06,0,0,2
entail,1,1.84E-06,1,2.28E-06,0,0,2
amvets,1,1.84E-06,1,2.28E-06,0,0,2
hariri,1,1.84E-06,1,2.28E-06,0,0,3
rebels,1,1.84E-06,1,2.28E-06,0,0,2
usfake,1,1.84E-06,1,2.28E-06,0,0,2
caputo,1,1.84E-06,1,2.28E-06,0,0,3
mourns,1,1.84E-06,1,2.28E-06,0,0,1
eiffel,1,1.84E-06,1,2.28E-06,0,0,2
palace,1,1.84E-06,1,2.28E-06,0,0,2
picnic,1,1.84E-06,1,2.28E-06,0,0,2
varela,1,1.84E-06,1,2.28E-06,0,0,3
knives,1,1.84E-06,1,2.28E-06,0,0,1
exsist,1,1.84E-06,1,2.28E-06,0,0,2
riyadh,1,1.84E-06,1,2.28E-06,0,0,2
santos,1,1.84E-06,1,2.28E-06,0,0,2
sergei,1,1.84E-06,1,2.28E-06,0,0,2
richie,1,1.84E-06,1,2.28E-06,0,0,2
giorgi,1,1.84E-06,1,2.28E-06,0,0,2
senses,1,1.84E-06,1,2.28E-06,0,0,1
menace,1,1.84E-06,1,2.28E-06,0,0,2
americ,1,1.84E-06,1,2.28E-06,0,0,3
snatch,1,1.84E-06,1,2.28E-06,0,0,1
fheile,1,1.84E-06,1,2.28E-06,0,0,2
fabric,1,1.84E-06,1,2.28E-06,0,0,2
tapped,1,1.84E-06,1,2.28E-06,0,0,1
hearby,1,1.84E-06,1,2.28E-06,0,0,2
kravis,1,1.84E-06,1,2.28E-06,0,0,2
humana,1,1.84E-06,1,2.28E-06,0,0,3
nkorea,1,1.84E-06,1,2.28E-06,0,0,2
playef,1,1.84E-06,1,2.28E-06,0,0,2
lienow,1,1.84E-06,1,2.28E-06,0,0,2
louvre,1,1.84E-06,1,2.28E-06,0,0,1
outage,1,1.84E-06,1,2.28E-06,0,0,2
celebs,1,1.84E-06,1,2.28E-06,0,0,2
rulers,1,1.84E-06,1,2.28E-06,0,0,2
streep,1,1.84E-06,1,2.28E-06,0,0,1
globes,1,1.84E-06,1,2.28E-06,0,0,1
rupert,1,1.84E-06,1,2.28E-06,0,0,2
timken,1,1.84E-06,1,2.28E-06,0,0,2
screws,1,1.84E-06,1,2.28E-06,0,0,1
looses,1,1.84E-06,1,2.28E-06,0,0,1
lashed,1,1.84E-06,1,2.28E-06,0,0,1
cooked,1,1.84E-06,1,2.28E-06,0,0,1
slowed,1,1.84E-06,1,2.28E-06,0,0,1
erased,1,1.84E-06,1,2.28E-06,0,0,2
airing,1,1.84E-06,1,2.28E-06,0,0,2
clears,1,1.84E-06,1,2.28E-06,0,0,1
nauert,1,1.84E-06,1,2.28E-06,0,0,2
cracks,1,1.84E-06,1,2.28E-06,0,0,1
echoed,1,1.84E-06,1,2.28E-06,0,0,2
buenos,1,1.84E-06,1,2.28E-06,0,0,2
brenda,1,1.84E-06,1,2.28E-06,0,0,2
tupelo,1,1.84E-06,1,2.28E-06,0,0,3
touted,1,1.84E-06,1,2.28E-06,0,0,1
bedlam,1,1.84E-06,1,2.28E-06,0,0,2
hector,1,1.84E-06,1,2.28E-06,0,0,2
unwise,1,1.84E-06,1,2.28E-06,0,0,2
loudon,1,1.84E-06,1,2.28E-06,0,0,2
reckon,1,1.84E-06,1,2.28E-06,0,0,2
ridden,1,1.84E-06,1,2.28E-06,0,0,2
strain,1,1.84E-06,1,2.28E-06,0,0,1
sorrow,1,1.84E-06,1,2.28E-06,0,0,2
dovish,1,1.84E-06,1,2.28E-06,0,0,2
straka,1,1.84E-06,1,2.28E-06,0,0,2
scares,1,1.84E-06,1,2.28E-06,0,0,1
unpaid,1,1.84E-06,1,2.28E-06,0,0,2
births,1,1.84E-06,1,2.28E-06,0,0,1
emergy,1,1.84E-06,1,2.28E-06,0,0,3
doable,1,1.84E-06,1,2.28E-06,0,0,2
hangar,1,1.84E-06,1,2.28E-06,0,0,2
saudis,1,1.84E-06,1,2.28E-06,0,0,2
canley,1,1.84E-06,1,2.28E-06,0,0,2
stormy,1,1.84E-06,1,2.28E-06,0,0,2
fisher,1,1.84E-06,1,2.28E-06,0,0,2
chants,1,1.84E-06,1,2.28E-06,0,0,1
voyage,1,1.84E-06,1,2.28E-06,0,0,2
govern,1,1.84E-06,1,2.28E-06,0,0,2
topeka,1,1.84E-06,1,2.28E-06,0,0,3
shurer,1,1.84E-06,1,2.28E-06,0,0,2
braved,1,1.84E-06,1,2.28E-06,0,0,1
boards,1,1.84E-06,1,2.28E-06,0,0,1
hassan,1,1.84E-06,1,2.28E-06,0,0,2
recede,1,1.84E-06,1,2.28E-06,0,0,2
fiddle,1,1.84E-06,1,2.28E-06,0,0,2
evelyn,1,1.84E-06,1,2.28E-06,0,0,3
banker,1,1.84E-06,1,2.28E-06,0,0,2
holder,1,1.84E-06,1,2.28E-06,0,0,2
fealty,1,1.84E-06,1,2.28E-06,0,0,2
fandos,1,1.84E-06,1,2.28E-06,0,0,2
hughes,1,1.84E-06,1,2.28E-06,0,0,1
quoted,1,1.84E-06,1,2.28E-06,0,0,1
himher,1,1.84E-06,1,2.28E-06,0,0,2
againt,1,1.84E-06,1,2.28E-06,0,0,2
fluent,1,1.84E-06,1,2.28E-06,0,0,1
dreama,1,1.84E-06,1,2.28E-06,0,0,2
friess,1,1.84E-06,1,2.28E-06,0,0,1
breach,1,1.84E-06,1,2.28E-06,0,0,1
aretha,1,1.84E-06,1,2.28E-06,0,0,3
wrongs,1,1.84E-06,1,2.28E-06,0,0,1
vukmir,1,1.84E-06,1,2.28E-06,0,0,2
enters,1,1.84E-06,1,2.28E-06,0,0,2
animus,1,1.84E-06,1,2.28E-06,0,0,3
koepka,1,1.84E-06,1,2.28E-06,0,0,2
redone,1,1.84E-06,1,2.28E-06,0,0,2
veered,1,1.84E-06,1,2.28E-06,0,0,1
slides,1,1.84E-06,1,2.28E-06,0,0,1
merger,1,1.84E-06,1,2.28E-06,0,0,2
defied,1,1.84E-06,1,2.28E-06,0,0,2
escort,1,1.84E-06,1,2.28E-06,0,0,2
rebelo,1,1.84E-06,1,2.28E-06,0,0,3
garlin,1,1.84E-06,1,2.28E-06,0,0,2
innocents,1,1.84E-06,1,2.28E-06,0,0,3
chided,1,1.84E-06,1,2.28E-06,0,0,1
jacket,1,1.84E-06,1,2.28E-06,0,0,2
breeds,1,1.84E-06,1,2.28E-06,0,0,1
felipe,1,1.84E-06,1,2.28E-06,0,0,2
infest,1,1.84E-06,1,2.28E-06,0,0,2
strozk,1,1.84E-06,1,2.28E-06,0,0,1
berlin,1,1.84E-06,1,2.28E-06,0,0,2
seattles,1,1.84E-06,1,2.28E-06,0,0,2
missle,1,1.84E-06,1,2.28E-06,0,0,2
staffs,1,1.84E-06,1,2.28E-06,0,0,1
divert,1,1.84E-06,1,2.28E-06,0,0,2
dating,1,1.84E-06,1,2.28E-06,0,0,2
busted,1,1.84E-06,1,2.28E-06,0,0,1
astros,1,1.84E-06,1,2.28E-06,0,0,2
lumber,1,1.84E-06,1,2.28E-06,0,0,2
dinesh,1,1.84E-06,1,2.28E-06,0,0,2
dsouza,1,1.84E-06,1,2.28E-06,0,0,2
rockin,1,1.84E-06,1,2.28E-06,0,0,2
ambition,1,1.84E-06,1,2.28E-06,0,0,3
burial,1,1.84E-06,1,2.28E-06,0,0,2
installed,1,1.84E-06,1,2.28E-06,0,0,2
seaman,1,1.84E-06,1,2.28E-06,0,0,2
aweigh,1,1.84E-06,1,2.28E-06,0,0,2
lahren,1,1.84E-06,1,2.28E-06,0,0,2
briefs,1,1.84E-06,1,2.28E-06,0,0,1
fbidoj,1,1.84E-06,1,2.28E-06,0,0,2
dewine,1,1.84E-06,1,2.28E-06,0,0,2
revolt,1,1.84E-06,1,2.28E-06,0,0,2
salena,1,1.84E-06,1,2.28E-06,0,0,3
disarm,1,1.84E-06,1,2.28E-06,0,0,2
meyers,1,1.84E-06,1,2.28E-06,0,0,2
nevins,1,1.84E-06,1,2.28E-06,0,0,2
donehe,1,1.84E-06,1,2.28E-06,0,0,2
linked,1,1.84E-06,1,2.28E-06,0,0,1
maxing,1,1.84E-06,1,2.28E-06,0,0,2
shadey,1,1.84E-06,1,2.28E-06,0,0,2
browns,1,1.84E-06,1,2.28E-06,0,0,1
sketch,1,1.84E-06,1,2.28E-06,0,0,1
enjoys,1,1.84E-06,1,2.28E-06,0,0,2
latvia,1,1.84E-06,1,2.28E-06,0,0,2
bourne,1,1.84E-06,1,2.28E-06,0,0,1
parcel,1,1.84E-06,1,2.28E-06,0,0,2
orange,1,1.84E-06,1,2.28E-06,0,0,2
koreas,1,1.84E-06,1,2.28E-06,0,0,2
freeze,1,1.84E-06,1,2.28E-06,0,0,1
oscars,1,1.84E-06,1,2.28E-06,0,0,2
dieing,1,1.84E-06,1,2.28E-06,0,0,2
yankee,1,1.84E-06,1,2.28E-06,0,0,2
binion,1,1.84E-06,1,2.28E-06,0,0,2
paxton,1,1.84E-06,1,2.28E-06,0,0,2
hikers,1,1.84E-06,1,2.28E-06,0,0,2
sanctity,1,1.84E-06,1,2.28E-06,0,0,3
orator,1,1.84E-06,1,2.28E-06,0,0,3
rwanda,1,1.84E-06,1,2.28E-06,0,0,2
kagame,1,1.84E-06,1,2.28E-06,0,0,2
bailey,1,1.84E-06,1,2.28E-06,0,0,2
disney,1,1.84E-06,1,2.28E-06,0,0,2
helpwe,1,1.84E-06,1,2.28E-06,0,0,1
levine,1,1.84E-06,1,2.28E-06,0,0,2
sneaky,1,1.84E-06,1,2.28E-06,0,0,2
monsey,1,1.84E-06,1,2.28E-06,0,0,2
juliet,1,1.84E-06,1,2.28E-06,0,0,2
mickey,1,1.84E-06,1,2.28E-06,0,0,2
cowboy,1,1.84E-06,1,2.28E-06,0,0,2
alowed,1,1.84E-06,1,2.28E-06,0,0,2
widows,1,1.84E-06,1,2.28E-06,0,0,2
sergey,1,1.84E-06,1,2.28E-06,0,0,2
ornato,1,1.84E-06,1,2.28E-06,0,0,3
domain,1,1.84E-06,1,2.28E-06,0,0,2
oliver,1,1.84E-06,1,2.28E-06,0,0,3
eddies,1,1.84E-06,1,2.28E-06,0,0,2
concha,1,1.84E-06,1,2.28E-06,0,0,2
abrupt,1,1.84E-06,1,2.28E-06,0,0,2
hazard,1,1.84E-06,1,2.28E-06,0,0,2
saugus,1,1.84E-06,1,2.28E-06,0,0,2
stared,1,1.84E-06,1,2.28E-06,0,0,1
cudgel,1,1.84E-06,1,2.28E-06,0,0,2
coward,1,1.84E-06,1,2.28E-06,0,0,2
angels,1,1.84E-06,1,2.28E-06,0,0,2
vowing,1,1.84E-06,1,2.28E-06,0,0,2
risked,1,1.84E-06,1,2.28E-06,0,0,1
dawsey,1,1.84E-06,1,2.28E-06,0,0,2
monroe,1,1.84E-06,1,2.28E-06,0,0,2
finder,1,1.84E-06,1,2.28E-06,0,0,2
volker,1,1.84E-06,1,2.28E-06,0,0,2
wusses,1,1.84E-06,1,2.28E-06,0,0,1
fixers,1,1.84E-06,1,2.28E-06,0,0,2
floors,1,1.84E-06,1,2.28E-06,0,0,1
obsess,1,1.84E-06,1,2.28E-06,0,0,2
infair,1,1.84E-06,1,2.28E-06,0,0,2
casual,1,1.84E-06,1,2.28E-06,0,0,2
ukrain,1,1.84E-06,1,2.28E-06,0,0,2
havana,1,1.84E-06,1,2.28E-06,0,0,3
greedy,1,1.84E-06,1,2.28E-06,0,0,2
depose,1,1.84E-06,1,2.28E-06,0,0,2
beacon,1,1.84E-06,1,2.28E-06,0,0,2
brewer,1,1.84E-06,1,2.28E-06,0,0,2
mccaul,1,1.84E-06,1,2.28E-06,0,0,1
defies,1,1.84E-06,1,2.28E-06,0,0,2
sniper,1,1.84E-06,1,2.28E-06,0,0,2
mortar,1,1.84E-06,1,2.28E-06,0,0,2
wiener,1,1.84E-06,1,2.28E-06,0,0,2
zucker,1,1.84E-06,1,2.28E-06,0,0,2
greasy,1,1.84E-06,1,2.28E-06,0,0,2
justly,1,1.84E-06,1,2.28E-06,0,0,2
serial,1,1.84E-06,1,2.28E-06,0,0,2
buster,1,1.84E-06,1,2.28E-06,0,0,2
grovel,1,1.84E-06,1,2.28E-06,0,0,2
pander,1,1.84E-06,1,2.28E-06,0,0,2
gibson,1,1.84E-06,1,2.28E-06,0,0,2
stifle,1,1.84E-06,1,2.28E-06,0,0,2
shirts,1,1.84E-06,1,2.28E-06,0,0,1
sucker,1,1.84E-06,1,2.28E-06,0,0,2
stonewall,1,1.84E-06,1,2.28E-06,0,0,3
farmer,1,1.84E-06,1,2.28E-06,0,0,2
gators,1,1.84E-06,1,2.28E-06,0,0,2
willfully,1,1.84E-06,1,2.28E-06,0,0,3
hoopla,1,1.84E-06,1,2.28E-06,0,0,2
stymie,1,1.84E-06,1,2.28E-06,0,0,2
waking,1,1.84E-06,1,2.28E-06,0,0,2
negate,1,1.84E-06,1,2.28E-06,0,0,2
preach,1,1.84E-06,1,2.28E-06,0,0,1
hyphen,1,1.84E-06,1,2.28E-06,0,0,2
arming,1,1.84E-06,1,2.28E-06,0,0,2
pamela,1,1.84E-06,1,2.28E-06,0,0,3
paloma,1,1.84E-06,1,2.28E-06,0,0,3
rancho,1,1.84E-06,1,2.28E-06,0,0,2
sununu,1,1.84E-06,1,2.28E-06,0,0,3
shrank,1,1.84E-06,1,2.28E-06,0,0,1
liable,1,1.84E-06,1,2.28E-06,0,0,2
uplift,1,1.84E-06,1,2.28E-06,0,0,2
chains,1,1.84E-06,1,2.28E-06,0,0,1
hiking,1,1.84E-06,1,2.28E-06,0,0,2
dancer,1,1.84E-06,1,2.28E-06,0,0,2
hubert,1,1.84E-06,1,2.28E-06,0,0,2
unnerving,1,1.84E-06,1,2.28E-06,0,0,3
stripe,1,1.84E-06,1,2.28E-06,0,0,1
purest,1,1.84E-06,1,2.28E-06,0,0,2
semnan,1,1.84E-06,1,2.28E-06,0,0,2
wright,1,1.84E-06,1,2.28E-06,0,0,1
corbyn,1,1.84E-06,1,2.28E-06,0,0,2
labour,1,1.84E-06,1,2.28E-06,0,0,2
bedbug,1,1.84E-06,1,2.28E-06,0,0,2
judged,1,1.84E-06,1,2.28E-06,0,0,1
subway,1,1.84E-06,1,2.28E-06,0,0,2
harlem,1,1.84E-06,1,2.28E-06,0,0,2
yields,1,1.84E-06,1,2.28E-06,0,0,1
godbut,1,1.84E-06,1,2.28E-06,0,0,2
fuming,1,1.84E-06,1,2.28E-06,0,0,2
falter,1,1.84E-06,1,2.28E-06,0,0,2
mahers,1,1.84E-06,1,2.28E-06,0,0,2
whaley,1,1.84E-06,1,2.28E-06,0,0,2
clicks,1,1.84E-06,1,2.28E-06,0,0,1
elpaso,1,1.84E-06,1,2.28E-06,0,0,3
pupils,1,1.84E-06,1,2.28E-06,0,0,2
msnbcs,1,1.84E-06,1,2.28E-06,0,0,#ERROR!
stiffs,1,1.84E-06,1,2.28E-06,0,0,1
somali,1,1.84E-06,1,2.28E-06,0,0,3
posing,1,1.84E-06,1,2.28E-06,0,0,2
pumped,1,1.84E-06,1,2.28E-06,0,0,1
favors,1,1.84E-06,1,2.28E-06,0,0,2
gilroy,1,1.84E-06,1,2.28E-06,0,0,2
marris,1,1.84E-06,1,2.28E-06,0,0,2
rodent,1,1.84E-06,1,2.28E-06,0,0,2
wavers,1,1.84E-06,1,2.28E-06,0,0,2
reconnect,1,1.84E-06,1,2.28E-06,0,0,3
rooted,1,1.84E-06,1,2.28E-06,0,0,1
nature,1,1.84E-06,1,2.28E-06,0,0,2
wildly,1,1.84E-06,1,2.28E-06,0,0,2
binary,1,1.84E-06,1,2.28E-06,0,0,3
rockys,1,1.84E-06,1,2.28E-06,0,0,2
carrie,1,1.84E-06,1,2.28E-06,0,0,2
scalia,1,1.84E-06,1,2.28E-06,0,0,2
credited,1,1.84E-06,1,2.28E-06,0,0,2
hormuz,1,1.84E-06,1,2.28E-06,0,0,2
cranks,1,1.84E-06,1,2.28E-06,0,0,1
battling,1,1.84E-06,1,2.28E-06,0,0,2
jasons,1,1.84E-06,1,2.28E-06,0,0,2
accuse,1,1.84E-06,1,2.28E-06,0,0,2
spewed,1,1.84E-06,1,2.28E-06,0,0,1
victoy,1,1.84E-06,1,2.28E-06,0,0,2
jessie,1,1.84E-06,1,2.28E-06,0,0,2
libras,1,1.84E-06,1,2.28E-06,0,0,2
crypto,1,1.84E-06,1,2.28E-06,0,0,2
hrobak,1,1.84E-06,1,2.28E-06,0,0,2
literacy,1,1.84E-06,1,2.28E-06,0,0,4
aghast,1,1.84E-06,1,2.28E-06,0,0,2
andrea,1,1.84E-06,1,2.28E-06,0,0,2
alliances,1,1.84E-06,1,2.28E-06,0,0,2
zoldan,1,1.84E-06,1,2.28E-06,0,0,2
depict,1,1.84E-06,1,2.28E-06,0,0,2
nailno,1,1.84E-06,1,2.28E-06,0,0,2
cocked,1,1.84E-06,1,2.28E-06,0,0,1
alleviate,1,1.84E-06,1,2.28E-06,0,0,3
ratify,1,1.84E-06,1,2.28E-06,0,0,3
disunity,1,1.84E-06,1,2.28E-06,0,0,4
motley,1,1.84E-06,1,2.28E-06,0,0,2
whales,1,1.84E-06,1,2.28E-06,0,0,2
argued,1,1.84E-06,1,2.28E-06,0,0,2
thread,1,1.84E-06,1,2.28E-06,0,0,1
harden,1,1.84E-06,1,2.28E-06,0,0,2
assure,1,1.84E-06,1,2.28E-06,0,0,2
sorial,1,1.84E-06,1,2.28E-06,0,0,2
damian,1,1.84E-06,1,2.28E-06,0,0,2
ebrard,1,1.84E-06,1,2.28E-06,0,0,2
cadets,1,1.84E-06,1,2.28E-06,0,0,2
reuven,1,1.84E-06,1,2.28E-06,0,0,2
corrup,1,1.84E-06,1,2.28E-06,0,0,2
markle,1,1.84E-06,1,2.28E-06,0,0,2
rivkin,1,1.84E-06,1,2.28E-06,0,0,2
abuser,1,1.84E-06,1,2.28E-06,0,0,3
talker,1,1.84E-06,1,2.28E-06,0,0,2
softer,1,1.84E-06,1,2.28E-06,0,0,2
penske,1,1.84E-06,1,2.28E-06,0,0,1
mobara,1,1.84E-06,1,2.28E-06,0,0,3
postthis,1,1.84E-06,1,2.28E-06,0,0,2
assess,1,1.84E-06,1,2.28E-06,0,0,2
geared,1,1.84E-06,1,2.28E-06,0,0,1
waitwhich,1,1.84E-06,0,0,9.47E-06,1,2
chases,1,1.84E-06,1,2.28E-06,0,0,1
nothin,1,1.84E-06,1,2.28E-06,0,0,2
levins,1,1.84E-06,1,2.28E-06,0,0,2
connecting,1,1.84E-06,1,2.28E-06,0,0,3
unveil,1,1.84E-06,1,2.28E-06,0,0,2
sempra,1,1.84E-06,1,2.28E-06,0,0,2
misuse,1,1.84E-06,1,2.28E-06,0,0,2
soared,1,1.84E-06,1,2.28E-06,0,0,1
gilead,1,1.84E-06,1,2.28E-06,0,0,2
watson,1,1.84E-06,1,2.28E-06,0,0,2
nobarr,1,1.84E-06,1,2.28E-06,0,0,2
inions,1,1.84E-06,1,2.28E-06,0,0,2
chabad,1,1.84E-06,1,2.28E-06,0,0,2
offset,1,1.84E-06,1,2.28E-06,0,0,2
smiley,1,1.84E-06,1,2.28E-06,0,0,2
devils,1,1.84E-06,1,2.28E-06,0,0,2
nameno,1,1.84E-06,1,2.28E-06,0,0,3
riches,1,1.84E-06,1,2.28E-06,0,0,1
crosby,1,1.84E-06,1,2.28E-06,0,0,2
waived,1,1.84E-06,1,2.28E-06,0,0,1
airbus,1,1.84E-06,1,2.28E-06,0,0,2
baylor,1,1.84E-06,1,2.28E-06,0,0,2
origin,1,1.84E-06,1,2.28E-06,0,0,3
cleans,1,1.84E-06,1,2.28E-06,0,0,1
usable,1,1.84E-06,1,2.28E-06,0,0,3
throug,1,1.84E-06,1,2.28E-06,0,0,1
jussie,1,1.84E-06,1,2.28E-06,0,0,2
travis,1,1.84E-06,1,2.28E-06,0,0,2
atkins,1,1.84E-06,1,2.28E-06,0,0,2
dispel,1,1.84E-06,1,2.28E-06,0,0,2
tongue,1,1.84E-06,1,2.28E-06,0,0,2
stains,1,1.84E-06,1,2.28E-06,0,0,1
thumbs,1,1.84E-06,1,2.28E-06,0,0,1
ardern,1,1.84E-06,1,2.28E-06,0,0,2
scraps,1,1.84E-06,1,2.28E-06,0,0,1
loftus,1,1.84E-06,1,2.28E-06,0,0,2
comedy,1,1.84E-06,1,2.28E-06,0,0,3
albert,1,1.84E-06,1,2.28E-06,0,0,2
worsts,1,1.84E-06,1,2.28E-06,0,0,1
sorely,1,1.84E-06,1,2.28E-06,0,0,3
nkfake,1,1.84E-06,1,2.28E-06,0,0,1
infant,1,1.84E-06,1,2.28E-06,0,0,2
ledger,1,1.84E-06,1,2.28E-06,0,0,2
cornyn,1,1.84E-06,1,2.28E-06,0,0,2
hunger,1,1.84E-06,1,2.28E-06,0,0,2
reborn,1,1.84E-06,1,2.28E-06,0,0,2
shelby,1,1.84E-06,1,2.28E-06,0,0,2
hooked,1,1.84E-06,1,2.28E-06,0,0,1
enoughits,1,1.84E-06,0,0,9.47E-06,1,3
ousted,1,1.84E-06,1,2.28E-06,0,0,1
colder,1,1.84E-06,1,2.28E-06,0,0,2
waming,1,1.84E-06,1,2.28E-06,0,0,2
howard,1,1.84E-06,1,2.28E-06,0,0,2
conjob,1,1.84E-06,1,2.28E-06,0,0,2
thorns,1,1.84E-06,1,2.28E-06,0,0,1
rivera,1,1.84E-06,1,2.28E-06,0,0,3
rudely,1,1.84E-06,1,2.28E-06,0,0,3
grapes,1,1.84E-06,1,2.28E-06,0,0,1
rested,1,1.84E-06,1,2.28E-06,0,0,1
makers,1,1.84E-06,1,2.28E-06,0,0,2
biasms,1,1.84E-06,1,2.28E-06,0,0,1
motive,1,1.84E-06,1,2.28E-06,0,0,2
wheels,1,1.84E-06,1,2.28E-06,0,0,1
federally,1,1.84E-06,1,2.28E-06,0,0,4
ballooned,1,1.84E-06,1,2.28E-06,0,0,2
compelled,1,1.84E-06,1,2.28E-06,0,0,2
illusions,1,1.84E-06,1,2.28E-06,0,0,3
bellinger,1,1.84E-06,1,2.28E-06,0,0,3
ballrooms,1,1.84E-06,1,2.28E-06,0,0,2
surveyits,1,1.84E-06,0,0,9.47E-06,1,3
monthsits,1,1.84E-06,0,0,9.47E-06,1,2
centennial,1,1.84E-06,1,2.28E-06,0,0,3
polluting,1,1.84E-06,1,2.28E-06,0,0,3
shellaced,1,1.84E-06,1,2.28E-06,0,0,2
policyits,1,1.84E-06,0,0,9.47E-06,1,3
gradually,1,1.84E-06,1,2.28E-06,0,0,3
marchionne,1,1.84E-06,1,2.28E-06,0,0,2
avenatti,1,1.84E-06,1,2.28E-06,0,0,4
boycotts,1,1.84E-06,1,2.28E-06,0,0,2
habitable,1,1.84E-06,0,0,9.47E-06,1,4
rebelling,1,1.84E-06,1,2.28E-06,0,0,3
kenyatta,1,1.84E-06,1,2.28E-06,0,0,3
propelled,1,1.84E-06,1,2.28E-06,0,0,2
attacker,1,1.84E-06,1,2.28E-06,0,0,3
furthers,1,1.84E-06,1,2.28E-06,0,0,2
bettered,1,1.84E-06,1,2.28E-06,0,0,2
windchill,1,1.84E-06,1,2.28E-06,0,0,2
pillsbury,1,1.84E-06,1,2.28E-06,0,0,3
arbitrary,1,1.84E-06,0,0,9.47E-06,1,4
attained,1,1.84E-06,1,2.28E-06,0,0,2
crovatto,1,1.84E-06,1,2.28E-06,0,0,3
exploited,1,1.84E-06,0,0,9.47E-06,1,2
beginnings,1,1.84E-06,1,2.28E-06,0,0,3
americannot,1,1.84E-06,0,0,9.47E-06,1,5
petitions,1,1.84E-06,0,0,9.47E-06,1,3
architect,1,1.84E-06,0,0,9.47E-06,1,3
collective,1,1.84E-06,0,0,9.47E-06,1,3
curiosity,1,1.84E-06,0,0,9.47E-06,1,4
marriott,1,1.84E-06,1,2.28E-06,0,0,2
magnetits,1,1.84E-06,0,0,9.47E-06,1,3
sitecheck,1,1.84E-06,0,0,9.47E-06,1,3
deposited,1,1.84E-06,1,2.28E-06,0,0,3
sanitized,1,1.84E-06,1,2.28E-06,0,0,3
excellence,1,1.84E-06,0,0,9.47E-06,1,3
vendetta,1,1.84E-06,1,2.28E-06,0,0,3
gracefully,1,1.84E-06,1,2.28E-06,0,0,4
switching,1,1.84E-06,1,2.28E-06,0,0,2
appetites,1,1.84E-06,1,2.28E-06,0,0,3
ethnicity,1,1.84E-06,1,2.28E-06,0,0,4
godmother,1,1.84E-06,0,0,9.47E-06,1,3
initiated,1,1.84E-06,1,2.28E-06,0,0,3
allocating,1,1.84E-06,1,2.28E-06,0,0,4
theatrics,1,1.84E-06,1,2.28E-06,0,0,2
arbitrate,1,1.84E-06,1,2.28E-06,0,0,3
magnitude,1,1.84E-06,1,2.28E-06,0,0,3
sanitizer,1,1.84E-06,1,2.28E-06,0,0,4
hermitage,1,1.84E-06,1,2.28E-06,0,0,3
anonymity,1,1.84E-06,1,2.28E-06,0,0,5
letterman,1,1.84E-06,0,0,9.47E-06,1,3
obscurity,1,1.84E-06,1,2.28E-06,0,0,4
attackers,1,1.84E-06,0,0,9.47E-06,1,3
annihilated,1,1.84E-06,1,2.28E-06,0,0,4
upsetting,1,1.84E-06,0,0,9.47E-06,1,3
sincerity,1,1.84E-06,1,2.28E-06,0,0,4
commence,1,1.84E-06,1,2.28E-06,0,0,2
distillers,1,1.84E-06,1,2.28E-06,0,0,3
disparity,1,1.84E-06,1,2.28E-06,0,0,4
nighttune,1,1.84E-06,0,0,9.47E-06,1,2
batteries,1,1.84E-06,0,0,9.47E-06,1,3
collegiate,1,1.84E-06,1,2.28E-06,0,0,3
misspelled,1,1.84E-06,1,2.28E-06,0,0,2
nighttime,1,1.84E-06,1,2.28E-06,0,0,2
capitolit,1,1.84E-06,1,2.28E-06,0,0,4
synthetic,1,1.84E-06,1,2.28E-06,0,0,3
citations,1,1.84E-06,1,2.28E-06,0,0,3
limitsamb,1,1.84E-06,1,2.28E-06,0,0,3
challenger,1,1.84E-06,1,2.28E-06,0,0,3
brutality,1,1.84E-06,1,2.28E-06,0,0,4
connections,1,1.84E-06,1,2.28E-06,0,0,3
hypocrite,1,1.84E-06,1,2.28E-06,0,0,3
cellphones,1,1.84E-06,1,2.28E-06,0,0,2
immersed,1,1.84E-06,1,2.28E-06,0,0,2
cattlemen,1,1.84E-06,1,2.28E-06,0,0,3
collapsing,1,1.84E-06,1,2.28E-06,0,0,3
imitation,1,1.84E-06,1,2.28E-06,0,0,4
uncommon,1,1.84E-06,1,2.28E-06,0,0,3
squatters,1,1.84E-06,1,2.28E-06,0,0,2
viability,1,1.84E-06,1,2.28E-06,0,0,4
reuniting,1,1.84E-06,1,2.28E-06,0,0,3
utilities,1,1.84E-06,1,2.28E-06,0,0,4
lithuania,1,1.84E-06,1,2.28E-06,0,0,3
evansville,1,1.84E-06,1,2.28E-06,0,0,3
criminally,1,1.84E-06,1,2.28E-06,0,0,4
counselall,1,1.84E-06,1,2.28E-06,0,0,3
marinette,1,1.84E-06,1,2.28E-06,0,0,3
captivity,1,1.84E-06,1,2.28E-06,0,0,4
stammers,1,1.84E-06,1,2.28E-06,0,0,2
slamming,1,1.84E-06,1,2.28E-06,0,0,2
councelall,1,1.84E-06,1,2.28E-06,0,0,3
collussion,1,1.84E-06,1,2.28E-06,0,0,3
rendition,1,1.84E-06,1,2.28E-06,0,0,3
mammogram,1,1.84E-06,0,0,9.47E-06,1,3
militants,1,1.84E-06,1,2.28E-06,0,0,3
boycotted,1,1.84E-06,1,2.28E-06,0,0,2
ambitions,1,1.84E-06,1,2.28E-06,0,0,3
physically,1,1.84E-06,1,2.28E-06,0,0,4
thatthose,1,1.84E-06,1,2.28E-06,0,0,2
seditious,1,1.84E-06,1,2.28E-06,0,0,4
petterson,1,1.84E-06,1,2.28E-06,0,0,3
exquisite,1,1.84E-06,1,2.28E-06,0,0,3
yountville,1,1.84E-06,1,2.28E-06,0,0,2
deceitful,1,1.84E-06,1,2.28E-06,0,0,3
prohibits,1,1.84E-06,1,2.28E-06,0,0,3
properity,1,1.84E-06,1,2.28E-06,0,0,4
betterour,1,1.84E-06,1,2.28E-06,0,0,3
economyits,1,1.84E-06,0,0,9.47E-06,1,4
bombshells,1,1.84E-06,1,2.28E-06,0,0,2
reiterates,1,1.84E-06,0,0,9.47E-06,1,3
lotteries,1,1.84E-06,1,2.28E-06,0,0,3
tragically,1,1.84E-06,1,2.28E-06,0,0,4
forcefully,1,1.84E-06,1,2.28E-06,0,0,4
patrolling,1,1.84E-06,1,2.28E-06,0,0,3
unnoticeable,1,1.84E-06,1,2.28E-06,0,0,5
positively,1,1.84E-06,0,0,9.47E-06,1,5
identities,1,1.84E-06,0,0,9.47E-06,1,4
anymoreits,1,1.84E-06,0,0,9.47E-06,1,4
immensely,1,1.84E-06,1,2.28E-06,0,0,4
backetball,1,1.84E-06,1,2.28E-06,0,0,3
positioned,1,1.84E-06,0,0,9.47E-06,1,3
interfaith,1,1.84E-06,0,0,9.47E-06,1,3
geothermal,1,1.84E-06,0,0,9.47E-06,1,3
ledbetters,1,1.84E-06,0,0,9.47E-06,1,3
unlawfully,1,1.84E-06,1,2.28E-06,0,0,4
unnecessarily,1,1.84E-06,1,2.28E-06,0,0,6
continually,1,1.84E-06,0,0,9.47E-06,1,4
campaignall,1,1.84E-06,0,0,9.47E-06,1,3
deficitits,1,1.84E-06,0,0,9.47E-06,1,4
politifact,1,1.84E-06,0,0,9.47E-06,1,4
gettysburg,1,1.84E-06,1,2.28E-06,0,0,3
anniversaries,1,1.84E-06,1,2.28E-06,0,0,5
partiesits,1,1.84E-06,0,0,9.47E-06,1,3
attributes,1,1.84E-06,1,2.28E-06,0,0,3
prohibited,1,1.84E-06,1,2.28E-06,0,0,3
organically,1,1.84E-06,1,2.28E-06,0,0,5
calamities,1,1.84E-06,1,2.28E-06,0,0,4
impartially,1,1.84E-06,1,2.28E-06,0,0,4
marshalling,1,1.84E-06,1,2.28E-06,0,0,3
phillipines,1,1.84E-06,1,2.28E-06,0,0,3
flattening,1,1.84E-06,1,2.28E-06,0,0,3
unsanitary,1,1.84E-06,1,2.28E-06,0,0,5
shanksville,1,1.84E-06,1,2.28E-06,0,0,2
schumerite,1,1.84E-06,1,2.28E-06,0,0,3
frantically,1,1.84E-06,1,2.28E-06,0,0,4
noblesville,1,1.84E-06,1,2.28E-06,0,0,3
nonprofits,1,1.84E-06,1,2.28E-06,0,0,3
extradited,1,1.84E-06,1,2.28E-06,0,0,3
billionyear,1,1.84E-06,1,2.28E-06,0,0,4
methane,1,1.84E-06,0,0,9.47E-06,1,2
lowjust,1,1.84E-06,0,0,9.47E-06,1,2
sweater,1,1.84E-06,0,0,9.47E-06,1,2
outdont,1,1.84E-06,0,0,9.47E-06,1,2
newsbut,1,1.84E-06,0,0,9.47E-06,1,2
augusta,1,1.84E-06,0,0,9.47E-06,1,3
planadd,1,1.84E-06,0,0,9.47E-06,1,2
frisked,1,1.84E-06,0,0,9.47E-06,1,1
goodbut,1,1.84E-06,0,0,9.47E-06,1,2
ramadan,1,1.84E-06,0,0,9.47E-06,1,3
loveour,1,1.84E-06,0,0,9.47E-06,1,3
partial,1,1.84E-06,0,0,9.47E-06,1,2
classmr,1,1.84E-06,0,0,9.47E-06,1,1
insured,1,1.84E-06,0,0,9.47E-06,1,2
bristol,1,1.84E-06,0,0,9.47E-06,1,2
worldwe,1,1.84E-06,0,0,9.47E-06,1,1
daylets,1,1.84E-06,0,0,9.47E-06,1,2
haunted,1,1.84E-06,0,0,9.47E-06,1,1
lshanah,1,1.84E-06,0,0,9.47E-06,1,2
reining,1,1.84E-06,0,0,9.47E-06,1,2
corners,1,1.84E-06,0,0,9.47E-06,1,2
willingness,1,1.84E-06,1,2.28E-06,0,0,3
stripes,1,1.84E-06,0,0,9.47E-06,1,1
skyline,1,1.84E-06,0,0,9.47E-06,1,2
comptroller,1,1.84E-06,1,2.28E-06,0,0,3
compass,1,1.84E-06,0,0,9.47E-06,1,2
goingto,1,1.84E-06,0,0,9.47E-06,1,2
engages,1,1.84E-06,0,0,9.47E-06,1,2
riskyno,1,1.84E-06,0,0,9.47E-06,1,3
lovable,1,1.84E-06,0,0,9.47E-06,1,3
leaping,1,1.84E-06,0,0,9.47E-06,1,2
broncos,1,1.84E-06,0,0,9.47E-06,1,2
affront,1,1.84E-06,0,0,9.47E-06,1,2
decency,1,1.84E-06,0,0,9.47E-06,1,3
dunking,1,1.84E-06,0,0,9.47E-06,1,2
popcorn,1,1.84E-06,0,0,9.47E-06,1,2
handout,1,1.84E-06,0,0,9.47E-06,1,2
toughwe,1,1.84E-06,0,0,9.47E-06,1,1
howards,1,1.84E-06,0,0,9.47E-06,1,2
bunions,1,1.84E-06,0,0,9.47E-06,1,2
unsettling,1,1.84E-06,1,2.28E-06,0,0,3
dcenter,1,1.84E-06,0,0,9.47E-06,1,2
signups,1,1.84E-06,0,0,9.47E-06,1,2
toenail,1,1.84E-06,0,0,9.47E-06,1,2
couples,1,1.84E-06,0,0,9.47E-06,1,2
curtain,1,1.84E-06,0,0,9.47E-06,1,2
ransoms,1,1.84E-06,0,0,9.47E-06,1,2
voyager,1,1.84E-06,0,0,9.47E-06,1,3
ticketpolls,1,1.84E-06,1,2.28E-06,0,0,3
morales,1,1.84E-06,0,0,9.47E-06,1,3
dreamer,1,1.84E-06,0,0,9.47E-06,1,2
homeyou,1,1.84E-06,0,0,9.47E-06,1,3
bubbles,1,1.84E-06,0,0,9.47E-06,1,2
durable,1,1.84E-06,0,0,9.47E-06,1,3
upthats,1,1.84E-06,0,0,9.47E-06,1,2
loveyou,1,1.84E-06,0,0,9.47E-06,1,3
dreamwe,1,1.84E-06,0,0,9.47E-06,1,1
ketchup,1,1.84E-06,0,0,9.47E-06,1,2
mustard,1,1.84E-06,0,0,9.47E-06,1,2
duchess,1,1.84E-06,0,0,9.47E-06,1,2
trayvon,1,1.84E-06,0,0,9.47E-06,1,2
compact,1,1.84E-06,0,0,9.47E-06,1,2
consume,1,1.84E-06,0,0,9.47E-06,1,2
marbles,1,1.84E-06,0,0,9.47E-06,1,2
matched,1,1.84E-06,0,0,9.47E-06,1,1
alaskas,1,1.84E-06,0,0,9.47E-06,1,3
glacier,1,1.84E-06,0,0,9.47E-06,1,2
manhattans,1,1.84E-06,1,2.28E-06,0,0,3
jogging,1,1.84E-06,0,0,9.47E-06,1,2
jobsnot,1,1.84E-06,0,0,9.47E-06,1,2
drastic,1,1.84E-06,0,0,9.47E-06,1,2
shrinks,1,1.84E-06,0,0,9.47E-06,1,1
anyones,1,1.84E-06,0,0,9.47E-06,1,2
propels,1,1.84E-06,0,0,9.47E-06,1,2
salesrt,1,1.84E-06,0,0,9.47E-06,1,2
authors,1,1.84E-06,0,0,9.47E-06,1,2
pausing,1,1.84E-06,0,0,9.47E-06,1,2
equalis,1,1.84E-06,0,0,9.47E-06,1,3
hugging,1,1.84E-06,0,0,9.47E-06,1,2
ripples,1,1.84E-06,0,0,9.47E-06,1,2
caterpillar,1,1.84E-06,1,2.28E-06,0,0,4
knowjoe,1,1.84E-06,0,0,9.47E-06,1,2
thingrt,1,1.84E-06,0,0,9.47E-06,1,1
lesbian,1,1.84E-06,0,0,9.47E-06,1,2
concord,1,1.84E-06,0,0,9.47E-06,1,2
bristow,1,1.84E-06,0,0,9.47E-06,1,2
oncolin,1,1.84E-06,0,0,9.47E-06,1,3
hanging,1,1.84E-06,0,0,9.47E-06,1,2
signage,1,1.84E-06,0,0,9.47E-06,1,2
eyewitness,1,1.84E-06,1,2.28E-06,0,0,4
capability,1,1.84E-06,1,2.28E-06,0,0,5
specter,1,1.84E-06,0,0,9.47E-06,1,2
trickle,1,1.84E-06,0,0,9.47E-06,1,2
jerking,1,1.84E-06,0,0,9.47E-06,1,2
easiest,1,1.84E-06,0,0,9.47E-06,1,2
coolest,1,1.84E-06,0,0,9.47E-06,1,2
bowling,1,1.84E-06,0,0,9.47E-06,1,2
lockout,1,1.84E-06,0,0,9.47E-06,1,2
context,1,1.84E-06,0,0,9.47E-06,1,2
roadget,1,1.84E-06,0,0,9.47E-06,1,2
endowed,1,1.84E-06,0,0,9.47E-06,1,2
heating,1,1.84E-06,0,0,9.47E-06,1,2
classwe,1,1.84E-06,0,0,9.47E-06,1,1
refunds,1,1.84E-06,0,0,9.47E-06,1,2
couldve,1,1.84E-06,0,0,9.47E-06,1,1
defines,1,1.84E-06,0,0,9.47E-06,1,2
voteyou,1,1.84E-06,0,0,9.47E-06,1,3
denison,1,1.84E-06,0,0,9.47E-06,1,3
eagerly,1,1.84E-06,0,0,9.47E-06,1,3
daytake,1,1.84E-06,0,0,9.47E-06,1,2
sinegal,1,1.84E-06,0,0,9.47E-06,1,3
lending,1,1.84E-06,0,0,9.47E-06,1,2
pirates,1,1.84E-06,0,0,9.47E-06,1,2
skeptic,1,1.84E-06,0,0,9.47E-06,1,2
diploma,1,1.84E-06,0,0,9.47E-06,1,3
intents,1,1.84E-06,0,0,9.47E-06,1,2
juniors,1,1.84E-06,0,0,9.47E-06,1,2
repetitive,1,1.84E-06,1,2.28E-06,0,0,4
ancient,1,1.84E-06,0,0,9.47E-06,1,2
illustrated,1,1.84E-06,1,2.28E-06,0,0,3
comesay,1,1.84E-06,0,0,9.47E-06,1,3
shadowy,1,1.84E-06,0,0,9.47E-06,1,3
graders,1,1.84E-06,0,0,9.47E-06,1,2
youjust,1,1.84E-06,0,0,9.47E-06,1,2
workout,1,1.84E-06,0,0,9.47E-06,1,2
parkers,1,1.84E-06,0,0,9.47E-06,1,2
daysend,1,1.84E-06,0,0,9.47E-06,1,2
quizzed,1,1.84E-06,0,0,9.47E-06,1,1
hussein,1,1.84E-06,0,0,9.47E-06,1,2
behring,1,1.84E-06,0,0,9.47E-06,1,2
barnard,1,1.84E-06,0,0,9.47E-06,1,2
ratesrt,1,1.84E-06,0,0,9.47E-06,1,2
backnow,1,1.84E-06,0,0,9.47E-06,1,2
shaking,1,1.84E-06,0,0,9.47E-06,1,2
doubles,1,1.84E-06,0,0,9.47E-06,1,2
mercury,1,1.84E-06,0,0,9.47E-06,1,3
peppers,1,1.84E-06,0,0,9.47E-06,1,2
twiceat,1,1.84E-06,0,0,9.47E-06,1,2
fooling,1,1.84E-06,0,0,9.47E-06,1,2
yetchip,1,1.84E-06,0,0,9.47E-06,1,2
baracka,1,1.84E-06,0,0,9.47E-06,1,3
stephon,1,1.84E-06,0,0,9.47E-06,1,2
fatherhood,1,1.84E-06,0,0,9.47E-06,1,3
apodaca,1,1.84E-06,0,0,9.47E-06,1,4
sputtering,1,1.84E-06,1,2.28E-06,0,0,3
dusting,1,1.84E-06,0,0,9.47E-06,1,2
soonget,1,1.84E-06,0,0,9.47E-06,1,2
reiterated,1,1.84E-06,1,2.28E-06,0,0,3
tackles,1,1.84E-06,0,0,9.47E-06,1,2
matchup,1,1.84E-06,0,0,9.47E-06,1,2
gameday,1,1.84E-06,0,0,9.47E-06,1,3
commences,1,1.84E-06,1,2.28E-06,0,0,2
copouts,1,1.84E-06,0,0,9.47E-06,1,2
valarie,1,1.84E-06,0,0,9.47E-06,1,3
menorah,1,1.84E-06,0,0,9.47E-06,1,3
battleship,1,1.84E-06,1,2.28E-06,0,0,3
planbetter,1,1.84E-06,1,2.28E-06,0,0,3
documentit,1,1.84E-06,1,2.28E-06,0,0,4
curious,1,1.84E-06,0,0,9.47E-06,1,3
wonderfully,1,1.84E-06,1,2.28E-06,0,0,4
actmake,1,1.84E-06,0,0,9.47E-06,1,2
chipped,1,1.84E-06,0,0,9.47E-06,1,1
militaries,1,1.84E-06,1,2.28E-06,0,0,4
tumbler,1,1.84E-06,0,0,9.47E-06,1,2
drastically,1,1.84E-06,1,2.28E-06,0,0,4
krueger,1,1.84E-06,0,0,9.47E-06,1,2
cutswho,1,1.84E-06,0,0,9.47E-06,1,2
packers,1,1.84E-06,0,0,9.47E-06,1,2
workhow,1,1.84E-06,0,0,9.47E-06,1,2
removes,1,1.84E-06,0,0,9.47E-06,1,2
wambach,1,1.84E-06,0,0,9.47E-06,1,2
axelrod,1,1.84E-06,0,0,9.47E-06,1,3
touring,1,1.84E-06,0,0,9.47E-06,1,2
tornado,1,1.84E-06,0,0,9.47E-06,1,3
ferraro,1,1.84E-06,0,0,9.47E-06,1,3
genuine,1,1.84E-06,0,0,9.47E-06,1,2
sputnik,1,1.84E-06,0,0,9.47E-06,1,2
candles,1,1.84E-06,0,0,9.47E-06,1,2
disdainfully,1,1.84E-06,0,0,9.47E-06,1,4
teaming,1,1.84E-06,0,0,9.47E-06,1,2
sounder,1,1.84E-06,0,0,9.47E-06,1,2
footing,1,1.84E-06,0,0,9.47E-06,1,2
doingas,1,1.84E-06,0,0,9.47E-06,1,2
drowned,1,1.84E-06,0,0,9.47E-06,1,1
atideas,1,1.84E-06,0,0,9.47E-06,1,3
partyas,1,1.84E-06,0,0,9.47E-06,1,2
etwatch,1,1.84E-06,0,0,9.47E-06,1,2
fremont,1,1.84E-06,0,0,9.47E-06,1,2
arcadia,1,1.84E-06,0,0,9.47E-06,1,3
chilean,1,1.84E-06,0,0,9.47E-06,1,2
changea,1,1.84E-06,0,0,9.47E-06,1,2
fatalities,1,1.84E-06,1,2.28E-06,0,0,4
therapists,1,1.84E-06,1,2.28E-06,0,0,3
mislead,1,1.84E-06,0,0,9.47E-06,1,2
mirrors,1,1.84E-06,0,0,9.47E-06,1,2
stepbut,1,1.84E-06,0,0,9.47E-06,1,2
grandma,1,1.84E-06,0,0,9.47E-06,1,2
tobacco,1,1.84E-06,0,0,9.47E-06,1,3
minuses,1,1.84E-06,1,2.28E-06,0,0,2
deletes,1,1.84E-06,1,2.28E-06,0,0,2
wreaths,1,1.84E-06,1,2.28E-06,0,0,1
hopkins,1,1.84E-06,1,2.28E-06,0,0,2
recants,1,1.84E-06,1,2.28E-06,0,0,2
esshaki,1,1.84E-06,1,2.28E-06,0,0,3
organic,1,1.84E-06,1,2.28E-06,0,0,3
amistad,1,1.84E-06,1,2.28E-06,0,0,3
morgana,1,1.84E-06,1,2.28E-06,0,0,3
lansing,1,1.84E-06,1,2.28E-06,0,0,2
mcadams,1,1.84E-06,1,2.28E-06,0,0,2
suckers,1,1.84E-06,1,2.28E-06,0,0,2
climber,1,1.84E-06,1,2.28E-06,0,0,2
jewelry,1,1.84E-06,1,2.28E-06,0,0,3
glimpse,1,1.84E-06,1,2.28E-06,0,0,1
bidenim,1,1.84E-06,1,2.28E-06,0,0,3
stalked,1,1.84E-06,1,2.28E-06,0,0,1
notrend,1,1.84E-06,1,2.28E-06,0,0,2
fuentes,1,1.84E-06,1,2.28E-06,0,0,1
melissa,1,1.84E-06,1,2.28E-06,0,0,3
robbers,1,1.84E-06,1,2.28E-06,0,0,2
rapists,1,1.84E-06,1,2.28E-06,0,0,2
nevadas,1,1.84E-06,1,2.28E-06,0,0,3
swampso,1,1.84E-06,1,2.28E-06,0,0,2
diehard,1,1.84E-06,1,2.28E-06,0,0,2
equaled,1,1.84E-06,1,2.28E-06,0,0,2
bookies,1,1.84E-06,1,2.28E-06,0,0,2
arrives,1,1.84E-06,1,2.28E-06,0,0,2
attempting,1,1.84E-06,1,2.28E-06,0,0,3
plagued,1,1.84E-06,1,2.28E-06,0,0,2
derrick,1,1.84E-06,1,2.28E-06,0,0,2
greener,1,1.84E-06,1,2.28E-06,0,0,2
floated,1,1.84E-06,1,2.28E-06,0,0,1
rejects,1,1.84E-06,1,2.28E-06,0,0,2
roughed,1,1.84E-06,1,2.28E-06,0,0,1
bidding,1,1.84E-06,1,2.28E-06,0,0,2
debunks,1,1.84E-06,1,2.28E-06,0,0,2
promesa,1,1.84E-06,1,2.28E-06,0,0,3
familia,1,1.84E-06,1,2.28E-06,0,0,3
refugee,1,1.84E-06,1,2.28E-06,0,0,3
scooter,1,1.84E-06,1,2.28E-06,0,0,2
austria,1,1.84E-06,1,2.28E-06,0,0,2
baghdad,1,1.84E-06,1,2.28E-06,0,0,2
unfettered,1,1.84E-06,1,2.28E-06,0,0,3
solidly,1,1.84E-06,1,2.28E-06,0,0,3
martial,1,1.84E-06,1,2.28E-06,0,0,2
renames,1,1.84E-06,1,2.28E-06,0,0,2
pursues,1,1.84E-06,1,2.28E-06,0,0,2
crudely,1,1.84E-06,1,2.28E-06,0,0,3
toppled,1,1.84E-06,1,2.28E-06,0,0,1
publish,1,1.84E-06,1,2.28E-06,0,0,2
hastily,1,1.84E-06,1,2.28E-06,0,0,3
staceys,1,1.84E-06,1,2.28E-06,0,0,2
comeour,1,1.84E-06,1,2.28E-06,0,0,3
undoing,1,1.84E-06,1,2.28E-06,0,0,2
mcenany,1,1.84E-06,1,2.28E-06,0,0,3
admirer,1,1.84E-06,1,2.28E-06,0,0,3
langone,1,1.84E-06,1,2.28E-06,0,0,2
preview,1,1.84E-06,1,2.28E-06,0,0,2
takeout,1,1.84E-06,1,2.28E-06,0,0,3
iranwho,1,1.84E-06,1,2.28E-06,0,0,3
staging,1,1.84E-06,1,2.28E-06,0,0,2
adjourn,1,1.84E-06,1,2.28E-06,0,0,2
crackup,1,1.84E-06,1,2.28E-06,0,0,2
godsend,1,1.84E-06,1,2.28E-06,0,0,2
stooped,1,1.84E-06,1,2.28E-06,0,0,1
maniacs,1,1.84E-06,1,2.28E-06,0,0,2
decried,1,1.84E-06,1,2.28E-06,0,0,2
surgeon,1,1.84E-06,1,2.28E-06,0,0,2
buckets,1,1.84E-06,1,2.28E-06,0,0,2
situations,1,1.84E-06,1,2.28E-06,0,0,3
paydirt,1,1.84E-06,1,2.28E-06,0,0,2
gambled,1,1.84E-06,1,2.28E-06,0,0,1
replied,1,1.84E-06,1,2.28E-06,0,0,2
recuses,1,1.84E-06,1,2.28E-06,0,0,2
spoiler,1,1.84E-06,1,2.28E-06,0,0,2
deflect,1,1.84E-06,1,2.28E-06,0,0,2
reagans,1,1.84E-06,1,2.28E-06,0,0,2
abiding,1,1.84E-06,1,2.28E-06,0,0,3
oversee,1,1.84E-06,1,2.28E-06,0,0,3
proxies,1,1.84E-06,1,2.28E-06,0,0,2
gutfeld,1,1.84E-06,1,2.28E-06,0,0,2
colbert,1,1.84E-06,1,2.28E-06,0,0,2
scratch,1,1.84E-06,1,2.28E-06,0,0,1
stocked,1,1.84E-06,1,2.28E-06,0,0,1
luckier,1,1.84E-06,1,2.28E-06,0,0,2
adriana,1,1.84E-06,1,2.28E-06,0,0,3
heckler,1,1.84E-06,1,2.28E-06,0,0,2
monahan,1,1.84E-06,1,2.28E-06,0,0,3
brewing,1,1.84E-06,1,2.28E-06,0,0,2
eminent,1,1.84E-06,1,2.28E-06,0,0,3
rafical,1,1.84E-06,1,2.28E-06,0,0,3
trample,1,1.84E-06,1,2.28E-06,0,0,2
derecho,1,1.84E-06,1,2.28E-06,0,0,3
publics,1,1.84E-06,1,2.28E-06,0,0,2
gohmert,1,1.84E-06,1,2.28E-06,0,0,2
emotion,1,1.84E-06,1,2.28E-06,0,0,3
abusive,1,1.84E-06,1,2.28E-06,0,0,3
surreal,1,1.84E-06,1,2.28E-06,0,0,2
escobar,1,1.84E-06,1,2.28E-06,0,0,3
faculty,1,1.84E-06,1,2.28E-06,0,0,3
shields,1,1.84E-06,1,2.28E-06,0,0,1
wimpier,1,1.84E-06,1,2.28E-06,0,0,2
torches,1,1.84E-06,1,2.28E-06,0,0,1
propped,1,1.84E-06,1,2.28E-06,0,0,1
mohamed,1,1.84E-06,1,2.28E-06,0,0,2
unmercifully,1,1.84E-06,1,2.28E-06,0,0,5
cruises,1,1.84E-06,1,2.28E-06,0,0,1
humanly,1,1.84E-06,1,2.28E-06,0,0,3
drifted,1,1.84E-06,1,2.28E-06,0,0,1
earthwe,1,1.84E-06,1,2.28E-06,0,0,1
unravel,1,1.84E-06,1,2.28E-06,0,0,3
mobster,1,1.84E-06,1,2.28E-06,0,0,2
growers,1,1.84E-06,1,2.28E-06,0,0,2
airhead,1,1.84E-06,1,2.28E-06,0,0,2
bungled,1,1.84E-06,1,2.28E-06,0,0,1
cynthia,1,1.84E-06,1,2.28E-06,0,0,2
disband,1,1.84E-06,1,2.28E-06,0,0,2
staring,1,1.84E-06,1,2.28E-06,0,0,2
saphier,1,1.84E-06,1,2.28E-06,0,0,2
shotgun,1,1.84E-06,1,2.28E-06,0,0,2
centric,1,1.84E-06,1,2.28E-06,0,0,2
crosses,1,1.84E-06,1,2.28E-06,0,0,1
paratus,1,1.84E-06,1,2.28E-06,0,0,3
vessels,1,1.84E-06,1,2.28E-06,0,0,2
whimper,1,1.84E-06,1,2.28E-06,0,0,2
affixed,1,1.84E-06,1,2.28E-06,0,0,2
disability,1,1.84E-06,1,2.28E-06,0,0,5
busiest,1,1.84E-06,1,2.28E-06,0,0,2
parsons,1,1.84E-06,1,2.28E-06,0,0,2
accidentally,1,1.84E-06,1,2.28E-06,0,0,5
memphis,1,1.84E-06,1,2.28E-06,0,0,2
hookers,1,1.84E-06,1,2.28E-06,0,0,2
artistically,1,1.84E-06,1,2.28E-06,0,0,5
repairs,1,1.84E-06,1,2.28E-06,0,0,2
winston,1,1.84E-06,1,2.28E-06,0,0,2
robeson,1,1.84E-06,1,2.28E-06,0,0,3
counyry,1,1.84E-06,1,2.28E-06,0,0,3
becsuse,1,1.84E-06,1,2.28E-06,0,0,2
forgery,1,1.84E-06,1,2.28E-06,0,0,3
grocers,1,1.84E-06,1,2.28E-06,0,0,2
beacons,1,1.84E-06,1,2.28E-06,0,0,2
squelch,1,1.84E-06,1,2.28E-06,0,0,1
betterment,1,1.84E-06,1,2.28E-06,0,0,3
whitewater,1,1.84E-06,1,2.28E-06,0,0,4
foresee,1,1.84E-06,1,2.28E-06,0,0,3
mrtrump,1,1.84E-06,1,2.28E-06,0,0,1
commuting,1,1.84E-06,1,2.28E-06,0,0,3
stumble,1,1.84E-06,1,2.28E-06,0,0,2
hotspot,1,1.84E-06,1,2.28E-06,0,0,2
descend,1,1.84E-06,1,2.28E-06,0,0,2
mancini,1,1.84E-06,1,2.28E-06,0,0,3
younger,1,1.84E-06,1,2.28E-06,0,0,2
ripoffs,1,1.84E-06,1,2.28E-06,0,0,2
soaking,1,1.84E-06,1,2.28E-06,0,0,2
frances,1,1.84E-06,1,2.28E-06,0,0,1
listing,1,1.84E-06,1,2.28E-06,0,0,2
entails,1,1.84E-06,1,2.28E-06,0,0,2
utahans,1,1.84E-06,1,2.28E-06,0,0,3
regions,1,1.84E-06,1,2.28E-06,0,0,2
agendas,1,1.84E-06,1,2.28E-06,0,0,3
hustory,1,1.84E-06,1,2.28E-06,0,0,3
cheered,1,1.84E-06,1,2.28E-06,0,0,1
tryingwith,1,1.84E-06,1,2.28E-06,0,0,2
mclarty,1,1.84E-06,1,2.28E-06,0,0,2
congenital,1,1.84E-06,1,2.28E-06,0,0,4
kistner,1,1.84E-06,1,2.28E-06,0,0,2
trivial,1,1.84E-06,1,2.28E-06,0,0,2
denials,1,1.84E-06,1,2.28E-06,0,0,2
severly,1,1.84E-06,1,2.28E-06,0,0,3
individually,1,1.84E-06,1,2.28E-06,0,0,5
faraway,1,1.84E-06,1,2.28E-06,0,0,3
puddles,1,1.84E-06,1,2.28E-06,0,0,2
payoffs,1,1.84E-06,1,2.28E-06,0,0,2
collaborated,1,1.84E-06,1,2.28E-06,0,0,4
bribing,1,1.84E-06,1,2.28E-06,0,0,2
mankato,1,1.84E-06,1,2.28E-06,0,0,3
auditorium,1,1.84E-06,1,2.28E-06,0,0,4
vacated,1,1.84E-06,1,2.28E-06,0,0,2
trashed,1,1.84E-06,1,2.28E-06,0,0,1
plunges,1,1.84E-06,1,2.28E-06,0,0,1
cigarettes,1,1.84E-06,1,2.28E-06,0,0,3
beneath,1,1.84E-06,1,2.28E-06,0,0,2
readers,1,1.84E-06,1,2.28E-06,0,0,2
starved,1,1.84E-06,1,2.28E-06,0,0,1
crashes,1,1.84E-06,1,2.28E-06,0,0,1
lapdogs,1,1.84E-06,1,2.28E-06,0,0,2
prefers,1,1.84E-06,1,2.28E-06,0,0,2
compton,1,1.84E-06,1,2.28E-06,0,0,2
thinker,1,1.84E-06,1,2.28E-06,0,0,2
morebut,1,1.84E-06,1,2.28E-06,0,0,3
richter,1,1.84E-06,1,2.28E-06,0,0,2
vanessa,1,1.84E-06,1,2.28E-06,0,0,3
javelin,1,1.84E-06,1,2.28E-06,0,0,3
fulcher,1,1.84E-06,1,2.28E-06,0,0,2
adamant,1,1.84E-06,1,2.28E-06,0,0,3
mccains,1,1.84E-06,1,2.28E-06,0,0,1
honoree,1,1.84E-06,1,2.28E-06,0,0,3
dislike,1,1.84E-06,1,2.28E-06,0,0,2
woodrow,1,1.84E-06,1,2.28E-06,0,0,2
brigade,1,1.84E-06,1,2.28E-06,0,0,2
gaining,1,1.84E-06,1,2.28E-06,0,0,2
michele,1,1.84E-06,1,2.28E-06,0,0,3
perhsps,1,1.84E-06,1,2.28E-06,0,0,1
afkarai,1,1.84E-06,1,2.28E-06,0,0,3
kirstie,1,1.84E-06,1,2.28E-06,0,0,2
library,1,1.84E-06,1,2.28E-06,0,0,3
pounces,1,1.84E-06,1,2.28E-06,0,0,1
deposition,1,1.84E-06,1,2.28E-06,0,0,4
hopping,1,1.84E-06,1,2.28E-06,0,0,2
whipped,1,1.84E-06,1,2.28E-06,0,0,1
unasked,1,1.84E-06,1,2.28E-06,0,0,2
kindest,1,1.84E-06,1,2.28E-06,0,0,2
newport,1,1.84E-06,1,2.28E-06,0,0,2
blooded,1,1.84E-06,1,2.28E-06,0,0,1
balkans,1,1.84E-06,1,2.28E-06,0,0,2
serbias,1,1.84E-06,1,2.28E-06,0,0,2
chrisie,1,1.84E-06,1,2.28E-06,0,0,2
synergy,1,1.84E-06,1,2.28E-06,0,0,3
blasted,1,1.84E-06,1,2.28E-06,0,0,1
storage,1,1.84E-06,1,2.28E-06,0,0,2
stepien,1,1.84E-06,1,2.28E-06,0,0,2
builder,1,1.84E-06,1,2.28E-06,0,0,2
polices,1,1.84E-06,1,2.28E-06,0,0,2
dragged,1,1.84E-06,1,2.28E-06,0,0,1
slinked,1,1.84E-06,1,2.28E-06,0,0,1
designs,1,1.84E-06,1,2.28E-06,0,0,2
heroine,1,1.84E-06,1,2.28E-06,0,0,2
kristen,1,1.84E-06,1,2.28E-06,0,0,2
parlors,1,1.84E-06,1,2.28E-06,0,0,2
ecuador,1,1.84E-06,1,2.28E-06,0,0,3
capping,1,1.84E-06,1,2.28E-06,0,0,2
neutron,1,1.84E-06,1,2.28E-06,0,0,2
pendley,1,1.84E-06,1,2.28E-06,0,0,2
partake,1,1.84E-06,1,2.28E-06,0,0,2
rectify,1,1.84E-06,1,2.28E-06,0,0,3
nastier,1,1.84E-06,1,2.28E-06,0,0,2
sarcasm,1,1.84E-06,1,2.28E-06,0,0,2
scaring,1,1.84E-06,1,2.28E-06,0,0,2
insulin,1,1.84E-06,1,2.28E-06,0,0,3
philbin,1,1.84E-06,1,2.28E-06,0,0,2
kathryn,1,1.84E-06,1,2.28E-06,0,0,2
burgums,1,1.84E-06,1,2.28E-06,0,0,2
priests,1,1.84E-06,1,2.28E-06,0,0,1
buffalo,1,1.84E-06,1,2.28E-06,0,0,3
touting,1,1.84E-06,1,2.28E-06,0,0,2
vincent,1,1.84E-06,1,2.28E-06,0,0,2
clyburn,1,1.84E-06,1,2.28E-06,0,0,2
cheater,1,1.84E-06,1,2.28E-06,0,0,2
taxiway,1,1.84E-06,1,2.28E-06,0,0,3
rachael,1,1.84E-06,1,2.28E-06,0,0,2
boating,1,1.84E-06,1,2.28E-06,0,0,2
gustavo,1,1.84E-06,1,2.28E-06,0,0,3
frorida,1,1.84E-06,1,2.28E-06,0,0,3
violationall,1,1.84E-06,1,2.28E-06,0,0,4
cleaned,1,1.84E-06,1,2.28E-06,0,0,1
wonders,1,1.84E-06,1,2.28E-06,0,0,2
subside,1,1.84E-06,1,2.28E-06,0,0,2
lecture,1,1.84E-06,1,2.28E-06,0,0,2
agothis,1,1.84E-06,1,2.28E-06,0,0,3
bending,1,1.84E-06,1,2.28E-06,0,0,2
trumans,1,1.84E-06,1,2.28E-06,0,0,2
refusal,1,1.84E-06,1,2.28E-06,0,0,3
verdict,1,1.84E-06,1,2.28E-06,0,0,2
princes,1,1.84E-06,1,2.28E-06,0,0,1
riviera,1,1.84E-06,1,2.28E-06,0,0,3
raiders,1,1.84E-06,1,2.28E-06,0,0,2
wouldve,1,1.84E-06,1,2.28E-06,0,0,1
milking,1,1.84E-06,1,2.28E-06,0,0,2
arrival,1,1.84E-06,1,2.28E-06,0,0,3
coltony,1,1.84E-06,1,2.28E-06,0,0,3
shaffer,1,1.84E-06,1,2.28E-06,0,0,2
mustafa,1,1.84E-06,1,2.28E-06,0,0,3
catcher,1,1.84E-06,1,2.28E-06,0,0,2
sinking,1,1.84E-06,1,2.28E-06,0,0,2
receipt,1,1.84E-06,1,2.28E-06,0,0,2
wilsond,1,1.84E-06,1,2.28E-06,0,0,2
plunged,1,1.84E-06,1,2.28E-06,0,0,1
subsidy,1,1.84E-06,1,2.28E-06,0,0,3
racking,1,1.84E-06,1,2.28E-06,0,0,2
makings,1,1.84E-06,1,2.28E-06,0,0,2
holiest,1,1.84E-06,1,2.28E-06,0,0,2
isolate,1,1.84E-06,1,2.28E-06,0,0,3
blathering,1,1.84E-06,1,2.28E-06,0,0,3
reportthis,1,1.84E-06,1,2.28E-06,0,0,3
untruth,1,1.84E-06,1,2.28E-06,0,0,2
exorbitant,1,1.84E-06,1,2.28E-06,0,0,4
heeling,1,1.84E-06,1,2.28E-06,0,0,2
artificially,1,1.84E-06,1,2.28E-06,0,0,5
cancellation,1,1.84E-06,1,2.28E-06,0,0,4
colmery,1,1.84E-06,1,2.28E-06,0,0,3
frazier,1,1.84E-06,1,2.28E-06,0,0,2
busting,1,1.84E-06,1,2.28E-06,0,0,2
implode,1,1.84E-06,1,2.28E-06,0,0,2
corning,1,1.84E-06,1,2.28E-06,0,0,2
guarded,1,1.84E-06,1,2.28E-06,0,0,1
handels,1,1.84E-06,1,2.28E-06,0,0,2
devised,1,1.84E-06,1,2.28E-06,0,0,2
rexnord,1,1.84E-06,1,2.28E-06,0,0,2
mahmoud,1,1.84E-06,1,2.28E-06,0,0,2
falcons,1,1.84E-06,1,2.28E-06,0,0,2
juliana,1,1.84E-06,1,2.28E-06,0,0,3
museums,1,1.84E-06,1,2.28E-06,0,0,2
knowles,1,1.84E-06,1,2.28E-06,0,0,2
runways,1,1.84E-06,1,2.28E-06,0,0,2
mailbox,1,1.84E-06,1,2.28E-06,0,0,2
nowwere,1,1.84E-06,1,2.28E-06,0,0,2
meaningfully,1,1.84E-06,1,2.28E-06,0,0,4
fbijust,1,1.84E-06,1,2.28E-06,0,0,2
shulkin,1,1.84E-06,1,2.28E-06,0,0,2
lawfare,1,1.84E-06,1,2.28E-06,0,0,2
crafted,1,1.84E-06,1,2.28E-06,0,0,1
dcthank,1,1.84E-06,1,2.28E-06,0,0,1
murdoch,1,1.84E-06,1,2.28E-06,0,0,2
interfe,1,1.84E-06,1,2.28E-06,0,0,2
minorities,1,1.84E-06,1,2.28E-06,0,0,4
swamped,1,1.84E-06,1,2.28E-06,0,0,1
unequivocally,1,1.84E-06,1,2.28E-06,0,0,6
naively,1,1.84E-06,1,2.28E-06,0,0,3
manhunt,1,1.84E-06,1,2.28E-06,0,0,2
supteme,1,1.84E-06,1,2.28E-06,0,0,2
tsunami,1,1.84E-06,1,2.28E-06,0,0,3
relitigate,1,1.84E-06,1,2.28E-06,0,0,4
useable,1,1.84E-06,1,2.28E-06,0,0,3
kristol,1,1.84E-06,1,2.28E-06,0,0,2
philladelphia,1,1.84E-06,1,2.28E-06,0,0,4
whizzed,1,1.84E-06,1,2.28E-06,0,0,1
dunford,1,1.84E-06,1,2.28E-06,0,0,2
bracing,1,1.84E-06,1,2.28E-06,0,0,2
violate,1,1.84E-06,1,2.28E-06,0,0,2
pushers,1,1.84E-06,1,2.28E-06,0,0,2
installations,1,1.84E-06,1,2.28E-06,0,0,4
epstein,1,1.84E-06,1,2.28E-06,0,0,2
securityno,1,1.84E-06,1,2.28E-06,0,0,5
tijuana,1,1.84E-06,1,2.28E-06,0,0,3
backlog,1,1.84E-06,1,2.28E-06,0,0,2
resting,1,1.84E-06,1,2.28E-06,0,0,2
woolsey,1,1.84E-06,1,2.28E-06,0,0,2
falsify,1,1.84E-06,1,2.28E-06,0,0,3
krysten,1,1.84E-06,1,2.28E-06,0,0,2
harmony,1,1.84E-06,1,2.28E-06,0,0,3
dodgers,1,1.84E-06,1,2.28E-06,0,0,2
stifled,1,1.84E-06,1,2.28E-06,0,0,1
chanded,1,1.84E-06,1,2.28E-06,0,0,1
paulsen,1,1.84E-06,1,2.28E-06,0,0,2
dakotas,1,1.84E-06,1,2.28E-06,0,0,3
horrors,1,1.84E-06,1,2.28E-06,0,0,2
desires,1,1.84E-06,1,2.28E-06,0,0,2
wherein,1,1.84E-06,1,2.28E-06,0,0,2
danials,1,1.84E-06,1,2.28E-06,0,0,2
arabian,1,1.84E-06,1,2.28E-06,0,0,3
shapiro,1,1.84E-06,1,2.28E-06,0,0,3
eugenie,1,1.84E-06,1,2.28E-06,0,0,3
ulysses,1,1.84E-06,1,2.28E-06,0,0,2
kristin,1,1.84E-06,1,2.28E-06,0,0,2
reseach,1,1.84E-06,1,2.28E-06,0,0,2
expanse,1,1.84E-06,1,2.28E-06,0,0,2
tristan,1,1.84E-06,1,2.28E-06,0,0,2
minster,1,1.84E-06,1,2.28E-06,0,0,2
ferrara,1,1.84E-06,1,2.28E-06,0,0,3
dipping,1,1.84E-06,1,2.28E-06,0,0,2
honorwe,1,1.84E-06,1,2.28E-06,0,0,2
couched,1,1.84E-06,1,2.28E-06,0,0,1
bankers,1,1.84E-06,1,2.28E-06,0,0,2
relates,1,1.84E-06,1,2.28E-06,0,0,2
katelyn,1,1.84E-06,1,2.28E-06,0,0,3
intentionally,1,1.84E-06,1,2.28E-06,0,0,5
choking,1,1.84E-06,1,2.28E-06,0,0,2
cosumer,1,1.84E-06,1,2.28E-06,0,0,3
bolster,1,1.84E-06,1,2.28E-06,0,0,2
inflict,1,1.84E-06,1,2.28E-06,0,0,2
jurists,1,1.84E-06,1,2.28E-06,0,0,2
foreman,1,1.84E-06,1,2.28E-06,0,0,3
blinded,1,1.84E-06,1,2.28E-06,0,0,1
filters,1,1.84E-06,1,2.28E-06,0,0,2
fudging,1,1.84E-06,1,2.28E-06,0,0,2
exponentially,1,1.84E-06,1,2.28E-06,0,0,5
uschina,1,1.84E-06,1,2.28E-06,0,0,3
complexity,1,1.84E-06,1,2.28E-06,0,0,4
gravely,1,1.84E-06,1,2.28E-06,0,0,3
strategically,1,1.84E-06,1,2.28E-06,0,0,5
unglued,1,1.84E-06,1,2.28E-06,0,0,2
firings,1,1.84E-06,1,2.28E-06,0,0,2
weeding,1,1.84E-06,1,2.28E-06,0,0,2
blunder,1,1.84E-06,1,2.28E-06,0,0,2
hightax,1,1.84E-06,1,2.28E-06,0,0,2
purport,1,1.84E-06,1,2.28E-06,0,0,2
shopped,1,1.84E-06,1,2.28E-06,0,0,1
koreans,1,1.84E-06,1,2.28E-06,0,0,2
stauber,1,1.84E-06,1,2.28E-06,0,0,2
tamping,1,1.84E-06,1,2.28E-06,0,0,2
kasichs,1,1.84E-06,1,2.28E-06,0,0,2
ratchet,1,1.84E-06,1,2.28E-06,0,0,2
cometax,1,1.84E-06,1,2.28E-06,0,0,3
stivers,1,1.84E-06,1,2.28E-06,0,0,2
alfonse,1,1.84E-06,1,2.28E-06,0,0,2
darling,1,1.84E-06,1,2.28E-06,0,0,2
plastic,1,1.84E-06,1,2.28E-06,0,0,2
morphed,1,1.84E-06,1,2.28E-06,0,0,1
recheck,1,1.84E-06,1,2.28E-06,0,0,2
simplicity,1,1.84E-06,1,2.28E-06,0,0,4
tribune,1,1.84E-06,1,2.28E-06,0,0,2
pretext,1,1.84E-06,1,2.28E-06,0,0,2
pagewas,1,1.84E-06,1,2.28E-06,0,0,3
slapped,1,1.84E-06,1,2.28E-06,0,0,1
dodging,1,1.84E-06,1,2.28E-06,0,0,2
posture,1,1.84E-06,1,2.28E-06,0,0,2
julyour,1,1.84E-06,1,2.28E-06,0,0,3
scheels,1,1.84E-06,1,2.28E-06,0,0,1
crowley,1,1.84E-06,1,2.28E-06,0,0,2
drunken,1,1.84E-06,1,2.28E-06,0,0,2
mukasey,1,1.84E-06,1,2.28E-06,0,0,3
commanded,1,1.84E-06,1,2.28E-06,0,0,2
disillusioned,1,1.84E-06,1,2.28E-06,0,0,4
ignores,1,1.84E-06,1,2.28E-06,0,0,2
fairest,1,1.84E-06,1,2.28E-06,0,0,2
letizia,1,1.84E-06,1,2.28E-06,0,0,3
tenuous,1,1.84E-06,1,2.28E-06,0,0,3
juncker,1,1.84E-06,1,2.28E-06,0,0,2
ushered,1,1.84E-06,1,2.28E-06,0,0,2
justins,1,1.84E-06,1,2.28E-06,0,0,2
somolia,1,1.84E-06,1,2.28E-06,0,0,3
merrily,1,1.84E-06,1,2.28E-06,0,0,3
metcalf,1,1.84E-06,1,2.28E-06,0,0,2
worldhe,1,1.84E-06,1,2.28E-06,0,0,1
reptrey,1,1.84E-06,1,2.28E-06,0,0,2
wiretap,1,1.84E-06,1,2.28E-06,0,0,3
progressits,1,1.84E-06,0,0,9.47E-06,1,3
genesis,1,1.84E-06,1,2.28E-06,0,0,3
folding,1,1.84E-06,1,2.28E-06,0,0,2
sponsor,1,1.84E-06,1,2.28E-06,0,0,2
probers,1,1.84E-06,1,2.28E-06,0,0,2
stateno,1,1.84E-06,1,2.28E-06,0,0,3
spoiled,1,1.84E-06,1,2.28E-06,0,0,1
ainsley,1,1.84E-06,1,2.28E-06,0,0,2
unequal,1,1.84E-06,1,2.28E-06,0,0,3
stamina,1,1.84E-06,1,2.28E-06,0,0,3
bernadette,1,1.84E-06,1,2.28E-06,0,0,3
testers,1,1.84E-06,1,2.28E-06,0,0,2
foxnews,1,1.84E-06,1,2.28E-06,0,0,2
matalin,1,1.84E-06,1,2.28E-06,0,0,3
recollections,1,1.84E-06,1,2.28E-06,0,0,4
peepers,1,1.84E-06,1,2.28E-06,0,0,2
crimson,1,1.84E-06,1,2.28E-06,0,0,2
tarrifs,1,1.84E-06,1,2.28E-06,0,0,2
sealing,1,1.84E-06,1,2.28E-06,0,0,2
nutritional,1,1.84E-06,0,0,9.47E-06,1,4
estonia,1,1.84E-06,1,2.28E-06,0,0,3
robbery,1,1.84E-06,1,2.28E-06,0,0,3
refined,1,1.84E-06,1,2.28E-06,0,0,2
conceal,1,1.84E-06,1,2.28E-06,0,0,2
saucier,1,1.84E-06,1,2.28E-06,0,0,2
xinping,1,1.84E-06,1,2.28E-06,0,0,2
emerged,1,1.84E-06,1,2.28E-06,0,0,2
sixteen,1,1.84E-06,1,2.28E-06,0,0,2
christi,1,1.84E-06,1,2.28E-06,0,0,2
redrawn,1,1.84E-06,1,2.28E-06,0,0,2
somehow,1,1.84E-06,1,2.28E-06,0,0,3
swaying,1,1.84E-06,1,2.28E-06,0,0,2
goalrob,1,1.84E-06,1,2.28E-06,0,0,2
goldman,1,1.84E-06,1,2.28E-06,0,0,2
sustain,1,1.84E-06,1,2.28E-06,0,0,2
erratic,1,1.84E-06,1,2.28E-06,0,0,3
kruczek,1,1.84E-06,1,2.28E-06,0,0,2
invoked,1,1.84E-06,1,2.28E-06,0,0,2
cancels,1,1.84E-06,1,2.28E-06,0,0,2
nearing,1,1.84E-06,1,2.28E-06,0,0,2
preston,1,1.84E-06,1,2.28E-06,0,0,2
samsung,1,1.84E-06,1,2.28E-06,0,0,2
grading,1,1.84E-06,1,2.28E-06,0,0,2
evolved,1,1.84E-06,1,2.28E-06,0,0,2
risking,1,1.84E-06,1,2.28E-06,0,0,2
smashed,1,1.84E-06,1,2.28E-06,0,0,1
solberg,1,1.84E-06,1,2.28E-06,0,0,2
inocent,1,1.84E-06,1,2.28E-06,0,0,3
dictate,1,1.84E-06,1,2.28E-06,0,0,2
striped,1,1.84E-06,1,2.28E-06,0,0,1
vandyke,1,1.84E-06,1,2.28E-06,0,0,2
nonstop,1,1.84E-06,1,2.28E-06,0,0,2
pramila,1,1.84E-06,1,2.28E-06,0,0,3
jayapal,1,1.84E-06,1,2.28E-06,0,0,3
panders,1,1.84E-06,1,2.28E-06,0,0,2
angered,1,1.84E-06,1,2.28E-06,0,0,2
maureen,1,1.84E-06,1,2.28E-06,0,0,2
mcgahns,1,1.84E-06,1,2.28E-06,0,0,1
citizensyou,1,1.84E-06,0,0,9.47E-06,1,5
specify,1,1.84E-06,1,2.28E-06,0,0,3
filmmakers,1,1.84E-06,0,0,9.47E-06,1,3
escaped,1,1.84E-06,1,2.28E-06,0,0,2
suppose,1,1.84E-06,1,2.28E-06,0,0,2
whistle,1,1.84E-06,1,2.28E-06,0,0,2
english,1,1.84E-06,1,2.28E-06,0,0,2
weasels,1,1.84E-06,1,2.28E-06,0,0,2
bravado,1,1.84E-06,1,2.28E-06,0,0,3
refered,1,1.84E-06,1,2.28E-06,0,0,2
mazloum,1,1.84E-06,1,2.28E-06,0,0,2
accepts,1,1.84E-06,1,2.28E-06,0,0,2
zuckers,1,1.84E-06,1,2.28E-06,0,0,2
turkeys,1,1.84E-06,1,2.28E-06,0,0,2
hapgood,1,1.84E-06,1,2.28E-06,0,0,2
mansion,1,1.84E-06,1,2.28E-06,0,0,2
beetles,1,1.84E-06,1,2.28E-06,0,0,2
premise,1,1.84E-06,1,2.28E-06,0,0,2
leaning,1,1.84E-06,1,2.28E-06,0,0,2
incomrs,1,1.84E-06,1,2.28E-06,0,0,2
hostess,1,1.84E-06,1,2.28E-06,0,0,2
empires,1,1.84E-06,1,2.28E-06,0,0,2
enraged,1,1.84E-06,1,2.28E-06,0,0,2
medicar,1,1.84E-06,1,2.28E-06,0,0,3
rispone,1,1.84E-06,1,2.28E-06,0,0,2
venture,1,1.84E-06,1,2.28E-06,0,0,2
implies,1,1.84E-06,1,2.28E-06,0,0,2
savages,1,1.84E-06,1,2.28E-06,0,0,2
bizarre,1,1.84E-06,1,2.28E-06,0,0,2
schemes,1,1.84E-06,1,2.28E-06,0,0,1
planetthats,1,1.84E-06,0,0,9.47E-06,1,3
storied,1,1.84E-06,1,2.28E-06,0,0,2
economicsit,1,1.84E-06,0,0,9.47E-06,1,5
showbiz,1,1.84E-06,1,2.28E-06,0,0,2
resorts,1,1.84E-06,1,2.28E-06,0,0,2
tweeted,1,1.84E-06,1,2.28E-06,0,0,1
flaming,1,1.84E-06,1,2.28E-06,0,0,2
swapped,1,1.84E-06,1,2.28E-06,0,0,1
fixated,1,1.84E-06,1,2.28E-06,0,0,2
messing,1,1.84E-06,1,2.28E-06,0,0,2
terrify,1,1.84E-06,1,2.28E-06,0,0,3
sadique,1,1.84E-06,1,2.28E-06,0,0,3
leisure,1,1.84E-06,1,2.28E-06,0,0,2
retrain,1,1.84E-06,1,2.28E-06,0,0,2
upfront,1,1.84E-06,1,2.28E-06,0,0,2
thanked,1,1.84E-06,1,2.28E-06,0,0,1
scolded,1,1.84E-06,1,2.28E-06,0,0,1
forgave,1,1.84E-06,1,2.28E-06,0,0,2
fantastically,1,1.84E-06,1,2.28E-06,0,0,5
smartly,1,1.84E-06,1,2.28E-06,0,0,2
kneecap,1,1.84E-06,1,2.28E-06,0,0,2
electronically,1,1.84E-06,1,2.28E-06,0,0,6
warrens,1,1.84E-06,1,2.28E-06,0,0,2
emanuel,1,1.84E-06,1,2.28E-06,0,0,3
fifties,1,1.84E-06,1,2.28E-06,0,0,2
marquis,1,1.84E-06,1,2.28E-06,0,0,2
moulton,1,1.84E-06,1,2.28E-06,0,0,2
entries,1,1.84E-06,1,2.28E-06,0,0,2
kashmir,1,1.84E-06,1,2.28E-06,0,0,2
jokebut,1,1.84E-06,1,2.28E-06,0,0,3
nazisin,1,1.84E-06,1,2.28E-06,0,0,3
beatles,1,1.84E-06,1,2.28E-06,0,0,2
rashida,1,1.84E-06,1,2.28E-06,0,0,3
reaping,1,1.84E-06,1,2.28E-06,0,0,2
cursing,1,1.84E-06,1,2.28E-06,0,0,2
proportionally,1,1.84E-06,1,2.28E-06,0,0,5
deutsch,1,1.84E-06,1,2.28E-06,0,0,1
ussouth,1,1.84E-06,1,2.28E-06,0,0,2
racists,1,1.84E-06,1,2.28E-06,0,0,2
revises,1,1.84E-06,1,2.28E-06,0,0,2
depress,1,1.84E-06,1,2.28E-06,0,0,2
sherrod,1,1.84E-06,1,2.28E-06,0,0,2
samurai,1,1.84E-06,1,2.28E-06,0,0,3
merkels,1,1.84E-06,1,2.28E-06,0,0,2
systematically,1,1.84E-06,1,2.28E-06,0,0,6
neutral,1,1.84E-06,1,2.28E-06,0,0,2
strongl,1,1.84E-06,1,2.28E-06,0,0,1
preside,1,1.84E-06,1,2.28E-06,0,0,2
assumed,1,1.84E-06,1,2.28E-06,0,0,2
arresed,1,1.84E-06,1,2.28E-06,0,0,2
pickens,1,1.84E-06,1,2.28E-06,0,0,2
equated,1,1.84E-06,1,2.28E-06,0,0,2
elijahs,1,1.84E-06,1,2.28E-06,0,0,3
summarizes,1,1.84E-06,0,0,9.47E-06,1,3
macrons,1,1.84E-06,1,2.28E-06,0,0,2
mendoza,1,1.84E-06,1,2.28E-06,0,0,3
apprise,1,1.84E-06,1,2.28E-06,0,0,2
exerted,1,1.84E-06,1,2.28E-06,0,0,2
shampoo,1,1.84E-06,1,2.28E-06,0,0,2
hagerty,1,1.84E-06,1,2.28E-06,0,0,3
seizure,1,1.84E-06,1,2.28E-06,0,0,2
censors,1,1.84E-06,1,2.28E-06,0,0,2
respondwith,1,1.84E-06,0,0,9.47E-06,1,3
explore,1,1.84E-06,1,2.28E-06,0,0,2
germans,1,1.84E-06,1,2.28E-06,0,0,2
hovered,1,1.84E-06,1,2.28E-06,0,0,2
induced,1,1.84E-06,1,2.28E-06,0,0,2
flagged,1,1.84E-06,1,2.28E-06,0,0,1
foisted,1,1.84E-06,1,2.28E-06,0,0,1
kameron,1,1.84E-06,1,2.28E-06,0,0,3
swimmingly,1,1.84E-06,1,2.28E-06,0,0,3
phantom,1,1.84E-06,1,2.28E-06,0,0,2
grisham,1,1.84E-06,1,2.28E-06,0,0,2
russias,1,1.84E-06,1,2.28E-06,0,0,2
hrasbig,1,1.84E-06,1,2.28E-06,0,0,2
whatley,1,1.84E-06,1,2.28E-06,0,0,2
bashing,1,1.84E-06,1,2.28E-06,0,0,2
intellectually,1,1.84E-06,1,2.28E-06,0,0,5
inequalitya,1,1.84E-06,0,0,9.47E-06,1,5
hailing,1,1.84E-06,1,2.28E-06,0,0,2
shoebiz,1,1.84E-06,1,2.28E-06,0,0,2
nechama,1,1.84E-06,1,2.28E-06,0,0,3
stature,1,1.84E-06,1,2.28E-06,0,0,2
excitedjohn,1,1.84E-06,0,0,9.47E-06,1,4
wishers,1,1.84E-06,1,2.28E-06,0,0,2
rightthanks,1,1.84E-06,0,0,9.47E-06,1,2
desired,1,1.84E-06,1,2.28E-06,0,0,2
meander,1,1.84E-06,1,2.28E-06,0,0,2
empress,1,1.84E-06,1,2.28E-06,0,0,2
copious,1,1.84E-06,1,2.28E-06,0,0,3
shahira,1,1.84E-06,1,2.28E-06,0,0,3
coastal,1,1.84E-06,1,2.28E-06,0,0,2
sourced,1,1.84E-06,1,2.28E-06,0,0,1
hombres,1,1.84E-06,1,2.28E-06,0,0,1
telease,1,1.84E-06,1,2.28E-06,0,0,2
adopted,1,1.84E-06,1,2.28E-06,0,0,2
amputee,1,1.84E-06,1,2.28E-06,0,0,3
yielded,1,1.84E-06,1,2.28E-06,0,0,1
reneged,1,1.84E-06,1,2.28E-06,0,0,2
percentthis,1,1.84E-06,1,2.28E-06,0,0,3
grieves,1,1.84E-06,1,2.28E-06,0,0,1
albence,1,1.84E-06,1,2.28E-06,0,0,2
switchboard,1,1.84E-06,0,0,9.47E-06,1,2
untaxed,1,1.84E-06,1,2.28E-06,0,0,2
kentuky,1,1.84E-06,1,2.28E-06,0,0,3
applies,1,1.84E-06,1,2.28E-06,0,0,2
firepac,1,1.84E-06,1,2.28E-06,0,0,3
embargo,1,1.84E-06,1,2.28E-06,0,0,3
litigations,1,1.84E-06,1,2.28E-06,0,0,4
cartoon,1,1.84E-06,1,2.28E-06,0,0,2
yisroel,1,1.84E-06,1,2.28E-06,0,0,2
potomac,1,1.84E-06,1,2.28E-06,0,0,3
adverse,1,1.84E-06,1,2.28E-06,0,0,2
closest,1,1.84E-06,1,2.28E-06,0,0,2
nastily,1,1.84E-06,1,2.28E-06,0,0,3
rebrand,1,1.84E-06,1,2.28E-06,0,0,2
telecom,1,1.84E-06,1,2.28E-06,0,0,3
securiy,1,1.84E-06,1,2.28E-06,0,0,3
gregory,1,1.84E-06,1,2.28E-06,0,0,3
reeling,1,1.84E-06,1,2.28E-06,0,0,2
mcmahon,1,1.84E-06,1,2.28E-06,0,0,2
perdues,1,1.84E-06,1,2.28E-06,0,0,2
screwup,1,1.84E-06,1,2.28E-06,0,0,2
communique,1,1.84E-06,1,2.28E-06,0,0,4
limitations,1,1.84E-06,1,2.28E-06,0,0,4
jacinda,1,1.84E-06,1,2.28E-06,0,0,3
strzoks,1,1.84E-06,1,2.28E-06,0,0,1
mosques,1,1.84E-06,1,2.28E-06,0,0,2
vetoing,1,1.84E-06,1,2.28E-06,0,0,2
frantic,1,1.84E-06,1,2.28E-06,0,0,2
dioxide,1,1.84E-06,1,2.28E-06,0,0,2
copying,1,1.84E-06,1,2.28E-06,0,0,2
extinct,1,1.84E-06,1,2.28E-06,0,0,2
traunch,1,1.84E-06,1,2.28E-06,0,0,1
newborn,1,1.84E-06,1,2.28E-06,0,0,2
cutsetc,1,1.84E-06,1,2.28E-06,0,0,2
lagging,1,1.84E-06,1,2.28E-06,0,0,2
muthana,1,1.84E-06,1,2.28E-06,0,0,3
factors,1,1.84E-06,1,2.28E-06,0,0,2
strived,1,1.84E-06,1,2.28E-06,0,0,1
iceberg,1,1.84E-06,1,2.28E-06,0,0,3
wieners,1,1.84E-06,1,2.28E-06,0,0,2
mariano,1,1.84E-06,1,2.28E-06,0,0,3
smeared,1,1.84E-06,1,2.28E-06,0,0,1
botched,1,1.84E-06,1,2.28E-06,0,0,1
feature,1,1.84E-06,1,2.28E-06,0,0,2
holders,1,1.84E-06,1,2.28E-06,0,0,2
internationally,1,1.84E-06,1,2.28E-06,0,0,6
glyptis,1,1.84E-06,1,2.28E-06,0,0,2
prudent,1,1.84E-06,1,2.28E-06,0,0,2
houlton,1,1.84E-06,1,2.28E-06,0,0,2
payback,1,1.84E-06,1,2.28E-06,0,0,2
counterfeit,1,1.84E-06,1,2.28E-06,0,0,3
noncitizens,1,1.84E-06,1,2.28E-06,0,0,4
disrespectfully,1,1.84E-06,1,2.28E-06,0,0,5
unmitigated,1,1.84E-06,1,2.28E-06,0,0,4
institution,1,1.84E-06,1,2.28E-06,0,0,4
attributing,1,1.84E-06,1,2.28E-06,0,0,4
prohibiting,1,1.84E-06,1,2.28E-06,0,0,4
whitmeropen,1,1.84E-06,1,2.28E-06,0,0,4
recruitment,1,1.84E-06,1,2.28E-06,0,0,3
antiquities,1,1.84E-06,1,2.28E-06,0,0,4
documentsit,1,1.84E-06,1,2.28E-06,0,0,4
objectivity,1,1.84E-06,1,2.28E-06,0,0,5
celebrities,1,1.84E-06,1,2.28E-06,0,0,4
arbitration,1,1.84E-06,1,2.28E-06,0,0,4
braithwaite,1,1.84E-06,1,2.28E-06,0,0,2
hostilities,1,1.84E-06,1,2.28E-06,0,0,4
scattershot,1,1.84E-06,1,2.28E-06,0,0,3
hospitality,1,1.84E-06,1,2.28E-06,0,0,5
acquisition,1,1.84E-06,1,2.28E-06,0,0,4
insensitive,1,1.84E-06,1,2.28E-06,0,0,4
maithripala,1,1.84E-06,1,2.28E-06,0,0,4
militarized,1,1.84E-06,1,2.28E-06,0,0,4
territorial,1,1.84E-06,1,2.28E-06,0,0,4
commiecast,1,1.84E-06,1,2.28E-06,0,0,3
oppressionit,1,1.84E-06,0,0,9.47E-06,1,4
communicat,1,1.84E-06,1,2.28E-06,0,0,4
commentary,1,1.84E-06,1,2.28E-06,0,0,4
politicsthis,1,1.84E-06,0,0,9.47E-06,1,4
insuranceits,1,1.84E-06,0,0,9.47E-06,1,4
cuttingstock,1,1.84E-06,1,2.28E-06,0,0,3
productivity,1,1.84E-06,0,0,9.47E-06,1,5
geopolitical,1,1.84E-06,0,0,9.47E-06,1,5
necessitynot,1,1.84E-06,0,0,9.47E-06,1,5
undercutting,1,1.84E-06,1,2.28E-06,0,0,4
availability,1,1.84E-06,0,0,9.47E-06,1,6
politicianif,1,1.84E-06,1,2.28E-06,0,0,5
electability,1,1.84E-06,1,2.28E-06,0,0,6
commonsense,1,1.84E-06,0,0,9.47E-06,1,3
hospitalvery,1,1.84E-06,1,2.28E-06,0,0,5
counterattack,1,1.84E-06,1,2.28E-06,0,0,4
azithromycin,1,1.84E-06,1,2.28E-06,0,0,5
summarizing,1,1.84E-06,0,0,9.47E-06,1,4
reconstitute,1,1.84E-06,1,2.28E-06,0,0,4
commentator,1,1.84E-06,1,2.28E-06,0,0,4
prioritizing,1,1.84E-06,1,2.28E-06,0,0,4
politicizing,1,1.84E-06,1,2.28E-06,0,0,5
securityisis,1,1.84E-06,1,2.28E-06,0,0,5
capabilities,1,1.84E-06,1,2.28E-06,0,0,5
cutssecurity,1,1.84E-06,1,2.28E-06,0,0,5
prohibitions,1,1.84E-06,1,2.28E-06,0,0,4
smithsonians,1,1.84E-06,1,2.28E-06,0,0,3
battlegrounds,1,1.84E-06,1,2.28E-06,0,0,3
hypocritical,1,1.84E-06,1,2.28E-06,0,0,5
facilitation,1,1.84E-06,1,2.28E-06,0,0,5
whitewashing,1,1.84E-06,1,2.28E-06,0,0,4
acquisitions,1,1.84E-06,1,2.28E-06,0,0,4
unpopularity,1,1.84E-06,1,2.28E-06,0,0,6
malnutrition,1,1.84E-06,1,2.28E-06,0,0,4
definitively,1,1.84E-06,1,2.28E-06,0,0,6
counterfeits,1,1.84E-06,1,2.28E-06,0,0,3
communicate,1,1.84E-06,1,2.28E-06,0,0,4
facilitating,1,1.84E-06,1,2.28E-06,0,0,5
overcapacity,1,1.84E-06,1,2.28E-06,0,0,6
legitimately,1,1.84E-06,1,2.28E-06,0,0,6
prohibitively,1,1.84E-06,0,0,9.47E-06,1,6
transitioning,1,1.84E-06,1,2.28E-06,0,0,4
profitability,1,1.84E-06,1,2.28E-06,0,0,6
reconstituted,1,1.84E-06,1,2.28E-06,0,0,4
resuscitation,1,1.84E-06,1,2.28E-06,0,0,5
dependability,1,1.84E-06,1,2.28E-06,0,0,6
homosexuality,1,1.84E-06,1,2.28E-06,0,0,6
programming,1,1.84E-06,1,2.28E-06,0,0,3
politicization,1,1.84E-06,1,2.28E-06,0,0,6
rehabilitation,1,1.84E-06,1,2.28E-06,0,0,6
vulnerabilities,1,1.84E-06,1,2.28E-06,0,0,6
hospitalizations,1,1.84E-06,1,2.28E-06,0,0,6
yoursbig,1,1.84E-06,0,0,9.47E-06,1,2
glaciers,1,1.84E-06,0,0,9.47E-06,1,2
bearssee,1,1.84E-06,0,0,9.47E-06,1,2
handchip,1,1.84E-06,0,0,9.47E-06,1,2
octobera,1,1.84E-06,0,0,9.47E-06,1,4
planshow,1,1.84E-06,0,0,9.47E-06,1,2
yearthat,1,1.84E-06,0,0,9.47E-06,1,2
mckinley,1,1.84E-06,0,0,9.47E-06,1,2
applause,1,1.84E-06,0,0,9.47E-06,1,2
embraced,1,1.84E-06,0,0,9.47E-06,1,2
achieves,1,1.84E-06,0,0,9.47E-06,1,2
yearwish,1,1.84E-06,0,0,9.47E-06,1,2
clementa,1,1.84E-06,0,0,9.47E-06,1,3
pinckney,1,1.84E-06,0,0,9.47E-06,1,2
nonetheless,1,1.84E-06,1,2.28E-06,0,0,4
fourteen,1,1.84E-06,0,0,9.47E-06,1,2
cuteness,1,1.84E-06,0,0,9.47E-06,1,3
stewards,1,1.84E-06,0,0,9.47E-06,1,2
deniedor,1,1.84E-06,0,0,9.47E-06,1,3
catalyst,1,1.84E-06,0,0,9.47E-06,1,3
classnot,1,1.84E-06,0,0,9.47E-06,1,2
valuable,1,1.84E-06,0,0,9.47E-06,1,3
boehners,1,1.84E-06,0,0,9.47E-06,1,2
worrying,1,1.84E-06,0,0,9.47E-06,1,2
endanger,1,1.84E-06,0,0,9.47E-06,1,3
happiest,1,1.84E-06,0,0,9.47E-06,1,2
scariest,1,1.84E-06,0,0,9.47E-06,1,2
kailashs,1,1.84E-06,0,0,9.47E-06,1,2
voiceuse,1,1.84E-06,0,0,9.47E-06,1,2
thirteen,1,1.84E-06,0,0,9.47E-06,1,2
yearsbut,1,1.84E-06,0,0,9.47E-06,1,2
nationas,1,1.84E-06,0,0,9.47E-06,1,3
bossmade,1,1.84E-06,0,0,9.47E-06,1,2
knowthat,1,1.84E-06,0,0,9.47E-06,1,2
albright,1,1.84E-06,0,0,9.47E-06,1,2
dayevery,1,1.84E-06,0,0,9.47E-06,1,4
nightyou,1,1.84E-06,0,0,9.47E-06,1,3
spoilers,1,1.84E-06,0,0,9.47E-06,1,2
seahawks,1,1.84E-06,0,0,9.47E-06,1,2
remsburg,1,1.84E-06,0,0,9.47E-06,1,2
leukemia,1,1.84E-06,0,0,9.47E-06,1,3
seasonal,1,1.84E-06,0,0,9.47E-06,1,3
checkups,1,1.84E-06,0,0,9.47E-06,1,2
carethat,1,1.84E-06,0,0,9.47E-06,1,3
hardship,1,1.84E-06,0,0,9.47E-06,1,2
stresses,1,1.84E-06,0,0,9.47E-06,1,1
fromwhen,1,1.84E-06,0,0,9.47E-06,1,2
prophecy,1,1.84E-06,0,0,9.47E-06,1,3
suffrage,1,1.84E-06,0,0,9.47E-06,1,2
syracuse,1,1.84E-06,0,0,9.47E-06,1,3
dragging,1,1.84E-06,0,0,9.47E-06,1,2
dynamism,1,1.84E-06,0,0,9.47E-06,1,3
likeheat,1,1.84E-06,0,0,9.47E-06,1,3
unafraid,1,1.84E-06,0,0,9.47E-06,1,3
kindness,1,1.84E-06,0,0,9.47E-06,1,2
peopleto,1,1.84E-06,0,0,9.47E-06,1,3
licensed,1,1.84E-06,0,0,9.47E-06,1,2
ohiomore,1,1.84E-06,0,0,9.47E-06,1,3
reachfor,1,1.84E-06,0,0,9.47E-06,1,2
acquired,1,1.84E-06,0,0,9.47E-06,1,2
sensible,1,1.84E-06,0,0,9.47E-06,1,3
gestures,1,1.84E-06,0,0,9.47E-06,1,2
grinding,1,1.84E-06,0,0,9.47E-06,1,2
sporting,1,1.84E-06,0,0,9.47E-06,1,2
saveweve,1,1.84E-06,0,0,9.47E-06,1,3
netherlands,1,1.84E-06,1,2.28E-06,0,0,3
starship,1,1.84E-06,0,0,9.47E-06,1,2
economys,1,1.84E-06,0,0,9.47E-06,1,4
starring,1,1.84E-06,0,0,9.47E-06,1,2
taxesbut,1,1.84E-06,0,0,9.47E-06,1,3
actright,1,1.84E-06,0,0,9.47E-06,1,2
compound,1,1.84E-06,0,0,9.47E-06,1,2
enabling,1,1.84E-06,0,0,9.47E-06,1,3
yearstay,1,1.84E-06,0,0,9.47E-06,1,2
yearsget,1,1.84E-06,0,0,9.47E-06,1,2
daythats,1,1.84E-06,0,0,9.47E-06,1,2
salesman,1,1.84E-06,0,0,9.47E-06,1,3
thingget,1,1.84E-06,0,0,9.47E-06,1,2
canheres,1,1.84E-06,0,0,9.47E-06,1,2
teaching,1,1.84E-06,0,0,9.47E-06,1,2
seaboard,1,1.84E-06,0,0,9.47E-06,1,2
grabbing,1,1.84E-06,0,0,9.47E-06,1,2
symptoms,1,1.84E-06,0,0,9.47E-06,1,2
pregnant,1,1.84E-06,0,0,9.47E-06,1,2
redefine,1,1.84E-06,0,0,9.47E-06,1,3
staffers,1,1.84E-06,0,0,9.47E-06,1,2
voicewho,1,1.84E-06,0,0,9.47E-06,1,3
homemade,1,1.84E-06,0,0,9.47E-06,1,3
coherent,1,1.84E-06,0,0,9.47E-06,1,3
mcgovern,1,1.84E-06,0,0,9.47E-06,1,2
jobsgood,1,1.84E-06,0,0,9.47E-06,1,2
debateor,1,1.84E-06,0,0,9.47E-06,1,3
lengthening,1,1.84E-06,1,2.28E-06,0,0,3
yorkyour,1,1.84E-06,0,0,9.47E-06,1,3
sneaking,1,1.84E-06,0,0,9.47E-06,1,2
beholden,1,1.84E-06,0,0,9.47E-06,1,3
superman,1,1.84E-06,0,0,9.47E-06,1,3
ideajust,1,1.84E-06,0,0,9.47E-06,1,3
retreads,1,1.84E-06,0,0,9.47E-06,1,2
academic,1,1.84E-06,0,0,9.47E-06,1,4
mandates,1,1.84E-06,0,0,9.47E-06,1,2
sonspres,1,1.84E-06,0,0,9.47E-06,1,1
retirees,1,1.84E-06,0,0,9.47E-06,1,3
eloquent,1,1.84E-06,0,0,9.47E-06,1,3
notebook,1,1.84E-06,0,0,9.47E-06,1,3
displace,1,1.84E-06,0,0,9.47E-06,1,2
myselfto,1,1.84E-06,0,0,9.47E-06,1,3
changeup,1,1.84E-06,0,0,9.47E-06,1,2
outspent,1,1.84E-06,0,0,9.47E-06,1,2
retooled,1,1.84E-06,0,0,9.47E-06,1,2
drawings,1,1.84E-06,0,0,9.47E-06,1,2
airfares,1,1.84E-06,0,0,9.47E-06,1,2
educator,1,1.84E-06,0,0,9.47E-06,1,4
maximize,1,1.84E-06,0,0,9.47E-06,1,3
clothing,1,1.84E-06,0,0,9.47E-06,1,2
modified,1,1.84E-06,0,0,9.47E-06,1,3
crippled,1,1.84E-06,0,0,9.47E-06,1,1
ohiotune,1,1.84E-06,0,0,9.47E-06,1,3
sidewalk,1,1.84E-06,0,0,9.47E-06,1,3
wildcats,1,1.84E-06,0,0,9.47E-06,1,2
islander,1,1.84E-06,0,0,9.47E-06,1,3
loanslet,1,1.84E-06,0,0,9.47E-06,1,2
downchip,1,1.84E-06,0,0,9.47E-06,1,2
thingone,1,1.84E-06,0,0,9.47E-06,1,2
animated,1,1.84E-06,0,0,9.47E-06,1,3
nowpotus,1,1.84E-06,0,0,9.47E-06,1,3
savingby,1,1.84E-06,0,0,9.47E-06,1,3
todaynow,1,1.84E-06,0,0,9.47E-06,1,3
wondered,1,1.84E-06,0,0,9.47E-06,1,2
barackif,1,1.84E-06,0,0,9.47E-06,1,3
giveaway,1,1.84E-06,0,0,9.47E-06,1,3
backjoan,1,1.84E-06,0,0,9.47E-06,1,2
dayorder,1,1.84E-06,0,0,9.47E-06,1,3
imported,1,1.84E-06,0,0,9.47E-06,1,2
snapshot,1,1.84E-06,0,0,9.47E-06,1,2
growthby,1,1.84E-06,0,0,9.47E-06,1,2
download,1,1.84E-06,0,0,9.47E-06,1,2
ringtone,1,1.84E-06,0,0,9.47E-06,1,2
optional,1,1.84E-06,0,0,9.47E-06,1,3
tempting,1,1.84E-06,0,0,9.47E-06,1,2
profiled,1,1.84E-06,0,0,9.47E-06,1,2
harvests,1,1.84E-06,0,0,9.47E-06,1,2
chipping,1,1.84E-06,0,0,9.47E-06,1,2
tailgate,1,1.84E-06,0,0,9.47E-06,1,2
quotable,1,1.84E-06,0,0,9.47E-06,1,3
lesbians,1,1.84E-06,0,0,9.47E-06,1,2
atlantis,1,1.84E-06,0,0,9.47E-06,1,3
lincolns,1,1.84E-06,0,0,9.47E-06,1,2
botswana,1,1.84E-06,0,0,9.47E-06,1,3
santiago,1,1.84E-06,0,0,9.47E-06,1,3
tsunamis,1,1.84E-06,0,0,9.47E-06,1,3
cheapest,1,1.84E-06,0,0,9.47E-06,1,2
futureby,1,1.84E-06,0,0,9.47E-06,1,4
futureif,1,1.84E-06,0,0,9.47E-06,1,3
anyoneis,1,1.84E-06,0,0,9.47E-06,1,3
landover,1,1.84E-06,0,0,9.47E-06,1,3
friendsi,1,1.84E-06,0,0,9.47E-06,1,2
blockade,1,1.84E-06,0,0,9.47E-06,1,2
juncture,1,1.84E-06,0,0,9.47E-06,1,2
ushering,1,1.84E-06,0,0,9.47E-06,1,3
medvedev,1,1.84E-06,0,0,9.47E-06,1,3
lawelena,1,1.84E-06,0,0,9.47E-06,1,4
bombings,1,1.84E-06,0,0,9.47E-06,1,2
competed,1,1.84E-06,0,0,9.47E-06,1,2
morejoin,1,1.84E-06,0,0,9.47E-06,1,3
alarming,1,1.84E-06,0,0,9.47E-06,1,3
passions,1,1.84E-06,0,0,9.47E-06,1,2
populari,1,1.84E-06,0,0,9.47E-06,1,4
plouffes,1,1.84E-06,0,0,9.47E-06,1,1
forceful,1,1.84E-06,0,0,9.47E-06,1,3
medalone,1,1.84E-06,0,0,9.47E-06,1,3
sebelius,1,1.84E-06,0,0,9.47E-06,1,3
resisted,1,1.84E-06,0,0,9.47E-06,1,2
luckiest,1,1.84E-06,0,0,9.47E-06,1,2
unveiled,1,1.84E-06,0,0,9.47E-06,1,2
helphost,1,1.84E-06,0,0,9.47E-06,1,2
colberts,1,1.84E-06,0,0,9.47E-06,1,2
uploaded,1,1.84E-06,1,2.28E-06,0,0,2
armenian,1,1.84E-06,1,2.28E-06,0,0,3
chaldean,1,1.84E-06,1,2.28E-06,0,0,2
sponsors,1,1.84E-06,1,2.28E-06,0,0,2
religous,1,1.84E-06,1,2.28E-06,0,0,3
overrule,1,1.84E-06,1,2.28E-06,0,0,4
goldmine,1,1.84E-06,1,2.28E-06,0,0,2
oblivion,1,1.84E-06,1,2.28E-06,0,0,3
resolute,1,1.84E-06,1,2.28E-06,0,0,3
disputed,1,1.84E-06,1,2.28E-06,0,0,2
muskegon,1,1.84E-06,1,2.28E-06,0,0,3
toensing,1,1.84E-06,1,2.28E-06,0,0,2
deceased,1,1.84E-06,1,2.28E-06,0,0,2
wretched,1,1.84E-06,1,2.28E-06,0,0,1
gauntlet,1,1.84E-06,1,2.28E-06,0,0,2
valdosta,1,1.84E-06,1,2.28E-06,0,0,3
slashing,1,1.84E-06,1,2.28E-06,0,0,2
boarding,1,1.84E-06,1,2.28E-06,0,0,2
screened,1,1.84E-06,1,2.28E-06,0,0,1
nicklaus,1,1.84E-06,1,2.28E-06,0,0,2
usurping,1,1.84E-06,1,2.28E-06,0,0,3
georgian,1,1.84E-06,1,2.28E-06,0,0,2
dreamget,1,1.84E-06,1,2.28E-06,0,0,2
shipyard,1,1.84E-06,1,2.28E-06,0,0,2
escalate,1,1.84E-06,1,2.28E-06,0,0,3
moroccan,1,1.84E-06,1,2.28E-06,0,0,3
moroccos,1,1.84E-06,1,2.28E-06,0,0,3
autonomy,1,1.84E-06,1,2.28E-06,0,0,4
removals,1,1.84E-06,1,2.28E-06,0,0,3
drenched,1,1.84E-06,1,2.28E-06,0,0,1
fairways,1,1.84E-06,1,2.28E-06,0,0,2
trusting,1,1.84E-06,1,2.28E-06,0,0,2
donoghue,1,1.84E-06,1,2.28E-06,0,0,3
demeaned,1,1.84E-06,1,2.28E-06,0,0,2
dethrone,1,1.84E-06,1,2.28E-06,0,0,2
impulsar,1,1.84E-06,1,2.28E-06,0,0,3
libertad,1,1.84E-06,1,2.28E-06,0,0,3
traverse,1,1.84E-06,1,2.28E-06,0,0,2
swindled,1,1.84E-06,1,2.28E-06,0,0,1
dementia,1,1.84E-06,1,2.28E-06,0,0,3
coughing,1,1.84E-06,1,2.28E-06,0,0,2
gingrich,1,1.84E-06,1,2.28E-06,0,0,2
software,1,1.84E-06,1,2.28E-06,0,0,2
systemic,1,1.84E-06,1,2.28E-06,0,0,3
journals,1,1.84E-06,1,2.28E-06,0,0,2
deducted,1,1.84E-06,1,2.28E-06,0,0,2
dictates,1,1.84E-06,1,2.28E-06,0,0,2
bengahzi,1,1.84E-06,1,2.28E-06,0,0,3
marchant,1,1.84E-06,1,2.28E-06,0,0,2
wrestler,1,1.84E-06,1,2.28E-06,0,0,2
mathematical,1,1.84E-06,1,2.28E-06,0,0,5
handrail,1,1.84E-06,1,2.28E-06,0,0,2
dissolve,1,1.84E-06,1,2.28E-06,0,0,2
commencment,1,1.84E-06,1,2.28E-06,0,0,3
nationwe,1,1.84E-06,1,2.28E-06,0,0,2
profiles,1,1.84E-06,1,2.28E-06,0,0,3
tampered,1,1.84E-06,1,2.28E-06,0,0,2
olympian,1,1.84E-06,1,2.28E-06,0,0,3
restores,1,1.84E-06,1,2.28E-06,0,0,2
personas,1,1.84E-06,1,2.28E-06,0,0,3
forehead,1,1.84E-06,1,2.28E-06,0,0,3
eviction,1,1.84E-06,1,2.28E-06,0,0,3
commemorates,1,1.84E-06,0,0,9.47E-06,1,4
adhering,1,1.84E-06,1,2.28E-06,0,0,3
trounces,1,1.84E-06,1,2.28E-06,0,0,1
grynbaum,1,1.84E-06,1,2.28E-06,0,0,2
touching,1,1.84E-06,1,2.28E-06,0,0,2
punching,1,1.84E-06,1,2.28E-06,0,0,2
reviving,1,1.84E-06,1,2.28E-06,0,0,3
roadside,1,1.84E-06,1,2.28E-06,0,0,2
precinct,1,1.84E-06,1,2.28E-06,0,0,2
diseases,1,1.84E-06,1,2.28E-06,0,0,2
figuring,1,1.84E-06,1,2.28E-06,0,0,3
incurred,1,1.84E-06,1,2.28E-06,0,0,2
relation,1,1.84E-06,1,2.28E-06,0,0,3
thompson,1,1.84E-06,1,2.28E-06,0,0,2
vehicles,1,1.84E-06,1,2.28E-06,0,0,3
clunkers,1,1.84E-06,1,2.28E-06,0,0,2
convicts,1,1.84E-06,1,2.28E-06,0,0,2
Ø¨Ø²Ø±Ú¯,1,1.84E-06,1,2.28E-06,0,0,#ERROR!
credence,1,1.84E-06,1,2.28E-06,0,0,2
narrowed,1,1.84E-06,1,2.28E-06,0,0,2
holdover,1,1.84E-06,1,2.28E-06,0,0,3
munchkin,1,1.84E-06,1,2.28E-06,0,0,2
chippewa,1,1.84E-06,1,2.28E-06,0,0,3
schumers,1,1.84E-06,1,2.28E-06,0,0,2
mcginley,1,1.84E-06,1,2.28E-06,0,0,2
revolver,1,1.84E-06,1,2.28E-06,0,0,3
forensic,1,1.84E-06,1,2.28E-06,0,0,3
surveyed,1,1.84E-06,1,2.28E-06,0,0,2
deafness,1,1.84E-06,1,2.28E-06,0,0,2
urgently,1,1.84E-06,1,2.28E-06,0,0,3
purchaes,1,1.84E-06,1,2.28E-06,0,0,2
veronica,1,1.84E-06,1,2.28E-06,0,0,4
subtract,1,1.84E-06,1,2.28E-06,0,0,2
mcmuffin,1,1.84E-06,1,2.28E-06,0,0,2
moonface,1,1.84E-06,1,2.28E-06,0,0,2
suspects,1,1.84E-06,1,2.28E-06,0,0,2
scrubbed,1,1.84E-06,1,2.28E-06,0,0,1
breakers,1,1.84E-06,1,2.28E-06,0,0,2
carnival,1,1.84E-06,1,2.28E-06,0,0,3
outbound,1,1.84E-06,1,2.28E-06,0,0,2
swinging,1,1.84E-06,1,2.28E-06,0,0,2
lopsided,1,1.84E-06,1,2.28E-06,0,0,2
bismarck,1,1.84E-06,1,2.28E-06,0,0,2
hazleton,1,1.84E-06,1,2.28E-06,0,0,3
podestas,1,1.84E-06,1,2.28E-06,0,0,3
stricken,1,1.84E-06,1,2.28E-06,0,0,2
unknowns,1,1.84E-06,1,2.28E-06,0,0,2
dropouts,1,1.84E-06,1,2.28E-06,0,0,2
occupied,1,1.84E-06,1,2.28E-06,0,0,3
primiums,1,1.84E-06,1,2.28E-06,0,0,2
admirals,1,1.84E-06,1,2.28E-06,0,0,3
mariners,1,1.84E-06,1,2.28E-06,0,0,3
jentezen,1,1.84E-06,1,2.28E-06,0,0,3
merrimac,1,1.84E-06,1,2.28E-06,0,0,3
ungifted,1,1.84E-06,1,2.28E-06,0,0,2
barbours,1,1.84E-06,1,2.28E-06,0,0,2
cambodia,1,1.84E-06,1,2.28E-06,0,0,3
somerset,1,1.84E-06,1,2.28E-06,0,0,3
overpass,1,1.84E-06,1,2.28E-06,0,0,3
nationss,1,1.84E-06,1,2.28E-06,0,0,2
hoarding,1,1.84E-06,1,2.28E-06,0,0,2
vanished,1,1.84E-06,1,2.28E-06,0,0,2
reacting,1,1.84E-06,1,2.28E-06,0,0,2
arguably,1,1.84E-06,1,2.28E-06,0,0,3
accosted,1,1.84E-06,1,2.28E-06,0,0,2
debunked,1,1.84E-06,1,2.28E-06,0,0,2
survives,1,1.84E-06,1,2.28E-06,0,0,2
blockage,1,1.84E-06,1,2.28E-06,0,0,2
cratered,1,1.84E-06,1,2.28E-06,0,0,2
reopened,1,1.84E-06,1,2.28E-06,0,0,2
areamore,1,1.84E-06,1,2.28E-06,0,0,3
vilified,1,1.84E-06,1,2.28E-06,0,0,3
mckelway,1,1.84E-06,1,2.28E-06,0,0,2
financed,1,1.84E-06,1,2.28E-06,0,0,2
whiplash,1,1.84E-06,1,2.28E-06,0,0,2
exterior,1,1.84E-06,1,2.28E-06,0,0,3
defacing,1,1.84E-06,1,2.28E-06,0,0,3
secondly,1,1.84E-06,1,2.28E-06,0,0,3
mistaken,1,1.84E-06,1,2.28E-06,0,0,3
mcarthur,1,1.84E-06,1,2.28E-06,0,0,2
listings,1,1.84E-06,1,2.28E-06,0,0,2
changers,1,1.84E-06,1,2.28E-06,0,0,2
misdeeds,1,1.84E-06,1,2.28E-06,0,0,2
douglass,1,1.84E-06,1,2.28E-06,0,0,2
persists,1,1.84E-06,1,2.28E-06,0,0,2
redskins,1,1.84E-06,1,2.28E-06,0,0,2
bumbling,1,1.84E-06,1,2.28E-06,0,0,2
enforced,1,1.84E-06,1,2.28E-06,0,0,2
tiffanys,1,1.84E-06,1,2.28E-06,0,0,3
bustling,1,1.84E-06,1,2.28E-06,0,0,2
activate,1,1.84E-06,1,2.28E-06,0,0,3
doexcept,1,1.84E-06,1,2.28E-06,0,0,2
weighing,1,1.84E-06,1,2.28E-06,0,0,2
newscast,1,1.84E-06,1,2.28E-06,0,0,2
plunging,1,1.84E-06,1,2.28E-06,0,0,2
shredded,1,1.84E-06,1,2.28E-06,0,0,1
stagnant,1,1.84E-06,1,2.28E-06,0,0,2
knockout,1,1.84E-06,1,2.28E-06,0,0,2
shepherd,1,1.84E-06,1,2.28E-06,0,0,2
alerting,1,1.84E-06,1,2.28E-06,0,0,3
keyboard,1,1.84E-06,1,2.28E-06,0,0,2
walorski,1,1.84E-06,1,2.28E-06,0,0,3
dumpster,1,1.84E-06,1,2.28E-06,0,0,2
concasts,1,1.84E-06,1,2.28E-06,0,0,2
redstone,1,1.84E-06,1,2.28E-06,0,0,2
ironclad,1,1.84E-06,1,2.28E-06,0,0,3
lankford,1,1.84E-06,1,2.28E-06,0,0,2
montanas,1,1.84E-06,1,2.28E-06,0,0,3
bungling,1,1.84E-06,1,2.28E-06,0,0,2
concepts,1,1.84E-06,1,2.28E-06,0,0,2
majewski,1,1.84E-06,1,2.28E-06,0,0,3
monumrnt,1,1.84E-06,1,2.28E-06,0,0,2
wildwood,1,1.84E-06,1,2.28E-06,0,0,2
ginsberg,1,1.84E-06,1,2.28E-06,0,0,2
hometown,1,1.84E-06,1,2.28E-06,0,0,3
planmore,1,1.84E-06,1,2.28E-06,0,0,2
assisted,1,1.84E-06,1,2.28E-06,0,0,2
gofundme,1,1.84E-06,1,2.28E-06,0,0,2
isolated,1,1.84E-06,1,2.28E-06,0,0,3
unsteady,1,1.84E-06,1,2.28E-06,0,0,3
ravaging,1,1.84E-06,1,2.28E-06,0,0,3
Ø´Ø±Ú©Øª,1,1.84E-06,1,2.28E-06,0,0,#ERROR!
parscale,1,1.84E-06,1,2.28E-06,0,0,3
unifying,1,1.84E-06,1,2.28E-06,0,0,3
marshals,1,1.84E-06,1,2.28E-06,0,0,2
enriched,1,1.84E-06,1,2.28E-06,0,0,2
gunboats,1,1.84E-06,1,2.28E-06,0,0,2
eastport,1,1.84E-06,1,2.28E-06,0,0,2
lobsters,1,1.84E-06,1,2.28E-06,0,0,2
overused,1,1.84E-06,1,2.28E-06,0,0,3
tabulate,1,1.84E-06,1,2.28E-06,0,0,3
bloombeg,1,1.84E-06,1,2.28E-06,0,0,2
imperils,1,1.84E-06,1,2.28E-06,0,0,3
fisagate,1,1.84E-06,1,2.28E-06,0,0,3
charlies,1,1.84E-06,1,2.28E-06,0,0,2
rudeness,1,1.84E-06,1,2.28E-06,0,0,3
indebted,1,1.84E-06,1,2.28E-06,0,0,2
fedexcup,1,1.84E-06,1,2.28E-06,0,0,3
enablers,1,1.84E-06,1,2.28E-06,0,0,3
sunlight,1,1.84E-06,1,2.28E-06,0,0,2
offender,1,1.84E-06,1,2.28E-06,0,0,3
plugging,1,1.84E-06,1,2.28E-06,0,0,2
thuggery,1,1.84E-06,1,2.28E-06,0,0,3
lateness,1,1.84E-06,1,2.28E-06,0,0,3
dominate,1,1.84E-06,1,2.28E-06,0,0,3
bargains,1,1.84E-06,1,2.28E-06,0,0,2
remotely,1,1.84E-06,1,2.28E-06,0,0,4
securely,1,1.84E-06,1,2.28E-06,0,0,4
failings,1,1.84E-06,1,2.28E-06,0,0,2
defender,1,1.84E-06,1,2.28E-06,0,0,3
hartzler,1,1.84E-06,1,2.28E-06,0,0,2
jpmorgan,1,1.84E-06,1,2.28E-06,0,0,2
solemnly,1,1.84E-06,1,2.28E-06,0,0,3
dzhokhar,1,1.84E-06,1,2.28E-06,0,0,2
tsarnaev,1,1.84E-06,1,2.28E-06,0,0,2
arizonas,1,1.84E-06,1,2.28E-06,0,0,4
floridas,1,1.84E-06,1,2.28E-06,0,0,3
railways,1,1.84E-06,1,2.28E-06,0,0,2
motivate,1,1.84E-06,1,2.28E-06,0,0,3
squadron,1,1.84E-06,1,2.28E-06,0,0,2
exposeda,1,1.84E-06,1,2.28E-06,0,0,4
stadiums,1,1.84E-06,1,2.28E-06,0,0,2
creators,1,1.84E-06,1,2.28E-06,0,0,2
monterey,1,1.84E-06,1,2.28E-06,0,0,3
wishbone,1,1.84E-06,1,2.28E-06,0,0,2
gobblers,1,1.84E-06,1,2.28E-06,0,0,2
marshawn,1,1.84E-06,1,2.28E-06,0,0,2
liangelo,1,1.84E-06,1,2.28E-06,0,0,3
wdiverse,1,1.84E-06,1,2.28E-06,0,0,2
cultures,1,1.84E-06,1,2.28E-06,0,0,2
storming,1,1.84E-06,1,2.28E-06,0,0,2
griparmy,1,1.84E-06,1,2.28E-06,0,0,3
yearfour,1,1.84E-06,1,2.28E-06,0,0,2
brazenly,1,1.84E-06,1,2.28E-06,0,0,3
fakenews,1,1.84E-06,1,2.28E-06,0,0,3
licenses,1,1.84E-06,1,2.28E-06,0,0,2
ingrates,1,1.84E-06,1,2.28E-06,0,0,2
racefake,1,1.84E-06,1,2.28E-06,0,0,3
aligning,1,1.84E-06,1,2.28E-06,0,0,3
advising,1,1.84E-06,1,2.28E-06,0,0,3
tortured,1,1.84E-06,1,2.28E-06,0,0,2
deceived,1,1.84E-06,1,2.28E-06,0,0,2
koreanot,1,1.84E-06,1,2.28E-06,0,0,3
noticing,1,1.84E-06,1,2.28E-06,0,0,3
lifecont,1,1.84E-06,1,2.28E-06,0,0,3
malaysia,1,1.84E-06,1,2.28E-06,0,0,3
andeavor,1,1.84E-06,1,2.28E-06,0,0,3
refinery,1,1.84E-06,1,2.28E-06,0,0,4
legalize,1,1.84E-06,1,2.28E-06,0,0,3
harveymy,1,1.84E-06,1,2.28E-06,0,0,3
retaking,1,1.84E-06,1,2.28E-06,0,0,3
strongto,1,1.84E-06,1,2.28E-06,0,0,2
pershing,1,1.84E-06,1,2.28E-06,0,0,2
unwisely,1,1.84E-06,1,2.28E-06,0,0,4
rebounds,1,1.84E-06,1,2.28E-06,0,0,2
renovate,1,1.84E-06,1,2.28E-06,0,0,3
sanction,1,1.84E-06,1,2.28E-06,0,0,2
burdened,1,1.84E-06,1,2.28E-06,0,0,2
intraday,1,1.84E-06,1,2.28E-06,0,0,3
susteren,1,1.84E-06,1,2.28E-06,0,0,3
enquirer,1,1.84E-06,1,2.28E-06,0,0,3
guardian,1,1.84E-06,1,2.28E-06,0,0,2
kirkwood,1,1.84E-06,1,2.28E-06,0,0,2
bleached,1,1.84E-06,1,2.28E-06,0,0,1
washpost,1,1.84E-06,1,2.28E-06,0,0,2
nguyá»…n,1,1.84E-06,1,2.28E-06,0,0,1
taormina,1,1.84E-06,1,2.28E-06,0,0,3
welcomed,1,1.84E-06,1,2.28E-06,0,0,2
rocketry,1,1.84E-06,1,2.28E-06,0,0,3
signings,1,1.84E-06,1,2.28E-06,0,0,2
tumbling,1,1.84E-06,1,2.28E-06,0,0,2
enhances,1,1.84E-06,1,2.28E-06,0,0,2
atlantas,1,1.84E-06,1,2.28E-06,0,0,3
mcgarvey,1,1.84E-06,1,2.28E-06,0,0,2
unmasked,1,1.84E-06,1,2.28E-06,0,0,2
trucking,1,1.84E-06,1,2.28E-06,0,0,2
phadraig,1,1.84E-06,1,2.28E-06,0,0,2
linkedin,1,1.84E-06,1,2.28E-06,0,0,3
culturea,1,1.84E-06,1,2.28E-06,0,0,3
leopoldo,1,1.84E-06,1,2.28E-06,0,0,3
reprieve,1,1.84E-06,1,2.28E-06,0,0,2
krzanich,1,1.84E-06,1,2.28E-06,0,0,2
berkeley,1,1.84E-06,1,2.28E-06,0,0,3
energies,1,1.84E-06,1,2.28E-06,0,0,3
outgoing,1,1.84E-06,1,2.28E-06,0,0,2
mcdonald,1,1.84E-06,1,2.28E-06,0,0,2
factstoo,1,1.84E-06,1,2.28E-06,0,0,2
pressing,1,1.84E-06,1,2.28E-06,0,0,2
evanchos,1,1.84E-06,1,2.28E-06,0,0,3
careless,1,1.84E-06,1,2.28E-06,0,0,3
eleventh,1,1.84E-06,1,2.28E-06,0,0,3
explores,1,1.84E-06,1,2.28E-06,0,0,2
builthas,1,1.84E-06,1,2.28E-06,0,0,2
pesident,1,1.84E-06,1,2.28E-06,0,0,3
exceeded,1,1.84E-06,1,2.28E-06,0,0,2
populism,1,1.84E-06,1,2.28E-06,0,0,3
adjourns,1,1.84E-06,1,2.28E-06,0,0,2
carafano,1,1.84E-06,1,2.28E-06,0,0,4
fbicomey,1,1.84E-06,1,2.28E-06,0,0,3
exploded,1,1.84E-06,1,2.28E-06,0,0,2
protocol,1,1.84E-06,1,2.28E-06,0,0,3
elegance,1,1.84E-06,1,2.28E-06,0,0,3
crafting,1,1.84E-06,1,2.28E-06,0,0,2
preamble,1,1.84E-06,1,2.28E-06,0,0,2
gulfport,1,1.84E-06,1,2.28E-06,0,0,2
eventual,1,1.84E-06,1,2.28E-06,0,0,3
climbers,1,1.84E-06,1,2.28E-06,0,0,2
mistreat,1,1.84E-06,1,2.28E-06,0,0,2
workings,1,1.84E-06,1,2.28E-06,0,0,2
contains,1,1.84E-06,1,2.28E-06,0,0,2
portions,1,1.84E-06,1,2.28E-06,0,0,2
suresnes,1,1.84E-06,1,2.28E-06,0,0,2
evacuate,1,1.84E-06,1,2.28E-06,0,0,3
hultgren,1,1.84E-06,1,2.28E-06,0,0,2
mckenzie,1,1.84E-06,1,2.28E-06,0,0,2
squirrel,1,1.84E-06,1,2.28E-06,0,0,2
walkaway,1,1.84E-06,1,2.28E-06,0,0,3
thunders,1,1.84E-06,1,2.28E-06,0,0,2
enlisted,1,1.84E-06,1,2.28E-06,0,0,2
reverent,1,1.84E-06,1,2.28E-06,0,0,3
simpsons,1,1.84E-06,1,2.28E-06,0,0,2
princess,1,1.84E-06,1,2.28E-06,0,0,2
shoutout,1,1.84E-06,1,2.28E-06,0,0,2
lacrosse,1,1.84E-06,1,2.28E-06,0,0,2
nepotism,1,1.84E-06,1,2.28E-06,0,0,3
troopers,1,1.84E-06,1,2.28E-06,0,0,2
darkened,1,1.84E-06,1,2.28E-06,0,0,2
arsonist,1,1.84E-06,1,2.28E-06,0,0,3
elevator,1,1.84E-06,1,2.28E-06,0,0,4
riveting,1,1.84E-06,1,2.28E-06,0,0,3
wheeling,1,1.84E-06,1,2.28E-06,0,0,2
newfound,1,1.84E-06,1,2.28E-06,0,0,2
undercut,1,1.84E-06,1,2.28E-06,0,0,3
flailing,1,1.84E-06,1,2.28E-06,0,0,2
cnbcalso,1,1.84E-06,1,2.28E-06,0,0,2
nicholas,1,1.84E-06,1,2.28E-06,0,0,3
amendmen,1,1.84E-06,1,2.28E-06,0,0,3
retarded,1,1.84E-06,1,2.28E-06,0,0,2
renowned,1,1.84E-06,1,2.28E-06,0,0,2
fumbling,1,1.84E-06,1,2.28E-06,0,0,2
weissman,1,1.84E-06,1,2.28E-06,0,0,2
function,1,1.84E-06,1,2.28E-06,0,0,2
rosemary,1,1.84E-06,1,2.28E-06,0,0,4
referral,1,1.84E-06,1,2.28E-06,0,0,3
morphing,1,1.84E-06,1,2.28E-06,0,0,2
michaels,1,1.84E-06,1,2.28E-06,0,0,2
blinders,1,1.84E-06,1,2.28E-06,0,0,2
formerly,1,1.84E-06,1,2.28E-06,0,0,3
premised,1,1.84E-06,1,2.28E-06,0,0,2
resulted,1,1.84E-06,1,2.28E-06,0,0,2
massages,1,1.84E-06,1,2.28E-06,0,0,2
vanguard,1,1.84E-06,1,2.28E-06,0,0,2
honolulu,1,1.84E-06,1,2.28E-06,0,0,4
improper,1,1.84E-06,1,2.28E-06,0,0,3
snipping,1,1.84E-06,1,2.28E-06,0,0,2
cautious,1,1.84E-06,1,2.28E-06,0,0,3
novartis,1,1.84E-06,1,2.28E-06,0,0,3
exerting,1,1.84E-06,1,2.28E-06,0,0,3
leftwing,1,1.84E-06,1,2.28E-06,0,0,2
portugal,1,1.84E-06,1,2.28E-06,0,0,3
canopies,1,1.84E-06,1,2.28E-06,0,0,3
clarence,1,1.84E-06,1,2.28E-06,0,0,2
sidekick,1,1.84E-06,1,2.28E-06,0,0,3
melanias,1,1.84E-06,1,2.28E-06,0,0,3
password,1,1.84E-06,1,2.28E-06,0,0,2
distroys,1,1.84E-06,1,2.28E-06,0,0,2
lingered,1,1.84E-06,1,2.28E-06,0,0,2
downplay,1,1.84E-06,1,2.28E-06,0,0,2
embraces,1,1.84E-06,1,2.28E-06,0,0,2
ovechkin,1,1.84E-06,1,2.28E-06,0,0,3
sighting,1,1.84E-06,1,2.28E-06,0,0,2
facelift,1,1.84E-06,1,2.28E-06,0,0,3
burglary,1,1.84E-06,1,2.28E-06,0,0,3
faulkner,1,1.84E-06,1,2.28E-06,0,0,2
himselfi,1,1.84E-06,1,2.28E-06,0,0,3
escaping,1,1.84E-06,1,2.28E-06,0,0,3
offended,1,1.84E-06,1,2.28E-06,0,0,2
lawmaker,1,1.84E-06,1,2.28E-06,0,0,3
tapestry,1,1.84E-06,1,2.28E-06,0,0,3
prairies,1,1.84E-06,1,2.28E-06,0,0,2
nurtured,1,1.84E-06,1,2.28E-06,0,0,2
operator,1,1.84E-06,1,2.28E-06,0,0,4
guterres,1,1.84E-06,1,2.28E-06,0,0,2
mauricio,1,1.84E-06,1,2.28E-06,0,0,3
embedded,1,1.84E-06,1,2.28E-06,0,0,2
shortest,1,1.84E-06,1,2.28E-06,0,0,2
retainer,1,1.84E-06,1,2.28E-06,0,0,3
screwing,1,1.84E-06,1,2.28E-06,0,0,2
hercules,1,1.84E-06,1,2.28E-06,0,0,3
triumphs,1,1.84E-06,1,2.28E-06,0,0,1
octobers,1,1.84E-06,1,2.28E-06,0,0,3
northcom,1,1.84E-06,1,2.28E-06,0,0,2
southcom,1,1.84E-06,1,2.28E-06,0,0,2
breeding,1,1.84E-06,1,2.28E-06,0,0,2
deflated,1,1.84E-06,1,2.28E-06,0,0,2
cradling,1,1.84E-06,1,2.28E-06,0,0,2
mindless,1,1.84E-06,1,2.28E-06,0,0,2
truejust,1,1.84E-06,1,2.28E-06,0,0,2
relating,1,1.84E-06,1,2.28E-06,0,0,3
humboldt,1,1.84E-06,1,2.28E-06,0,0,2
youtubes,1,1.84E-06,1,2.28E-06,0,0,2
moonbeam,1,1.84E-06,1,2.28E-06,0,0,2
companys,1,1.84E-06,1,2.28E-06,0,0,3
shulkins,1,1.84E-06,1,2.28E-06,0,0,2
casedont,1,1.84E-06,1,2.28E-06,0,0,3
swapping,1,1.84E-06,1,2.28E-06,0,0,2
handover,1,1.84E-06,1,2.28E-06,0,0,3
yearmost,1,1.84E-06,1,2.28E-06,0,0,2
sourceor,1,1.84E-06,1,2.28E-06,0,0,2
choirboy,1,1.84E-06,1,2.28E-06,0,0,2
aviators,1,1.84E-06,1,2.28E-06,0,0,3
startled,1,1.84E-06,1,2.28E-06,0,0,1
kristian,1,1.84E-06,1,2.28E-06,0,0,2
addicted,1,1.84E-06,1,2.28E-06,0,0,2
gridiron,1,1.84E-06,1,2.28E-06,0,0,3
appealed,1,1.84E-06,1,2.28E-06,0,0,2
firearms,1,1.84E-06,1,2.28E-06,0,0,2
scripted,1,1.84E-06,1,2.28E-06,0,0,1
ministry,1,1.84E-06,1,2.28E-06,0,0,3
kenstarr,1,1.84E-06,1,2.28E-06,0,0,2
grassley,1,1.84E-06,1,2.28E-06,0,0,2
branches,1,1.84E-06,1,2.28E-06,0,0,1
enforcer,1,1.84E-06,1,2.28E-06,0,0,3
genocide,1,1.84E-06,1,2.28E-06,0,0,3
grounded,1,1.84E-06,1,2.28E-06,0,0,1
overdose,1,1.84E-06,1,2.28E-06,0,0,3
commentators,1,1.84E-06,0,0,9.47E-06,1,4
domenech,1,1.84E-06,1,2.28E-06,0,0,3
reflexes,1,1.84E-06,1,2.28E-06,0,0,2
stumbles,1,1.84E-06,1,2.28E-06,0,0,2
armynavy,1,1.84E-06,1,2.28E-06,0,0,4
granting,1,1.84E-06,1,2.28E-06,0,0,2
shootout,1,1.84E-06,1,2.28E-06,0,0,2
pivoting,1,1.84E-06,1,2.28E-06,0,0,3
repeated,1,1.84E-06,1,2.28E-06,0,0,2
barbaric,1,1.84E-06,1,2.28E-06,0,0,3
spencers,1,1.84E-06,1,2.28E-06,0,0,2
stefanik,1,1.84E-06,1,2.28E-06,0,0,3
unspoken,1,1.84E-06,1,2.28E-06,0,0,3
henchman,1,1.84E-06,1,2.28E-06,0,0,2
altering,1,1.84E-06,1,2.28E-06,0,0,3
hysteria,1,1.84E-06,1,2.28E-06,0,0,3
discused,1,1.84E-06,1,2.28E-06,0,0,2
remained,1,1.84E-06,1,2.28E-06,0,0,2
envision,1,1.84E-06,1,2.28E-06,0,0,3
remedies,1,1.84E-06,1,2.28E-06,0,0,3
levinson,1,1.84E-06,1,2.28E-06,0,0,3
baghdadi,1,1.84E-06,1,2.28E-06,0,0,3
monsters,1,1.84E-06,1,2.28E-06,0,0,2
chutzpah,1,1.84E-06,1,2.28E-06,0,0,2
stoppers,1,1.84E-06,1,2.28E-06,0,0,2
adjusted,1,1.84E-06,1,2.28E-06,0,0,2
validate,1,1.84E-06,1,2.28E-06,0,0,3
discreet,1,1.84E-06,1,2.28E-06,0,0,2
murderer,1,1.84E-06,1,2.28E-06,0,0,3
conjures,1,1.84E-06,1,2.28E-06,0,0,2
reformat,1,1.84E-06,1,2.28E-06,0,0,3
derelict,1,1.84E-06,1,2.28E-06,0,0,3
diplomat,1,1.84E-06,1,2.28E-06,0,0,3
missions,1,1.84E-06,1,2.28E-06,0,0,2
interact,1,1.84E-06,1,2.28E-06,0,0,3
studends,1,1.84E-06,1,2.28E-06,0,0,2
lynching,1,1.84E-06,1,2.28E-06,0,0,2
bandaids,1,1.84E-06,1,2.28E-06,0,0,2
baseless,1,1.84E-06,1,2.28E-06,0,0,3
outraged,1,1.84E-06,1,2.28E-06,0,0,2
upstairs,1,1.84E-06,1,2.28E-06,0,0,2
coercion,1,1.84E-06,1,2.28E-06,0,0,2
deprived,1,1.84E-06,1,2.28E-06,0,0,2
hijacked,1,1.84E-06,1,2.28E-06,0,0,2
napoleon,1,1.84E-06,1,2.28E-06,0,0,3
kilmeade,1,1.84E-06,1,2.28E-06,0,0,2
kiriakou,1,1.84E-06,1,2.28E-06,0,0,3
chambers,1,1.84E-06,1,2.28E-06,0,0,2
felonies,1,1.84E-06,1,2.28E-06,0,0,3
quagmire,1,1.84E-06,1,2.28E-06,0,0,2
ruthless,1,1.84E-06,1,2.28E-06,0,0,2
extorted,1,1.84E-06,1,2.28E-06,0,0,2
apparent,1,1.84E-06,1,2.28E-06,0,0,3
plusplus,1,1.84E-06,1,2.28E-06,0,0,2
schiffty,1,1.84E-06,1,2.28E-06,0,0,2
euphoria,1,1.84E-06,1,2.28E-06,0,0,3
navistar,1,1.84E-06,1,2.28E-06,0,0,3
beijings,1,1.84E-06,1,2.28E-06,0,0,2
fracture,1,1.84E-06,1,2.28E-06,0,0,2
swirling,1,1.84E-06,1,2.28E-06,0,0,2
rivalpot,1,1.84E-06,1,2.28E-06,0,0,3
libeling,1,1.84E-06,1,2.28E-06,0,0,3
sounding,1,1.84E-06,1,2.28E-06,0,0,2
ofunless,1,1.84E-06,1,2.28E-06,0,0,3
thiswere,1,1.84E-06,1,2.28E-06,0,0,2
ukraines,1,1.84E-06,1,2.28E-06,0,0,2
involves,1,1.84E-06,1,2.28E-06,0,0,2
recommendeda,1,1.84E-06,1,2.28E-06,0,0,5
revoking,1,1.84E-06,1,2.28E-06,0,0,3
enclaves,1,1.84E-06,1,2.28E-06,0,0,2
almighty,1,1.84E-06,1,2.28E-06,0,0,3
exporter,1,1.84E-06,1,2.28E-06,0,0,3
kathleen,1,1.84E-06,1,2.28E-06,0,0,2
musician,1,1.84E-06,1,2.28E-06,0,0,3
bookeven,1,1.84E-06,1,2.28E-06,0,0,3
forecast,1,1.84E-06,1,2.28E-06,0,0,3
unsigned,1,1.84E-06,1,2.28E-06,0,0,2
recision,1,1.84E-06,1,2.28E-06,0,0,3
redirect,1,1.84E-06,1,2.28E-06,0,0,3
discount,1,1.84E-06,1,2.28E-06,0,0,2
despised,1,1.84E-06,1,2.28E-06,0,0,2
trumpyou,1,1.84E-06,1,2.28E-06,0,0,3
anyplace,1,1.84E-06,1,2.28E-06,0,0,3
giuseppi,1,1.84E-06,1,2.28E-06,0,0,3
jokingly,1,1.84E-06,1,2.28E-06,0,0,3
carriers,1,1.84E-06,1,2.28E-06,0,0,2
competes,1,1.84E-06,1,2.28E-06,0,0,2
treading,1,1.84E-06,1,2.28E-06,0,0,2
cohesion,1,1.84E-06,1,2.28E-06,0,0,3
reptlaib,1,1.84E-06,1,2.28E-06,0,0,2
envelope,1,1.84E-06,1,2.28E-06,0,0,3
deferral,1,1.84E-06,1,2.28E-06,0,0,3
inverted,1,1.84E-06,1,2.28E-06,0,0,2
unsealed,1,1.84E-06,1,2.28E-06,0,0,2
amazingo,1,1.84E-06,1,2.28E-06,0,0,4
marrying,1,1.84E-06,1,2.28E-06,0,0,2
chariman,1,1.84E-06,1,2.28E-06,0,0,3
sinkhole,1,1.84E-06,1,2.28E-06,0,0,3
truedoes,1,1.84E-06,1,2.28E-06,0,0,2
measured,1,1.84E-06,1,2.28E-06,0,0,2
sharpton,1,1.84E-06,1,2.28E-06,0,0,2
homicide,1,1.84E-06,1,2.28E-06,0,0,3
athletic,1,1.84E-06,1,2.28E-06,0,0,3
hypothetical,1,1.84E-06,1,2.28E-06,0,0,5
severino,1,1.84E-06,1,2.28E-06,0,0,4
brandons,1,1.84E-06,1,2.28E-06,0,0,2
drumbeat,1,1.84E-06,1,2.28E-06,0,0,2
tendered,1,1.84E-06,1,2.28E-06,0,0,2
volatile,1,1.84E-06,1,2.28E-06,0,0,4
inhumane,1,1.84E-06,1,2.28E-06,0,0,3
maligned,1,1.84E-06,1,2.28E-06,0,0,2
deutsche,1,1.84E-06,1,2.28E-06,0,0,1
nbcmsnbc,1,1.84E-06,1,2.28E-06,0,0,#ERROR!
breached,1,1.84E-06,1,2.28E-06,0,0,1
mercedes,1,1.84E-06,1,2.28E-06,0,0,2
kazianis,1,1.84E-06,1,2.28E-06,0,0,3
ratified,1,1.84E-06,1,2.28E-06,0,0,3
woodland,1,1.84E-06,1,2.28E-06,0,0,2
lockhead,1,1.84E-06,1,2.28E-06,0,0,2
issuance,1,1.84E-06,1,2.28E-06,0,0,2
episodes,1,1.84E-06,1,2.28E-06,0,0,3
promotes,1,1.84E-06,1,2.28E-06,0,0,2
bluffing,1,1.84E-06,1,2.28E-06,0,0,2
shackles,1,1.84E-06,1,2.28E-06,0,0,2
shipment,1,1.84E-06,1,2.28E-06,0,0,2
butchery,1,1.84E-06,1,2.28E-06,0,0,3
taxation,1,1.84E-06,1,2.28E-06,0,0,3
imprison,1,1.84E-06,1,2.28E-06,0,0,3
ryÅgoku,1,1.84E-06,1,2.28E-06,0,0,3
jokester,1,1.84E-06,1,2.28E-06,0,0,3
soliders,1,1.84E-06,1,2.28E-06,0,0,3
sledgehammer,1,1.84E-06,1,2.28E-06,0,0,4
refinish,1,1.84E-06,1,2.28E-06,0,0,3
squander,1,1.84E-06,1,2.28E-06,0,0,2
forgiven,1,1.84E-06,1,2.28E-06,0,0,3
footings,1,1.84E-06,1,2.28E-06,0,0,2
realtors,1,1.84E-06,1,2.28E-06,0,0,2
gangthat,1,1.84E-06,1,2.28E-06,0,0,2
jobsjobs,1,1.84E-06,1,2.28E-06,0,0,2
wondrous,1,1.84E-06,1,2.28E-06,0,0,2
candidat,1,1.84E-06,1,2.28E-06,0,0,3
diblasio,1,1.84E-06,1,2.28E-06,0,0,3
terroist,1,1.84E-06,1,2.28E-06,0,0,2
sirisena,1,1.84E-06,1,2.28E-06,0,0,4
liedmany,1,1.84E-06,1,2.28E-06,0,0,3
gaslight,1,1.84E-06,1,2.28E-06,0,0,2
dossiers,1,1.84E-06,1,2.28E-06,0,0,2
branding,1,1.84E-06,1,2.28E-06,0,0,2
populist,1,1.84E-06,1,2.28E-06,0,0,3
countrty,1,1.84E-06,1,2.28E-06,0,0,2
kirstjen,1,1.84E-06,1,2.28E-06,0,0,2
abducted,1,1.84E-06,1,2.28E-06,0,0,2
carranza,1,1.84E-06,1,2.28E-06,0,0,3
repjerry,1,1.84E-06,1,2.28E-06,0,0,3
mainstay,1,1.84E-06,1,2.28E-06,0,0,2
dirtiest,1,1.84E-06,1,2.28E-06,0,0,2
unproven,1,1.84E-06,1,2.28E-06,0,0,3
einstein,1,1.84E-06,1,2.28E-06,0,0,2
timapple,1,1.84E-06,1,2.28E-06,0,0,3
finalist,1,1.84E-06,1,2.28E-06,0,0,3
veterani,1,1.84E-06,1,2.28E-06,0,0,4
degraded,1,1.84E-06,1,2.28E-06,0,0,2
authenticated,1,1.84E-06,1,2.28E-06,0,0,4
resuming,1,1.84E-06,1,2.28E-06,0,0,3
guessing,1,1.84E-06,1,2.28E-06,0,0,2
captives,1,1.84E-06,1,2.28E-06,0,0,2
bathroom,1,1.84E-06,1,2.28E-06,0,0,2
dilanian,1,1.84E-06,1,2.28E-06,0,0,3
infusion,1,1.84E-06,1,2.28E-06,0,0,3
permeate,1,1.84E-06,1,2.28E-06,0,0,2
paradise,1,1.84E-06,1,2.28E-06,0,0,3
blizzard,1,1.84E-06,1,2.28E-06,0,0,2
freezing,1,1.84E-06,1,2.28E-06,0,0,2
muderers,1,1.84E-06,1,2.28E-06,0,0,3
displays,1,1.84E-06,1,2.28E-06,0,0,2
bestowed,1,1.84E-06,1,2.28E-06,0,0,2
huffpost,1,1.84E-06,1,2.28E-06,0,0,2
downturn,1,1.84E-06,1,2.28E-06,0,0,2
dantonio,1,1.84E-06,1,2.28E-06,0,0,3
marianos,1,1.84E-06,1,2.28E-06,0,0,3
godthank,1,1.84E-06,1,2.28E-06,0,0,2
prayersa,1,1.84E-06,1,2.28E-06,0,0,3
buchanan,1,1.84E-06,1,2.28E-06,0,0,3
communicator,1,1.84E-06,1,2.28E-06,0,0,5
decommission,1,1.84E-06,1,2.28E-06,0,0,4
commemorative,1,1.84E-06,0,0,9.47E-06,1,5
authentication,1,1.84E-06,1,2.28E-06,0,0,5
telecommunications,1,1.84E-06,1,2.28E-06,0,0,7
framework,1,1.84E-06,0,0,9.47E-06,1,3
checklist,1,1.84E-06,0,0,9.47E-06,1,2
monthsbut,1,1.84E-06,0,0,9.47E-06,1,2
recurring,1,1.84E-06,0,0,9.47E-06,1,3
shotenter,1,1.84E-06,0,0,9.47E-06,1,3
resorting,1,1.84E-06,0,0,9.47E-06,1,3
plausible,1,1.84E-06,0,0,9.47E-06,1,3
offenders,1,1.84E-06,0,0,9.47E-06,1,3
underpaid,1,1.84E-06,0,0,9.47E-06,1,3
lovethats,1,1.84E-06,0,0,9.47E-06,1,3
fightshow,1,1.84E-06,0,0,9.47E-06,1,2
soarswhen,1,1.84E-06,0,0,9.47E-06,1,2
affecting,1,1.84E-06,0,0,9.47E-06,1,3
landscape,1,1.84E-06,0,0,9.47E-06,1,2
generates,1,1.84E-06,0,0,9.47E-06,1,3
punchline,1,1.84E-06,0,0,9.47E-06,1,2
posturing,1,1.84E-06,0,0,9.47E-06,1,3
practical,1,1.84E-06,0,0,9.47E-06,1,3
lifetimes,1,1.84E-06,0,0,9.47E-06,1,3
systemnow,1,1.84E-06,0,0,9.47E-06,1,3
backsjust,1,1.84E-06,0,0,9.47E-06,1,2
centuries,1,1.84E-06,0,0,9.47E-06,1,3
concludes,1,1.84E-06,0,0,9.47E-06,1,2
childcare,1,1.84E-06,0,0,9.47E-06,1,2
skydiving,1,1.84E-06,0,0,9.47E-06,1,3
solarmore,1,1.84E-06,0,0,9.47E-06,1,3
catholics,1,1.84E-06,0,0,9.47E-06,1,3
reformfor,1,1.84E-06,0,0,9.47E-06,1,3
groundhog,1,1.84E-06,0,0,9.47E-06,1,2
dayexcept,1,1.84E-06,0,0,9.47E-06,1,3
problembe,1,1.84E-06,0,0,9.47E-06,1,2
startedif,1,1.84E-06,0,0,9.47E-06,1,3
careyoure,1,1.84E-06,0,0,9.47E-06,1,3
forgiving,1,1.84E-06,0,0,9.47E-06,1,3
investors,1,1.84E-06,0,0,9.47E-06,1,3
valentine,1,1.84E-06,0,0,9.47E-06,1,3
aheadmake,1,1.84E-06,0,0,9.47E-06,1,3
coworkers,1,1.84E-06,0,0,9.47E-06,1,3
translate,1,1.84E-06,0,0,9.47E-06,1,2
rightsbut,1,1.84E-06,0,0,9.47E-06,1,2
pediatric,1,1.84E-06,0,0,9.47E-06,1,3
largeness,1,1.84E-06,0,0,9.47E-06,1,3
remembers,1,1.84E-06,0,0,9.47E-06,1,3
teenagers,1,1.84E-06,0,0,9.47E-06,1,3
overjoyed,1,1.84E-06,0,0,9.47E-06,1,3
obsession,1,1.84E-06,0,0,9.47E-06,1,3
careening,1,1.84E-06,0,0,9.47E-06,1,3
onlineyou,1,1.84E-06,0,0,9.47E-06,1,4
columbine,1,1.84E-06,0,0,9.47E-06,1,3
discounts,1,1.84E-06,0,0,9.47E-06,1,2
alejandro,1,1.84E-06,0,0,9.47E-06,1,4
ignorance,1,1.84E-06,0,0,9.47E-06,1,3
cambridge,1,1.84E-06,0,0,9.47E-06,1,2
decreased,1,1.84E-06,0,0,9.47E-06,1,2
evilthats,1,1.84E-06,0,0,9.47E-06,1,3
childisnt,1,1.84E-06,0,0,9.47E-06,1,2
thatchers,1,1.84E-06,0,0,9.47E-06,1,2
newsflash,1,1.84E-06,0,0,9.47E-06,1,2
amplifies,1,1.84E-06,0,0,9.47E-06,1,3
countryon,1,1.84E-06,0,0,9.47E-06,1,2
imperfect,1,1.84E-06,0,0,9.47E-06,1,3
spectacle,1,1.84E-06,0,0,9.47E-06,1,3
perpetual,1,1.84E-06,0,0,9.47E-06,1,3
conscious,1,1.84E-06,0,0,9.47E-06,1,3
thanksnot,1,1.84E-06,0,0,9.47E-06,1,2
lakethats,1,1.84E-06,0,0,9.47E-06,1,3
schoolamy,1,1.84E-06,0,0,9.47E-06,1,3
bachelors,1,1.84E-06,0,0,9.47E-06,1,3
voiceshad,1,1.84E-06,0,0,9.47E-06,1,3
equalizer,1,1.84E-06,0,0,9.47E-06,1,4
firehouse,1,1.84E-06,0,0,9.47E-06,1,3
mourdocks,1,1.84E-06,0,0,9.47E-06,1,2
premature,1,1.84E-06,0,0,9.47E-06,1,3
refocused,1,1.84E-06,0,0,9.47E-06,1,3
virginian,1,1.84E-06,0,0,9.47E-06,1,3
choosebut,1,1.84E-06,0,0,9.47E-06,1,3
issuethis,1,1.84E-06,0,0,9.47E-06,1,3
clipboard,1,1.84E-06,0,0,9.47E-06,1,2
todayyour,1,1.84E-06,0,0,9.47E-06,1,4
reformaka,1,1.84E-06,0,0,9.47E-06,1,4
constance,1,1.84E-06,0,0,9.47E-06,1,2
crocodile,1,1.84E-06,0,0,9.47E-06,1,4
stupidest,1,1.84E-06,0,0,9.47E-06,1,3
schoolsim,1,1.84E-06,0,0,9.47E-06,1,2
describes,1,1.84E-06,0,0,9.47E-06,1,2
hugethank,1,1.84E-06,0,0,9.47E-06,1,3
outraised,1,1.84E-06,0,0,9.47E-06,1,2
homegrown,1,1.84E-06,0,0,9.47E-06,1,3
armstrong,1,1.84E-06,0,0,9.47E-06,1,2
audiences,1,1.84E-06,0,0,9.47E-06,1,2
placement,1,1.84E-06,0,0,9.47E-06,1,3
choicehes,1,1.84E-06,0,0,9.47E-06,1,2
textbooks,1,1.84E-06,0,0,9.47E-06,1,2
heroesusa,1,1.84E-06,0,0,9.47E-06,1,4
featuring,1,1.84E-06,0,0,9.47E-06,1,3
jumpstart,1,1.84E-06,0,0,9.47E-06,1,2
laptopget,1,1.84E-06,0,0,9.47E-06,1,3
adstaking,1,1.84E-06,0,0,9.47E-06,1,3
advocates,1,1.84E-06,0,0,9.47E-06,1,3
departure,1,1.84E-06,0,0,9.47E-06,1,3
rightwhen,1,1.84E-06,0,0,9.47E-06,1,2
alivejust,1,1.84E-06,0,0,9.47E-06,1,4
artifacts,1,1.84E-06,0,0,9.47E-06,1,3
responder,1,1.84E-06,0,0,9.47E-06,1,3
predictor,1,1.84E-06,0,0,9.47E-06,1,3
automaker,1,1.84E-06,0,0,9.47E-06,1,4
oversized,1,1.84E-06,0,0,9.47E-06,1,3
superhero,1,1.84E-06,0,0,9.47E-06,1,4
authorize,1,1.84E-06,0,0,9.47E-06,1,3
taxesless,1,1.84E-06,0,0,9.47E-06,1,3
toosounds,1,1.84E-06,0,0,9.47E-06,1,2
pinterest,1,1.84E-06,0,0,9.47E-06,1,3
finepotus,1,1.84E-06,0,0,9.47E-06,1,4
enlighten,1,1.84E-06,0,0,9.47E-06,1,3
forefront,1,1.84E-06,0,0,9.47E-06,1,3
industrys,1,1.84E-06,0,0,9.47E-06,1,3
againthis,1,1.84E-06,0,0,9.47E-06,1,3
bookmarks,1,1.84E-06,0,0,9.47E-06,1,2
scientist,1,1.84E-06,0,0,9.47E-06,1,2
corrosive,1,1.84E-06,0,0,9.47E-06,1,3
peacetime,1,1.84E-06,0,0,9.47E-06,1,3
surcharge,1,1.84E-06,0,0,9.47E-06,1,2
ornaments,1,1.84E-06,0,0,9.47E-06,1,3
shortages,1,1.84E-06,0,0,9.47E-06,1,2
irenemake,1,1.84E-06,0,0,9.47E-06,1,4
slideshow,1,1.84E-06,0,0,9.47E-06,1,3
dampening,1,1.84E-06,0,0,9.47E-06,1,3
geraldine,1,1.84E-06,0,0,9.47E-06,1,3
holbrooke,1,1.84E-06,0,0,9.47E-06,1,2
canvasses,1,1.84E-06,0,0,9.47E-06,1,2
overcomes,1,1.84E-06,0,0,9.47E-06,1,3
deceptive,1,1.84E-06,0,0,9.47E-06,1,3
naysayers,1,1.84E-06,0,0,9.47E-06,1,3
takeovers,1,1.84E-06,0,0,9.47E-06,1,3
appealing,1,1.84E-06,0,0,9.47E-06,1,3
designate,1,1.84E-06,0,0,9.47E-06,1,3
teamyoure,1,1.84E-06,0,0,9.47E-06,1,3
kalamazoo,1,1.84E-06,0,0,9.47E-06,1,4
lieberman,1,1.84E-06,0,0,9.47E-06,1,3
kaczynski,1,1.84E-06,0,0,9.47E-06,1,3
culminate,1,1.84E-06,0,0,9.47E-06,1,3
vancouver,1,1.84E-06,0,0,9.47E-06,1,3
thisvicki,1,1.84E-06,0,0,9.47E-06,1,3
begintune,1,1.84E-06,0,0,9.47E-06,1,3
newshouse,1,1.84E-06,0,0,9.47E-06,1,2
bickering,1,1.84E-06,0,0,9.47E-06,1,3
primetime,1,1.84E-06,0,0,9.47E-06,1,3
fractured,1,1.84E-06,0,0,9.47E-06,1,2
inundated,1,1.84E-06,1,2.28E-06,0,0,3
lategreat,1,1.84E-06,1,2.28E-06,0,0,3
decertify,1,1.84E-06,1,2.28E-06,0,0,4
mastriano,1,1.84E-06,1,2.28E-06,0,0,3
epidemics,1,1.84E-06,1,2.28E-06,0,0,4
pandemics,1,1.84E-06,1,2.28E-06,0,0,3
partnered,1,1.84E-06,1,2.28E-06,0,0,2
pashinyan,1,1.84E-06,1,2.28E-06,0,0,3
frivolous,1,1.84E-06,1,2.28E-06,0,0,3
obstinate,1,1.84E-06,1,2.28E-06,0,0,3
uncounted,1,1.84E-06,1,2.28E-06,0,0,2
giancarlo,1,1.84E-06,1,2.28E-06,0,0,3
preaching,1,1.84E-06,1,2.28E-06,0,0,2
springing,1,1.84E-06,1,2.28E-06,0,0,2
schoolnow,1,1.84E-06,1,2.28E-06,0,0,2
jonesboro,1,1.84E-06,1,2.28E-06,0,0,4
confiding,1,1.84E-06,1,2.28E-06,0,0,3
valuesget,1,1.84E-06,1,2.28E-06,0,0,3
shredding,1,1.84E-06,1,2.28E-06,0,0,2
screening,1,1.84E-06,1,2.28E-06,0,0,2
restricts,1,1.84E-06,1,2.28E-06,0,0,2
clubhouse,1,1.84E-06,1,2.28E-06,0,0,2
relegated,1,1.84E-06,1,2.28E-06,0,0,3
revolving,1,1.84E-06,1,2.28E-06,0,0,3
rejection,1,1.84E-06,1,2.28E-06,0,0,3
minuscule,1,1.84E-06,1,2.28E-06,0,0,4
jihadists,1,1.84E-06,1,2.28E-06,0,0,3
georgians,1,1.84E-06,1,2.28E-06,0,0,2
unleashed,1,1.84E-06,1,2.28E-06,0,0,2
verifying,1,1.84E-06,1,2.28E-06,0,0,3
intervene,1,1.84E-06,1,2.28E-06,0,0,3
exclusion,1,1.84E-06,1,2.28E-06,0,0,3
chickened,1,1.84E-06,1,2.28E-06,0,0,2
skyrocket,1,1.84E-06,1,2.28E-06,0,0,3
offshored,1,1.84E-06,1,2.28E-06,0,0,2
preservar,1,1.84E-06,1,2.28E-06,0,0,3
comunidad,1,1.84E-06,1,2.28E-06,0,0,4
arizonawe,1,1.84E-06,1,2.28E-06,0,0,4
sentinels,1,1.84E-06,1,2.28E-06,0,0,3
primaried,1,1.84E-06,1,2.28E-06,0,0,3
cardboard,1,1.84E-06,1,2.28E-06,0,0,2
intervals,1,1.84E-06,1,2.28E-06,0,0,3
discovers,1,1.84E-06,1,2.28E-06,0,0,3
energetic,1,1.84E-06,1,2.28E-06,0,0,4
troubling,1,1.84E-06,1,2.28E-06,0,0,2
inoculate,1,1.84E-06,1,2.28E-06,0,0,4
objecting,1,1.84E-06,1,2.28E-06,0,0,3
campaigna,1,1.84E-06,1,2.28E-06,0,0,3
medicarea,1,1.84E-06,1,2.28E-06,0,0,4
descended,1,1.84E-06,1,2.28E-06,0,0,2
valiantly,1,1.84E-06,1,2.28E-06,0,0,3
winschina,1,1.84E-06,1,2.28E-06,0,0,3
paragraph,1,1.84E-06,1,2.28E-06,0,0,3
untrusted,1,1.84E-06,1,2.28E-06,0,0,2
depriving,1,1.84E-06,1,2.28E-06,0,0,3
anchorman,1,1.84E-06,1,2.28E-06,0,0,3
sterilize,1,1.84E-06,1,2.28E-06,0,0,3
repayment,1,1.84E-06,1,2.28E-06,0,0,3
stripping,1,1.84E-06,1,2.28E-06,0,0,2
macdonald,1,1.84E-06,1,2.28E-06,0,0,3
middlemen,1,1.84E-06,1,2.28E-06,0,0,3
hypocrisy,1,1.84E-06,1,2.28E-06,0,0,4
exporters,1,1.84E-06,1,2.28E-06,0,0,3
gilcrease,1,1.84E-06,1,2.28E-06,0,0,2
spokesman,1,1.84E-06,1,2.28E-06,0,0,3
warmonger,1,1.84E-06,1,2.28E-06,0,0,3
disbursed,1,1.84E-06,1,2.28E-06,0,0,2
dismissal,1,1.84E-06,1,2.28E-06,0,0,3
ststement,1,1.84E-06,1,2.28E-06,0,0,2
tentative,1,1.84E-06,1,2.28E-06,0,0,3
languages,1,1.84E-06,1,2.28E-06,0,0,2
misplaced,1,1.84E-06,1,2.28E-06,0,0,2
lucrative,1,1.84E-06,1,2.28E-06,0,0,3
housewife,1,1.84E-06,1,2.28E-06,0,0,3
riverside,1,1.84E-06,1,2.28E-06,0,0,3
sidelined,1,1.84E-06,1,2.28E-06,0,0,3
plentiful,1,1.84E-06,1,2.28E-06,0,0,3
mailboxes,1,1.84E-06,1,2.28E-06,0,0,2
forgeries,1,1.84E-06,1,2.28E-06,0,0,3
brownouts,1,1.84E-06,1,2.28E-06,0,0,2
depressed,1,1.84E-06,1,2.28E-06,0,0,2
enforcers,1,1.84E-06,1,2.28E-06,0,0,3
surprises,1,1.84E-06,1,2.28E-06,0,0,2
faltering,1,1.84E-06,1,2.28E-06,0,0,3
exploring,1,1.84E-06,1,2.28E-06,0,0,3
spacewalk,1,1.84E-06,1,2.28E-06,0,0,3
depiction,1,1.84E-06,1,2.28E-06,0,0,3
specialty,1,1.84E-06,1,2.28E-06,0,0,3
disembark,1,1.84E-06,1,2.28E-06,0,0,3
fridaybig,1,1.84E-06,1,2.28E-06,0,0,3
clamoring,1,1.84E-06,1,2.28E-06,0,0,3
defenders,1,1.84E-06,1,2.28E-06,0,0,3
tropicana,1,1.84E-06,1,2.28E-06,0,0,4
westerdam,1,1.84E-06,1,2.28E-06,0,0,3
construct,1,1.84E-06,1,2.28E-06,0,0,2
penobscot,1,1.84E-06,1,2.28E-06,0,0,3
indulgent,1,1.84E-06,1,2.28E-06,0,0,3
foolhardy,1,1.84E-06,1,2.28E-06,0,0,3
grievance,1,1.84E-06,1,2.28E-06,0,0,2
yoshihide,1,1.84E-06,1,2.28E-06,0,0,3
exchanges,1,1.84E-06,1,2.28E-06,0,0,2
murdering,1,1.84E-06,1,2.28E-06,0,0,3
differing,1,1.84E-06,1,2.28E-06,0,0,3
woodwards,1,1.84E-06,1,2.28E-06,0,0,2
heartless,1,1.84E-06,1,2.28E-06,0,0,2
regulated,1,1.84E-06,1,2.28E-06,0,0,3
endangers,1,1.84E-06,1,2.28E-06,0,0,3
creepster,1,1.84E-06,1,2.28E-06,0,0,2
pertinent,1,1.84E-06,1,2.28E-06,0,0,3
debartolo,1,1.84E-06,1,2.28E-06,0,0,4
democrsts,1,1.84E-06,1,2.28E-06,0,0,2
chastised,1,1.84E-06,1,2.28E-06,0,0,2
riggleman,1,1.84E-06,1,2.28E-06,0,0,3
breaching,1,1.84E-06,1,2.28E-06,0,0,2
associate,1,1.84E-06,1,2.28E-06,0,0,3
endeavors,1,1.84E-06,1,2.28E-06,0,0,3
turbulent,1,1.84E-06,1,2.28E-06,0,0,3
perfected,1,1.84E-06,1,2.28E-06,0,0,2
frederick,1,1.84E-06,1,2.28E-06,0,0,3
leveraged,1,1.84E-06,1,2.28E-06,0,0,3
supremest,1,1.84E-06,1,2.28E-06,0,0,3
repressed,1,1.84E-06,1,2.28E-06,0,0,2
passwords,1,1.84E-06,1,2.28E-06,0,0,2
pressures,1,1.84E-06,1,2.28E-06,0,0,2
impartial,1,1.84E-06,1,2.28E-06,0,0,3
replenish,1,1.84E-06,1,2.28E-06,0,0,3
showdavid,1,1.84E-06,1,2.28E-06,0,0,3
fbirussia,1,1.84E-06,1,2.28E-06,0,0,3
caughtbut,1,1.84E-06,1,2.28E-06,0,0,2
deference,1,1.84E-06,1,2.28E-06,0,0,3
repudiate,1,1.84E-06,1,2.28E-06,0,0,3
boundless,1,1.84E-06,1,2.28E-06,0,0,2
taiwanese,1,1.84E-06,1,2.28E-06,0,0,3
treasured,1,1.84E-06,1,2.28E-06,0,0,2
supremely,1,1.84E-06,1,2.28E-06,0,0,4
foresight,1,1.84E-06,1,2.28E-06,0,0,3
deadheads,1,1.84E-06,1,2.28E-06,0,0,2
sabotaged,1,1.84E-06,1,2.28E-06,0,0,3
christine,1,1.84E-06,1,2.28E-06,0,0,2
princeton,1,1.84E-06,1,2.28E-06,0,0,3
showcased,1,1.84E-06,1,2.28E-06,0,0,2
gianforte,1,1.84E-06,1,2.28E-06,0,0,2
palestine,1,1.84E-06,1,2.28E-06,0,0,3
complains,1,1.84E-06,1,2.28E-06,0,0,2
wrestling,1,1.84E-06,1,2.28E-06,0,0,2
worsening,1,1.84E-06,1,2.28E-06,0,0,3
offshoots,1,1.84E-06,1,2.28E-06,0,0,2
arresting,1,1.84E-06,1,2.28E-06,0,0,3
danielson,1,1.84E-06,1,2.28E-06,0,0,3
normalize,1,1.84E-06,1,2.28E-06,0,0,3
salacious,1,1.84E-06,1,2.28E-06,0,0,4
atlantics,1,1.84E-06,1,2.28E-06,0,0,3
sightings,1,1.84E-06,1,2.28E-06,0,0,2
formulate,1,1.84E-06,1,2.28E-06,0,0,3
endowment,1,1.84E-06,1,2.28E-06,0,0,3
diagnosis,1,1.84E-06,1,2.28E-06,0,0,3
detainees,1,1.84E-06,1,2.28E-06,0,0,3
jonesport,1,1.84E-06,1,2.28E-06,0,0,3
disavowed,1,1.84E-06,1,2.28E-06,0,0,3
limelight,1,1.84E-06,1,2.28E-06,0,0,3
heartache,1,1.84E-06,1,2.28E-06,0,0,2
unfixable,1,1.84E-06,1,2.28E-06,0,0,4
hernandez,1,1.84E-06,1,2.28E-06,0,0,3
fischbach,1,1.84E-06,1,2.28E-06,0,0,2
hamberger,1,1.84E-06,1,2.28E-06,0,0,3
hamburger,1,1.84E-06,1,2.28E-06,0,0,3
betrayals,1,1.84E-06,1,2.28E-06,0,0,3
distanced,1,1.84E-06,1,2.28E-06,0,0,2
clementes,1,1.84E-06,1,2.28E-06,0,0,2
protester,1,1.84E-06,1,2.28E-06,0,0,3
fictional,1,1.84E-06,1,2.28E-06,0,0,3
caligiuri,1,1.84E-06,1,2.28E-06,0,0,4
undecided,1,1.84E-06,1,2.28E-06,0,0,3
temporary,1,1.84E-06,1,2.28E-06,0,0,4
texarkana,1,1.84E-06,1,2.28E-06,0,0,4
lifestyle,1,1.84E-06,1,2.28E-06,0,0,4
breakouts,1,1.84E-06,1,2.28E-06,0,0,2
entrapped,1,1.84E-06,1,2.28E-06,0,0,2
colombian,1,1.84E-06,1,2.28E-06,0,0,3
sponsored,1,1.84E-06,1,2.28E-06,0,0,2
occurring,1,1.84E-06,1,2.28E-06,0,0,3
compiling,1,1.84E-06,1,2.28E-06,0,0,3
showering,1,1.84E-06,1,2.28E-06,0,0,3
expensing,1,1.84E-06,1,2.28E-06,0,0,3
heartbeat,1,1.84E-06,1,2.28E-06,0,0,2
bluethank,1,1.84E-06,1,2.28E-06,0,0,2
roomtoday,1,1.84E-06,1,2.28E-06,0,0,3
explorers,1,1.84E-06,1,2.28E-06,0,0,3
inventors,1,1.84E-06,1,2.28E-06,0,0,3
lifemerry,1,1.84E-06,1,2.28E-06,0,0,4
harrowing,1,1.84E-06,1,2.28E-06,0,0,3
escalante,1,1.84E-06,1,2.28E-06,0,0,3
enactment,1,1.84E-06,1,2.28E-06,0,0,3
condemned,1,1.84E-06,1,2.28E-06,0,0,2
excluding,1,1.84E-06,1,2.28E-06,0,0,3
drumstick,1,1.84E-06,1,2.28E-06,0,0,2
elephants,1,1.84E-06,1,2.28E-06,0,0,3
mechanism,1,1.84E-06,1,2.28E-06,0,0,3
destinies,1,1.84E-06,1,2.28E-06,0,0,3
memorable,1,1.84E-06,1,2.28E-06,0,0,4
restraint,1,1.84E-06,1,2.28E-06,0,0,2
rejoining,1,1.84E-06,1,2.28E-06,0,0,3
assurance,1,1.84E-06,1,2.28E-06,0,0,3
humphreys,1,1.84E-06,1,2.28E-06,0,0,2
matsuyama,1,1.84E-06,1,2.28E-06,0,0,4
broadcoms,1,1.84E-06,1,2.28E-06,0,0,2
manaforts,1,1.84E-06,1,2.28E-06,0,0,3
anxiously,1,1.84E-06,1,2.28E-06,0,0,4
bartiromo,1,1.84E-06,1,2.28E-06,0,0,4
assertion,1,1.84E-06,1,2.28E-06,0,0,3
hencefake,1,1.84E-06,1,2.28E-06,0,0,3
koreastay,1,1.84E-06,1,2.28E-06,0,0,3
yearsmust,1,1.84E-06,1,2.28E-06,0,0,2
reformtax,1,1.84E-06,1,2.28E-06,0,0,3
ferocious,1,1.84E-06,1,2.28E-06,0,0,4
combatant,1,1.84E-06,1,2.28E-06,0,0,3
barcelona,1,1.84E-06,1,2.28E-06,0,0,4
councilhe,1,1.84E-06,1,2.28E-06,0,0,2
excessive,1,1.84E-06,1,2.28E-06,0,0,3
roarwatch,1,1.84E-06,1,2.28E-06,0,0,2
torturing,1,1.84E-06,1,2.28E-06,0,0,3
invalides,1,1.84E-06,1,2.28E-06,0,0,3
evangelic,1,1.84E-06,1,2.28E-06,0,0,4
misstated,1,1.84E-06,1,2.28E-06,0,0,2
deadliest,1,1.84E-06,1,2.28E-06,0,0,2
scjustice,1,1.84E-06,1,2.28E-06,0,0,2
cubavideo,1,1.84E-06,1,2.28E-06,0,0,4
aggrieved,1,1.84E-06,1,2.28E-06,0,0,2
inclusion,1,1.84E-06,1,2.28E-06,0,0,3
islanders,1,1.84E-06,1,2.28E-06,0,0,3
donorsnew,1,1.84E-06,1,2.28E-06,0,0,3
gentiloni,1,1.84E-06,1,2.28E-06,0,0,4
enlisting,1,1.84E-06,1,2.28E-06,0,0,3
ingrained,1,1.84E-06,1,2.28E-06,0,0,2
engineers,1,1.84E-06,1,2.28E-06,0,0,3
taoiseach,1,1.84E-06,1,2.28E-06,0,0,3
wiedefeld,1,1.84E-06,1,2.28E-06,0,0,3
favorably,1,1.84E-06,1,2.28E-06,0,0,4
permeated,1,1.84E-06,1,2.28E-06,0,0,2
fbishould,1,1.84E-06,1,2.28E-06,0,0,2
emboldens,1,1.84E-06,1,2.28E-06,0,0,3
displayed,1,1.84E-06,1,2.28E-06,0,0,2
detective,1,1.84E-06,1,2.28E-06,0,0,3
actresses,1,1.84E-06,1,2.28E-06,0,0,2
scrapping,1,1.84E-06,1,2.28E-06,0,0,2
appointee,1,1.84E-06,1,2.28E-06,0,0,3
badmouths,1,1.84E-06,1,2.28E-06,0,0,2
detection,1,1.84E-06,1,2.28E-06,0,0,3
policeman,1,1.84E-06,1,2.28E-06,0,0,4
makeshift,1,1.84E-06,1,2.28E-06,0,0,3
weissmans,1,1.84E-06,1,2.28E-06,0,0,2
addictive,1,1.84E-06,1,2.28E-06,0,0,3
liquified,1,1.84E-06,1,2.28E-06,0,0,3
originals,1,1.84E-06,1,2.28E-06,0,0,4
tactician,1,1.84E-06,1,2.28E-06,0,0,3
monetized,1,1.84E-06,1,2.28E-06,0,0,3
argentine,1,1.84E-06,1,2.28E-06,0,0,3
gasparino,1,1.84E-06,1,2.28E-06,0,0,4
overtaken,1,1.84E-06,1,2.28E-06,0,0,4
evacuated,1,1.84E-06,1,2.28E-06,0,0,3
bloodiest,1,1.84E-06,1,2.28E-06,0,0,2
primarily,1,1.84E-06,1,2.28E-06,0,0,4
embracing,1,1.84E-06,1,2.28E-06,0,0,3
overtaxed,1,1.84E-06,1,2.28E-06,0,0,3
kavanough,1,1.84E-06,1,2.28E-06,0,0,3
southport,1,1.84E-06,1,2.28E-06,0,0,2
mobilized,1,1.84E-06,1,2.28E-06,0,0,3
relievers,1,1.84E-06,1,2.28E-06,0,0,3
sustained,1,1.84E-06,1,2.28E-06,0,0,2
sheltered,1,1.84E-06,1,2.28E-06,0,0,2
comparing,1,1.84E-06,1,2.28E-06,0,0,3
armistice,1,1.84E-06,1,2.28E-06,0,0,3
violators,1,1.84E-06,1,2.28E-06,0,0,3
unimpeded,1,1.84E-06,1,2.28E-06,0,0,3
barometer,1,1.84E-06,1,2.28E-06,0,0,4
hindrance,1,1.84E-06,1,2.28E-06,0,0,2
horseface,1,1.84E-06,1,2.28E-06,0,0,3
stapleton,1,1.84E-06,1,2.28E-06,0,0,3
reservoir,1,1.84E-06,1,2.28E-06,0,0,3
doorsteps,1,1.84E-06,1,2.28E-06,0,0,2
columbuss,1,1.84E-06,1,2.28E-06,0,0,3
adventure,1,1.84E-06,1,2.28E-06,0,0,3
navigator,1,1.84E-06,1,2.28E-06,0,0,4
pyongyang,1,1.84E-06,1,2.28E-06,0,0,2
onlookers,1,1.84E-06,1,2.28E-06,0,0,3
identical,1,1.84E-06,1,2.28E-06,0,0,4
glassdoor,1,1.84E-06,1,2.28E-06,0,0,2
perceived,1,1.84E-06,1,2.28E-06,0,0,2
thatstory,1,1.84E-06,1,2.28E-06,0,0,3
rodriguez,1,1.84E-06,1,2.28E-06,0,0,3
laundered,1,1.84E-06,1,2.28E-06,0,0,2
customary,1,1.84E-06,1,2.28E-06,0,0,4
incentive,1,1.84E-06,1,2.28E-06,0,0,3
unethical,1,1.84E-06,1,2.28E-06,0,0,4
exchanged,1,1.84E-06,1,2.28E-06,0,0,2
untouched,1,1.84E-06,1,2.28E-06,0,0,2
silencing,1,1.84E-06,1,2.28E-06,0,0,3
redaction,1,1.84E-06,1,2.28E-06,0,0,3
loudmouth,1,1.84E-06,1,2.28E-06,0,0,2
notoriety,1,1.84E-06,1,2.28E-06,0,0,4
reopening,1,1.84E-06,1,2.28E-06,0,0,3
believers,1,1.84E-06,1,2.28E-06,0,0,3
penalized,1,1.84E-06,1,2.28E-06,0,0,3
recapture,1,1.84E-06,1,2.28E-06,0,0,3
reimburse,1,1.84E-06,1,2.28E-06,0,0,2
discgrace,1,1.84E-06,1,2.28E-06,0,0,2
elelments,1,1.84E-06,1,2.28E-06,0,0,3
shameless,1,1.84E-06,1,2.28E-06,0,0,3
chronicle,1,1.84E-06,1,2.28E-06,0,0,3
finishing,1,1.84E-06,1,2.28E-06,0,0,3
humanized,1,1.84E-06,1,2.28E-06,0,0,3
insisting,1,1.84E-06,1,2.28E-06,0,0,3
applauded,1,1.84E-06,1,2.28E-06,0,0,2
violently,1,1.84E-06,1,2.28E-06,0,0,3
disciples,1,1.84E-06,1,2.28E-06,0,0,3
luxurious,1,1.84E-06,1,2.28E-06,0,0,4
contained,1,1.84E-06,1,2.28E-06,0,0,2
unhelpful,1,1.84E-06,1,2.28E-06,0,0,3
surpluses,1,1.84E-06,1,2.28E-06,0,0,2
thingsbut,1,1.84E-06,1,2.28E-06,0,0,2
afterward,1,1.84E-06,1,2.28E-06,0,0,3
backfires,1,1.84E-06,1,2.28E-06,0,0,2
journeyed,1,1.84E-06,1,2.28E-06,0,0,2
indelibly,1,1.84E-06,1,2.28E-06,0,0,4
separates,1,1.84E-06,1,2.28E-06,0,0,3
dossierhe,1,1.84E-06,1,2.28E-06,0,0,2
filtering,1,1.84E-06,1,2.28E-06,0,0,3
abundance,1,1.84E-06,1,2.28E-06,0,0,3
implanted,1,1.84E-06,1,2.28E-06,0,0,2
gentlemen,1,1.84E-06,1,2.28E-06,0,0,3
acquiring,1,1.84E-06,1,2.28E-06,0,0,3
earnhardt,1,1.84E-06,1,2.28E-06,0,0,2
bookbring,1,1.84E-06,1,2.28E-06,0,0,2
redacting,1,1.84E-06,1,2.28E-06,0,0,3
republics,1,1.84E-06,1,2.28E-06,0,0,3
sylvester,1,1.84E-06,1,2.28E-06,0,0,3
nursultan,1,1.84E-06,1,2.28E-06,0,0,3
grandkids,1,1.84E-06,1,2.28E-06,0,0,2
memembers,1,1.84E-06,1,2.28E-06,0,0,3
encircled,1,1.84E-06,1,2.28E-06,0,0,2
terrorize,1,1.84E-06,1,2.28E-06,0,0,3
disrepair,1,1.84E-06,1,2.28E-06,0,0,3
legalized,1,1.84E-06,1,2.28E-06,0,0,3
excoriate,1,1.84E-06,1,2.28E-06,0,0,3
unopposed,1,1.84E-06,1,2.28E-06,0,0,3
skeptical,1,1.84E-06,1,2.28E-06,0,0,3
concealed,1,1.84E-06,1,2.28E-06,0,0,2
religions,1,1.84E-06,1,2.28E-06,0,0,3
depletion,1,1.84E-06,1,2.28E-06,0,0,3
extensive,1,1.84E-06,1,2.28E-06,0,0,3
kissinger,1,1.84E-06,1,2.28E-06,0,0,3
accidents,1,1.84E-06,1,2.28E-06,0,0,3
conceived,1,1.84E-06,1,2.28E-06,0,0,2
tenacious,1,1.84E-06,1,2.28E-06,0,0,4
everthing,1,1.84E-06,1,2.28E-06,0,0,3
paperwork,1,1.84E-06,1,2.28E-06,0,0,3
whirlwind,1,1.84E-06,1,2.28E-06,0,0,2
pointless,1,1.84E-06,1,2.28E-06,0,0,2
televised,1,1.84E-06,1,2.28E-06,0,0,3
vacancies,1,1.84E-06,1,2.28E-06,0,0,3
unfounded,1,1.84E-06,1,2.28E-06,0,0,2
prystaiko,1,1.84E-06,1,2.28E-06,0,0,3
doemocrat,1,1.84E-06,1,2.28E-06,0,0,3
psychotic,1,1.84E-06,1,2.28E-06,0,0,3
kidnapped,1,1.84E-06,1,2.28E-06,0,0,2
zapotosky,1,1.84E-06,1,2.28E-06,0,0,4
momentous,1,1.84E-06,1,2.28E-06,0,0,3
ethiopian,1,1.84E-06,1,2.28E-06,0,0,3
testifies,1,1.84E-06,1,2.28E-06,0,0,3
statesbut,1,1.84E-06,1,2.28E-06,0,0,3
revisions,1,1.84E-06,1,2.28E-06,0,0,3
selecting,1,1.84E-06,1,2.28E-06,0,0,3
demosalso,1,1.84E-06,1,2.28E-06,0,0,4
sawbefore,1,1.84E-06,1,2.28E-06,0,0,3
precisely,1,1.84E-06,1,2.28E-06,0,0,4
hazardous,1,1.84E-06,1,2.28E-06,0,0,3
impacting,1,1.84E-06,1,2.28E-06,0,0,3
kiddingly,1,1.84E-06,1,2.28E-06,0,0,3
honestare,1,1.84E-06,1,2.28E-06,0,0,3
esperanto,1,1.84E-06,1,2.28E-06,0,0,4
tolerates,1,1.84E-06,1,2.28E-06,0,0,3
slaughter,1,1.84E-06,1,2.28E-06,0,0,2
household,1,1.84E-06,1,2.28E-06,0,0,3
selective,1,1.84E-06,1,2.28E-06,0,0,3
highlight,1,1.84E-06,1,2.28E-06,0,0,2
transcrpt,1,1.84E-06,1,2.28E-06,0,0,1
bonaparte,1,1.84E-06,1,2.28E-06,0,0,3
finalized,1,1.84E-06,1,2.28E-06,0,0,3
considers,1,1.84E-06,1,2.28E-06,0,0,3
bombmaker,1,1.84E-06,1,2.28E-06,0,0,3
volodymyr,1,1.84E-06,1,2.28E-06,0,0,4
blackmail,1,1.84E-06,1,2.28E-06,0,0,2
mandating,1,1.84E-06,1,2.28E-06,0,0,3
backdated,1,1.84E-06,1,2.28E-06,0,0,2
functions,1,1.84E-06,1,2.28E-06,0,0,2
negligent,1,1.84E-06,1,2.28E-06,0,0,3
johnathan,1,1.84E-06,1,2.28E-06,0,0,3
malicious,1,1.84E-06,1,2.28E-06,0,0,4
unfailing,1,1.84E-06,1,2.28E-06,0,0,3
grassleys,1,1.84E-06,1,2.28E-06,0,0,2
goalposts,1,1.84E-06,1,2.28E-06,0,0,2
barreling,1,1.84E-06,1,2.28E-06,0,0,3
netanyahu,1,1.84E-06,1,2.28E-06,0,0,4
boneheads,1,1.84E-06,1,2.28E-06,0,0,3
policemen,1,1.84E-06,1,2.28E-06,0,0,4
overruled,1,1.84E-06,1,2.28E-06,0,0,3
emanating,1,1.84E-06,1,2.28E-06,0,0,4
indicated,1,1.84E-06,1,2.28E-06,0,0,3
ominously,1,1.84E-06,1,2.28E-06,0,0,4
blacklist,1,1.84E-06,1,2.28E-06,0,0,2
dastardly,1,1.84E-06,1,2.28E-06,0,0,3
terrified,1,1.84E-06,1,2.28E-06,0,0,3
espionage,1,1.84E-06,1,2.28E-06,0,0,3
speculate,1,1.84E-06,1,2.28E-06,0,0,3
coincides,1,1.84E-06,1,2.28E-06,0,0,2
assailing,1,1.84E-06,1,2.28E-06,0,0,3
admirably,1,1.84E-06,1,2.28E-06,0,0,4
wikileaks,1,1.84E-06,1,2.28E-06,0,0,3
overturns,1,1.84E-06,1,2.28E-06,0,0,3
sincerely,1,1.84E-06,1,2.28E-06,0,0,4
misguided,1,1.84E-06,1,2.28E-06,0,0,2
boomerang,1,1.84E-06,1,2.28E-06,0,0,3
benjamins,1,1.84E-06,1,2.28E-06,0,0,3
unbridled,1,1.84E-06,1,2.28E-06,0,0,2
similarly,1,1.84E-06,1,2.28E-06,0,0,4
estuaries,1,1.84E-06,1,2.28E-06,0,0,3
thursdays,1,1.84E-06,1,2.28E-06,0,0,2
modulated,1,1.84E-06,1,2.28E-06,0,0,3
indemnify,1,1.84E-06,1,2.28E-06,0,0,4
harassing,1,1.84E-06,1,2.28E-06,0,0,3
borderdmz,1,1.84E-06,1,2.28E-06,0,0,2
mightiest,1,1.84E-06,1,2.28E-06,0,0,2
retaliate,1,1.84E-06,1,2.28E-06,0,0,3
compliant,1,1.84E-06,1,2.28E-06,0,0,2
incidents,1,1.84E-06,1,2.28E-06,0,0,3
slightest,1,1.84E-06,1,2.28E-06,0,0,2
gohowever,1,1.84E-06,1,2.28E-06,0,0,4
exemplary,1,1.84E-06,1,2.28E-06,0,0,4
landmarks,1,1.84E-06,1,2.28E-06,0,0,2
omissions,1,1.84E-06,1,2.28E-06,0,0,3
ludicrous,1,1.84E-06,1,2.28E-06,0,0,3
kokugikan,1,1.84E-06,1,2.28E-06,0,0,4
asanoyama,1,1.84E-06,1,2.28E-06,0,0,5
predicate,1,1.84E-06,1,2.28E-06,0,0,3
delegated,1,1.84E-06,1,2.28E-06,0,0,3
biography,1,1.84E-06,1,2.28E-06,0,0,3
wealthier,1,1.84E-06,1,2.28E-06,0,0,2
hackberry,1,1.84E-06,1,2.28E-06,0,0,3
watershed,1,1.84E-06,1,2.28E-06,0,0,2
explanati,1,1.84E-06,1,2.28E-06,0,0,4
admirable,1,1.84E-06,1,2.28E-06,0,0,4
disregard,1,1.84E-06,1,2.28E-06,0,0,3
workhorse,1,1.84E-06,1,2.28E-06,0,0,2
trophyfor,1,1.84E-06,1,2.28E-06,0,0,3
goodgreat,1,1.84E-06,1,2.28E-06,0,0,2
goldstein,1,1.84E-06,1,2.28E-06,0,0,2
sincerest,1,1.84E-06,1,2.28E-06,0,0,3
nosedived,1,1.84E-06,1,2.28E-06,0,0,3
finalists,1,1.84E-06,1,2.28E-06,0,0,3
bethlehem,1,1.84E-06,1,2.28E-06,0,0,3
formalize,1,1.84E-06,1,2.28E-06,0,0,3
concocted,1,1.84E-06,1,2.28E-06,0,0,2
adversely,1,1.84E-06,1,2.28E-06,0,0,4
supersede,1,1.84E-06,1,2.28E-06,0,0,3
corruptly,1,1.84E-06,1,2.28E-06,0,0,3
healtcare,1,1.84E-06,1,2.28E-06,0,0,2
fulbright,1,1.84E-06,1,2.28E-06,0,0,2
overstate,1,1.84E-06,1,2.28E-06,0,0,3
loyalties,1,1.84E-06,1,2.28E-06,0,0,3
dominican,1,1.84E-06,1,2.28E-06,0,0,4
breathing,1,1.84E-06,1,2.28E-06,0,0,2
testament,1,1.84E-06,1,2.28E-06,0,0,3
northwest,1,1.84E-06,1,2.28E-06,0,0,2
amazingly,1,1.84E-06,1,2.28E-06,0,0,4
uniformly,1,1.84E-06,1,2.28E-06,0,0,4
expressly,1,1.84E-06,1,2.28E-06,0,0,3
harassers,1,1.84E-06,1,2.28E-06,0,0,3
spakovsky,1,1.84E-06,1,2.28E-06,0,0,3
overreach,1,1.84E-06,1,2.28E-06,0,0,3
disbarred,1,1.84E-06,1,2.28E-06,0,0,2
righteous,1,1.84E-06,1,2.28E-06,0,0,3
klobuchar,1,1.84E-06,1,2.28E-06,0,0,3
recoverer,1,1.84E-06,1,2.28E-06,0,0,4
astronaut,1,1.84E-06,1,2.28E-06,0,0,3
festivals,1,1.84E-06,1,2.28E-06,0,0,3
bernhardt,1,1.84E-06,1,2.28E-06,0,0,2
headwinds,1,1.84E-06,1,2.28E-06,0,0,2
starbucks,1,1.84E-06,1,2.28E-06,0,0,2
stoppable,1,1.84E-06,1,2.28E-06,0,0,3
exporting,1,1.84E-06,1,2.28E-06,0,0,3
inquiries,1,1.84E-06,1,2.28E-06,0,0,3
strangers,1,1.84E-06,1,2.28E-06,0,0,2
excursion,1,1.84E-06,1,2.28E-06,0,0,3
devastate,1,1.84E-06,1,2.28E-06,0,0,3
variation,1,1.84E-06,1,2.28E-06,0,0,3
overdrive,1,1.84E-06,1,2.28E-06,0,0,3
obtrusive,1,1.84E-06,1,2.28E-06,0,0,3
inclusive,1,1.84E-06,1,2.28E-06,0,0,3
narcotics,1,1.84E-06,1,2.28E-06,0,0,3
portrayed,1,1.84E-06,1,2.28E-06,0,0,2
possesses,1,1.84E-06,1,2.28E-06,0,0,2
liftbecome,1,1.84E-06,0,0,9.47E-06,1,3
unfinished,1,1.84E-06,0,0,9.47E-06,1,3
timethanks,1,1.84E-06,0,0,9.47E-06,1,3
groundwork,1,1.84E-06,0,0,9.47E-06,1,2
yearsshoot,1,1.84E-06,0,0,9.47E-06,1,2
daysshould,1,1.84E-06,0,0,9.47E-06,1,2
maymarking,1,1.84E-06,0,0,9.47E-06,1,3
aprilthats,1,1.84E-06,0,0,9.47E-06,1,3
translator,1,1.84E-06,0,0,9.47E-06,1,3
workplaces,1,1.84E-06,0,0,9.47E-06,1,2
conversion,1,1.84E-06,0,0,9.47E-06,1,3
veteransto,1,1.84E-06,0,0,9.47E-06,1,4
readyenter,1,1.84E-06,0,0,9.47E-06,1,3
supergirls,1,1.84E-06,0,0,9.47E-06,1,3
democracys,1,1.84E-06,0,0,9.47E-06,1,4
familieswe,1,1.84E-06,0,0,9.47E-06,1,3
workersnot,1,1.84E-06,0,0,9.47E-06,1,3
truthiness,1,1.84E-06,0,0,9.47E-06,1,3
reformjoin,1,1.84E-06,0,0,9.47E-06,1,3
elementary,1,1.84E-06,0,0,9.47E-06,1,5
growingbut,1,1.84E-06,0,0,9.47E-06,1,3
renouncing,1,1.84E-06,0,0,9.47E-06,1,3
workingfor,1,1.84E-06,0,0,9.47E-06,1,3
bostonians,1,1.84E-06,0,0,9.47E-06,1,3
lifesaving,1,1.84E-06,0,0,9.47E-06,1,4
undermined,1,1.84E-06,0,0,9.47E-06,1,3
possessing,1,1.84E-06,0,0,9.47E-06,1,3
integrated,1,1.84E-06,0,0,9.47E-06,1,3
quadrupled,1,1.84E-06,0,0,9.47E-06,1,2
plaintiffs,1,1.84E-06,0,0,9.47E-06,1,2
oklahomans,1,1.84E-06,0,0,9.47E-06,1,4
explosions,1,1.84E-06,0,0,9.47E-06,1,3
succession,1,1.84E-06,0,0,9.47E-06,1,3
unlicensed,1,1.84E-06,0,0,9.47E-06,1,3
absolutism,1,1.84E-06,0,0,9.47E-06,1,4
truthsthat,1,1.84E-06,0,0,9.47E-06,1,2
sustaining,1,1.84E-06,0,0,9.47E-06,1,3
eyesalicia,1,1.84E-06,0,0,9.47E-06,1,5
achievable,1,1.84E-06,0,0,9.47E-06,1,4
sharedthat,1,1.84E-06,0,0,9.47E-06,1,3
peopleyour,1,1.84E-06,0,0,9.47E-06,1,3
conception,1,1.84E-06,0,0,9.47E-06,1,3
applicants,1,1.84E-06,0,0,9.47E-06,1,3
sweatshirt,1,1.84E-06,0,0,9.47E-06,1,2
lesbiansor,1,1.84E-06,0,0,9.47E-06,1,3
elderlybut,1,1.84E-06,0,0,9.47E-06,1,4
amateurish,1,1.84E-06,0,0,9.47E-06,1,4
votinglets,1,1.84E-06,0,0,9.47E-06,1,3
worldfirst,1,1.84E-06,0,0,9.47E-06,1,2
seasonthis,1,1.84E-06,0,0,9.47E-06,1,3
paralympic,1,1.84E-06,0,0,9.47E-06,1,4
taxespotus,1,1.84E-06,0,0,9.47E-06,1,4
virginians,1,1.84E-06,0,0,9.47E-06,1,3
familiesrt,1,1.84E-06,0,0,9.47E-06,1,3
incomemuch,1,1.84E-06,0,0,9.47E-06,1,4
jeopardize,1,1.84E-06,0,0,9.47E-06,1,3
countsmake,1,1.84E-06,0,0,9.47E-06,1,2
nycairfare,1,1.84E-06,0,0,9.47E-06,1,3
bankrupted,1,1.84E-06,0,0,9.47E-06,1,2
worthwhile,1,1.84E-06,0,0,9.47E-06,1,3
decorating,1,1.84E-06,0,0,9.47E-06,1,4
coverednow,1,1.84E-06,0,0,9.47E-06,1,4
pathformer,1,1.84E-06,0,0,9.47E-06,1,3
disclosing,1,1.84E-06,0,0,9.47E-06,1,3
chancetake,1,1.84E-06,0,0,9.47E-06,1,3
compounded,1,1.84E-06,0,0,9.47E-06,1,2
exampleget,1,1.84E-06,0,0,9.47E-06,1,4
guggenheim,1,1.84E-06,0,0,9.47E-06,1,3
casualness,1,1.84E-06,0,0,9.47E-06,1,3
foreclosed,1,1.84E-06,0,0,9.47E-06,1,3
preference,1,1.84E-06,0,0,9.47E-06,1,3
shirtorder,1,1.84E-06,0,0,9.47E-06,1,3
housecheck,1,1.84E-06,0,0,9.47E-06,1,3
rebounding,1,1.84E-06,0,0,9.47E-06,1,3
doubtcheck,1,1.84E-06,0,0,9.47E-06,1,2
specialist,1,1.84E-06,0,0,9.47E-06,1,3
countapply,1,1.84E-06,0,0,9.47E-06,1,3
moratorium,1,1.84E-06,0,0,9.47E-06,1,4
muchexcept,1,1.84E-06,0,0,9.47E-06,1,3
minutesput,1,1.84E-06,0,0,9.47E-06,1,4
counseling,1,1.84E-06,0,0,9.47E-06,1,3
repayments,1,1.84E-06,0,0,9.47E-06,1,3
provisions,1,1.84E-06,0,0,9.47E-06,1,3
components,1,1.84E-06,0,0,9.47E-06,1,3
ownerspass,1,1.84E-06,0,0,9.47E-06,1,3
grudgingly,1,1.84E-06,0,0,9.47E-06,1,3
defaulting,1,1.84E-06,0,0,9.47E-06,1,3
campaignso,1,1.84E-06,0,0,9.47E-06,1,3
congressto,1,1.84E-06,0,0,9.47E-06,1,3
discourage,1,1.84E-06,0,0,9.47E-06,1,3
discharged,1,1.84E-06,0,0,9.47E-06,1,2
relaunches,1,1.84E-06,0,0,9.47E-06,1,2
electionwe,1,1.84E-06,0,0,9.47E-06,1,3
valuesthis,1,1.84E-06,0,0,9.47E-06,1,3
admiration,1,1.84E-06,0,0,9.47E-06,1,4
economynot,1,1.84E-06,0,0,9.47E-06,1,5
resiliency,1,1.84E-06,0,0,9.47E-06,1,4
reformthis,1,1.84E-06,0,0,9.47E-06,1,3
discontent,1,1.84E-06,0,0,9.47E-06,1,3
actionjoin,1,1.84E-06,0,0,9.47E-06,1,3
copenhagen,1,1.84E-06,0,0,9.47E-06,1,4
reformlets,1,1.84E-06,0,0,9.47E-06,1,3
learnshare,1,1.84E-06,0,0,9.47E-06,1,2
verifiably,1,1.84E-06,1,2.28E-06,0,0,4
historians,1,1.84E-06,1,2.28E-06,0,0,3
statehouse,1,1.84E-06,1,2.28E-06,0,0,3
certifying,1,1.84E-06,1,2.28E-06,0,0,3
scoundrels,1,1.84E-06,1,2.28E-06,0,0,2
subversion,1,1.84E-06,1,2.28E-06,0,0,3
unsolvable,1,1.84E-06,1,2.28E-06,0,0,4
deplorable,1,1.84E-06,1,2.28E-06,0,0,4
inspection,1,1.84E-06,1,2.28E-06,0,0,3
containers,1,1.84E-06,1,2.28E-06,0,0,3
wrongthink,1,1.84E-06,1,2.28E-06,0,0,2
fabricator,1,1.84E-06,1,2.28E-06,0,0,4
inglorious,1,1.84E-06,1,2.28E-06,0,0,4
eliminates,1,1.84E-06,1,2.28E-06,0,0,4
mechanical,1,1.84E-06,1,2.28E-06,0,0,4
stronghold,1,1.84E-06,1,2.28E-06,0,0,2
offshoring,1,1.84E-06,1,2.28E-06,0,0,3
americansi,1,1.84E-06,1,2.28E-06,0,0,5
shoutedlet,1,1.84E-06,1,2.28E-06,0,0,3
enumerated,1,1.84E-06,1,2.28E-06,0,0,4
ineligible,1,1.84E-06,1,2.28E-06,0,0,5
globalists,1,1.84E-06,1,2.28E-06,0,0,3
disrupting,1,1.84E-06,1,2.28E-06,0,0,3
sanctioned,1,1.84E-06,1,2.28E-06,0,0,2
vaccinated,1,1.84E-06,1,2.28E-06,0,0,3
incoherent,1,1.84E-06,1,2.28E-06,0,0,4
administer,1,1.84E-06,1,2.28E-06,0,0,4
wisconsins,1,1.84E-06,1,2.28E-06,0,0,3
desjarlais,1,1.84E-06,1,2.28E-06,0,0,3
triggering,1,1.84E-06,1,2.28E-06,0,0,3
nonfiction,1,1.84E-06,1,2.28E-06,0,0,3
archbishop,1,1.84E-06,1,2.28E-06,0,0,3
girlfriend,1,1.84E-06,1,2.28E-06,0,0,2
extensions,1,1.84E-06,1,2.28E-06,0,0,3
americanot,1,1.84E-06,1,2.28E-06,0,0,5
unfriendly,1,1.84E-06,1,2.28E-06,0,0,3
impeachmen,1,1.84E-06,1,2.28E-06,0,0,3
freeriding,1,1.84E-06,1,2.28E-06,0,0,3
apologizes,1,1.84E-06,1,2.28E-06,0,0,4
expressway,1,1.84E-06,1,2.28E-06,0,0,3
fabricates,1,1.84E-06,1,2.28E-06,0,0,3
automobils,1,1.84E-06,1,2.28E-06,0,0,4
procedural,1,1.84E-06,1,2.28E-06,0,0,4
overlooked,1,1.84E-06,1,2.28E-06,0,0,3
observance,1,1.84E-06,1,2.28E-06,0,0,3
hardliners,1,1.84E-06,1,2.28E-06,0,0,3
insatiable,1,1.84E-06,1,2.28E-06,0,0,4
destroyers,1,1.84E-06,1,2.28E-06,0,0,3
competence,1,1.84E-06,1,2.28E-06,0,0,3
pocahontus,1,1.84E-06,1,2.28E-06,0,0,4
reluctance,1,1.84E-06,1,2.28E-06,0,0,3
trajectory,1,1.84E-06,1,2.28E-06,0,0,4
bridgegate,1,1.84E-06,1,2.28E-06,0,0,3
proficient,1,1.84E-06,1,2.28E-06,0,0,3
inadequate,1,1.84E-06,1,2.28E-06,0,0,4
comparable,1,1.84E-06,1,2.28E-06,0,0,4
processors,1,1.84E-06,1,2.28E-06,0,0,3
discipline,1,1.84E-06,1,2.28E-06,0,0,3
evaporated,1,1.84E-06,1,2.28E-06,0,0,4
tediousnew,1,1.84E-06,1,2.28E-06,0,0,4
ostracized,1,1.84E-06,1,2.28E-06,0,0,3
alienating,1,1.84E-06,1,2.28E-06,0,0,4
unanswered,1,1.84E-06,1,2.28E-06,0,0,3
stockpiles,1,1.84E-06,1,2.28E-06,0,0,3
decoupling,1,1.84E-06,1,2.28E-06,0,0,3
antagonize,1,1.84E-06,1,2.28E-06,0,0,4
infectious,1,1.84E-06,1,2.28E-06,0,0,4
redesigned,1,1.84E-06,1,2.28E-06,0,0,3
weaponizes,1,1.84E-06,1,2.28E-06,0,0,3
essentials,1,1.84E-06,1,2.28E-06,0,0,3
warmongers,1,1.84E-06,1,2.28E-06,0,0,3
pretenders,1,1.84E-06,1,2.28E-06,0,0,3
resentment,1,1.84E-06,1,2.28E-06,0,0,3
denouncing,1,1.84E-06,1,2.28E-06,0,0,3
distressed,1,1.84E-06,1,2.28E-06,0,0,2
consultant,1,1.84E-06,1,2.28E-06,0,0,3
nowproblem,1,1.84E-06,1,2.28E-06,0,0,3
viewpoints,1,1.84E-06,1,2.28E-06,0,0,2
misprinted,1,1.84E-06,1,2.28E-06,0,0,2
thugsclean,1,1.84E-06,1,2.28E-06,0,0,2
blowoutnot,1,1.84E-06,1,2.28E-06,0,0,3
accounting,1,1.84E-06,1,2.28E-06,0,0,3
regulating,1,1.84E-06,1,2.28E-06,0,0,4
expression,1,1.84E-06,1,2.28E-06,0,0,3
vandalizes,1,1.84E-06,1,2.28E-06,0,0,3
cryinchuck,1,1.84E-06,1,2.28E-06,0,0,2
convicting,1,1.84E-06,1,2.28E-06,0,0,3
contenders,1,1.84E-06,1,2.28E-06,0,0,3
lobstering,1,1.84E-06,1,2.28E-06,0,0,3
franchises,1,1.84E-06,1,2.28E-06,0,0,2
disparaged,1,1.84E-06,1,2.28E-06,0,0,3
reaffirmed,1,1.84E-06,1,2.28E-06,0,0,2
boomingbut,1,1.84E-06,1,2.28E-06,0,0,3
imaginable,1,1.84E-06,1,2.28E-06,0,0,5
enormously,1,1.84E-06,1,2.28E-06,0,0,4
accumulate,1,1.84E-06,1,2.28E-06,0,0,4
dispatches,1,1.84E-06,1,2.28E-06,0,0,2
complained,1,1.84E-06,1,2.28E-06,0,0,2
reschedule,1,1.84E-06,1,2.28E-06,0,0,4
xenophobia,1,1.84E-06,1,2.28E-06,0,0,4
displaying,1,1.84E-06,1,2.28E-06,0,0,3
reportedly,1,1.84E-06,1,2.28E-06,0,0,4
performing,1,1.84E-06,1,2.28E-06,0,0,3
vandalized,1,1.84E-06,1,2.28E-06,0,0,3
storefront,1,1.84E-06,1,2.28E-06,0,0,3
pictureyet,1,1.84E-06,1,2.28E-06,0,0,4
exhaustion,1,1.84E-06,1,2.28E-06,0,0,3
overthrown,1,1.84E-06,1,2.28E-06,0,0,3
unofficial,1,1.84E-06,1,2.28E-06,0,0,4
roofmonday,1,1.84E-06,1,2.28E-06,0,0,3
statelocal,1,1.84E-06,1,2.28E-06,0,0,4
strategies,1,1.84E-06,1,2.28E-06,0,0,3
stonington,1,1.84E-06,1,2.28E-06,0,0,3
entrusting,1,1.84E-06,1,2.28E-06,0,0,3
russiagate,1,1.84E-06,1,2.28E-06,0,0,3
futurethis,1,1.84E-06,1,2.28E-06,0,0,4
stephenson,1,1.84E-06,1,2.28E-06,0,0,3
surprising,1,1.84E-06,1,2.28E-06,0,0,3
mismanaged,1,1.84E-06,1,2.28E-06,0,0,3
stupendous,1,1.84E-06,1,2.28E-06,0,0,3
laboratory,1,1.84E-06,1,2.28E-06,0,0,5
perception,1,1.84E-06,1,2.28E-06,0,0,3
housewives,1,1.84E-06,1,2.28E-06,0,0,3
compensate,1,1.84E-06,1,2.28E-06,0,0,3
redactions,1,1.84E-06,1,2.28E-06,0,0,3
experiment,1,1.84E-06,1,2.28E-06,0,0,4
singletary,1,1.84E-06,1,2.28E-06,0,0,4
splashdown,1,1.84E-06,1,2.28E-06,0,0,2
paramedics,1,1.84E-06,1,2.28E-06,0,0,4
reassigned,1,1.84E-06,1,2.28E-06,0,0,2
phenomenon,1,1.84E-06,1,2.28E-06,0,0,4
rescinding,1,1.84E-06,1,2.28E-06,0,0,3
conquering,1,1.84E-06,1,2.28E-06,0,0,3
supersonic,1,1.84E-06,1,2.28E-06,0,0,4
defamatory,1,1.84E-06,1,2.28E-06,0,0,5
retraction,1,1.84E-06,1,2.28E-06,0,0,3
purposeful,1,1.84E-06,1,2.28E-06,0,0,4
contingent,1,1.84E-06,1,2.28E-06,0,0,3
suspending,1,1.84E-06,1,2.28E-06,0,0,3
seamstress,1,1.84E-06,1,2.28E-06,0,0,2
montgomery,1,1.84E-06,1,2.28E-06,0,0,4
finalizing,1,1.84E-06,1,2.28E-06,0,0,4
destinybut,1,1.84E-06,1,2.28E-06,0,0,4
worshipers,1,1.84E-06,1,2.28E-06,0,0,3
conducting,1,1.84E-06,1,2.28E-06,0,0,3
policyweak,1,1.84E-06,1,2.28E-06,0,0,4
beneficial,1,1.84E-06,1,2.28E-06,0,0,4
guantanamo,1,1.84E-06,1,2.28E-06,0,0,4
horrifying,1,1.84E-06,1,2.28E-06,0,0,3
affliction,1,1.84E-06,1,2.28E-06,0,0,3
liberation,1,1.84E-06,1,2.28E-06,0,0,4
compliance,1,1.84E-06,1,2.28E-06,0,0,2
harrisburg,1,1.84E-06,1,2.28E-06,0,0,3
northamwho,1,1.84E-06,1,2.28E-06,0,0,3
virginiais,1,1.84E-06,1,2.28E-06,0,0,4
generators,1,1.84E-06,1,2.28E-06,0,0,4
laughingly,1,1.84E-06,1,2.28E-06,0,0,3
weverybody,1,1.84E-06,1,2.28E-06,0,0,5
nationsmet,1,1.84E-06,1,2.28E-06,0,0,3
failedthat,1,1.84E-06,1,2.28E-06,0,0,3
comparably,1,1.84E-06,1,2.28E-06,0,0,4
futureread,1,1.84E-06,1,2.28E-06,0,0,4
eradicated,1,1.84E-06,1,2.28E-06,0,0,4
vehemently,1,1.84E-06,1,2.28E-06,0,0,4
historywhy,1,1.84E-06,1,2.28E-06,0,0,4
overcoming,1,1.84E-06,1,2.28E-06,0,0,4
assurances,1,1.84E-06,1,2.28E-06,0,0,3
magnifying,1,1.84E-06,1,2.28E-06,0,0,3
intercepts,1,1.84E-06,1,2.28E-06,0,0,3
hensarling,1,1.84E-06,1,2.28E-06,0,0,3
unfiltered,1,1.84E-06,1,2.28E-06,0,0,3
missilebut,1,1.84E-06,1,2.28E-06,0,0,4
surrogates,1,1.84E-06,1,2.28E-06,0,0,3
disruptive,1,1.84E-06,1,2.28E-06,0,0,3
victorious,1,1.84E-06,1,2.28E-06,0,0,4
containing,1,1.84E-06,1,2.28E-06,0,0,3
fighterjet,1,1.84E-06,1,2.28E-06,0,0,3
remarkably,1,1.84E-06,1,2.28E-06,0,0,4
senrichard,1,1.84E-06,1,2.28E-06,0,0,3
upperlower,1,1.84E-06,1,2.28E-06,0,0,4
untrusting,1,1.84E-06,1,2.28E-06,0,0,3
negligence,1,1.84E-06,1,2.28E-06,0,0,3
governorof,1,1.84E-06,1,2.28E-06,0,0,4
entrapping,1,1.84E-06,1,2.28E-06,0,0,3
incidental,1,1.84E-06,1,2.28E-06,0,0,4
brzezinski,1,1.84E-06,1,2.28E-06,0,0,3
trishregan,1,1.84E-06,1,2.28E-06,0,0,3
lighthizer,1,1.84E-06,1,2.28E-06,0,0,3
portraying,1,1.84E-06,1,2.28E-06,0,0,3
afflicting,1,1.84E-06,1,2.28E-06,0,0,3
familiesto,1,1.84E-06,1,2.28E-06,0,0,4
disapprove,1,1.84E-06,1,2.28E-06,0,0,3
campaigner,1,1.84E-06,1,2.28E-06,0,0,3
screeching,1,1.84E-06,1,2.28E-06,0,0,2
dodgersred,1,1.84E-06,1,2.28E-06,0,0,2
easterners,1,1.84E-06,1,2.28E-06,0,0,3
burdensome,1,1.84E-06,1,2.28E-06,0,0,3
formidable,1,1.84E-06,1,2.28E-06,0,0,4
biodefense,1,1.84E-06,1,2.28E-06,0,0,3
pharmacist,1,1.84E-06,1,2.28E-06,0,0,3
chargeable,1,1.84E-06,1,2.28E-06,0,0,3
mobilizing,1,1.84E-06,1,2.28E-06,0,0,4
frequently,1,1.84E-06,1,2.28E-06,0,0,3
detractors,1,1.84E-06,1,2.28E-06,0,0,3
assembling,1,1.84E-06,1,2.28E-06,0,0,3
publicized,1,1.84E-06,1,2.28E-06,0,0,3
perpetrate,1,1.84E-06,1,2.28E-06,0,0,3
fertilizer,1,1.84E-06,1,2.28E-06,0,0,4
clearances,1,1.84E-06,1,2.28E-06,0,0,2
australian,1,1.84E-06,1,2.28E-06,0,0,3
admonished,1,1.84E-06,1,2.28E-06,0,0,3
countrybut,1,1.84E-06,1,2.28E-06,0,0,3
vocabulary,1,1.84E-06,1,2.28E-06,0,0,5
baldersons,1,1.84E-06,1,2.28E-06,0,0,3
entrapment,1,1.84E-06,1,2.28E-06,0,0,3
happenalso,1,1.84E-06,1,2.28E-06,0,0,4
pelosihigh,1,1.84E-06,1,2.28E-06,0,0,4
reagandole,1,1.84E-06,1,2.28E-06,0,0,4
detainment,1,1.84E-06,1,2.28E-06,0,0,3
presumably,1,1.84E-06,1,2.28E-06,0,0,4
negotiates,1,1.84E-06,1,2.28E-06,0,0,3
cooperated,1,1.84E-06,1,2.28E-06,0,0,3
barricaded,1,1.84E-06,1,2.28E-06,0,0,3
possession,1,1.84E-06,1,2.28E-06,0,0,3
loveragent,1,1.84E-06,1,2.28E-06,0,0,4
agentlover,1,1.84E-06,1,2.28E-06,0,0,4
liberating,1,1.84E-06,1,2.28E-06,0,0,4
lieutenant,1,1.84E-06,1,2.28E-06,0,0,4
unbalanced,1,1.84E-06,1,2.28E-06,0,0,3
uninvolved,1,1.84E-06,1,2.28E-06,0,0,3
charlevoix,1,1.84E-06,1,2.28E-06,0,0,3
problembut,1,1.84E-06,1,2.28E-06,0,0,3
tradecraft,1,1.84E-06,1,2.28E-06,0,0,3
separating,1,1.84E-06,1,2.28E-06,0,0,4
sentencing,1,1.84E-06,1,2.28E-06,0,0,3
expressing,1,1.84E-06,1,2.28E-06,0,0,3
spyingthis,1,1.84E-06,1,2.28E-06,0,0,2
scandalous,1,1.84E-06,1,2.28E-06,0,0,3
membersnot,1,1.84E-06,1,2.28E-06,0,0,3
cemeteries,1,1.84E-06,1,2.28E-06,0,0,4
infiltrate,1,1.84E-06,1,2.28E-06,0,0,3
mirziyoyev,1,1.84E-06,1,2.28E-06,0,0,4
uzbekistan,1,1.84E-06,1,2.28E-06,0,0,4
caregivers,1,1.84E-06,1,2.28E-06,0,0,4
compatible,1,1.84E-06,1,2.28E-06,0,0,4
medication,1,1.84E-06,1,2.28E-06,0,0,4
unrevealed,1,1.84E-06,1,2.28E-06,0,0,3
aggravated,1,1.84E-06,1,2.28E-06,0,0,3
nazarbayev,1,1.84E-06,1,2.28E-06,0,0,4
kazakhstan,1,1.84E-06,1,2.28E-06,0,0,3
governorsi,1,1.84E-06,1,2.28E-06,0,0,4
partnering,1,1.84E-06,1,2.28E-06,0,0,3
prescribed,1,1.84E-06,1,2.28E-06,0,0,2
calculated,1,1.84E-06,1,2.28E-06,0,0,3
countrynot,1,1.84E-06,1,2.28E-06,0,0,3
kidnapping,1,1.84E-06,1,2.28E-06,0,0,3
maintained,1,1.84E-06,1,2.28E-06,0,0,2
voluminous,1,1.84E-06,1,2.28E-06,0,0,4
combatants,1,1.84E-06,1,2.28E-06,0,0,3
russiajust,1,1.84E-06,1,2.28E-06,0,0,3
relocation,1,1.84E-06,1,2.28E-06,0,0,4
exercising,1,1.84E-06,1,2.28E-06,0,0,4
evidencein,1,1.84E-06,1,2.28E-06,0,0,4
decoration,1,1.84E-06,1,2.28E-06,0,0,4
succinctly,1,1.84E-06,1,2.28E-06,0,0,3
classmates,1,1.84E-06,1,2.28E-06,0,0,2
clintondnc,1,1.84E-06,1,2.28E-06,0,0,2
linebacker,1,1.84E-06,1,2.28E-06,0,0,4
boundaries,1,1.84E-06,1,2.28E-06,0,0,3
wastelands,1,1.84E-06,1,2.28E-06,0,0,3
derogatory,1,1.84E-06,1,2.28E-06,0,0,5
outlandish,1,1.84E-06,1,2.28E-06,0,0,3
relocating,1,1.84E-06,1,2.28E-06,0,0,4
thornberry,1,1.84E-06,1,2.28E-06,0,0,3
telehealth,1,1.84E-06,1,2.28E-06,0,0,3
modulating,1,1.84E-06,1,2.28E-06,0,0,4
microphone,1,1.84E-06,1,2.28E-06,0,0,3
impossibly,1,1.84E-06,1,2.28E-06,0,0,4
albaghdadi,1,1.84E-06,1,2.28E-06,0,0,4
convincing,1,1.84E-06,1,2.28E-06,0,0,3
cortuption,1,1.84E-06,1,2.28E-06,0,0,3
warfighter,1,1.84E-06,1,2.28E-06,0,0,3
financials,1,1.84E-06,1,2.28E-06,0,0,3
prizefight,1,1.84E-06,1,2.28E-06,0,0,3
envisioned,1,1.84E-06,1,2.28E-06,0,0,3
subverting,1,1.84E-06,1,2.28E-06,0,0,3
deepstater,1,1.84E-06,1,2.28E-06,0,0,3
consulting,1,1.84E-06,1,2.28E-06,0,0,3
highjacked,1,1.84E-06,1,2.28E-06,0,0,2
condemning,1,1.84E-06,1,2.28E-06,0,0,3
irrational,1,1.84E-06,1,2.28E-06,0,0,4
bucksexton,1,1.84E-06,1,2.28E-06,0,0,3
resigining,1,1.84E-06,1,2.28E-06,0,0,4
recaptured,1,1.84E-06,1,2.28E-06,0,0,3
beheadings,1,1.84E-06,1,2.28E-06,0,0,3
disposable,1,1.84E-06,1,2.28E-06,0,0,4
reaspected,1,1.84E-06,1,2.28E-06,0,0,2
pranksters,1,1.84E-06,1,2.28E-06,0,0,2
projecting,1,1.84E-06,1,2.28E-06,0,0,3
backfiring,1,1.84E-06,1,2.28E-06,0,0,3
protectors,1,1.84E-06,1,2.28E-06,0,0,3
camouflage,1,1.84E-06,1,2.28E-06,0,0,3
discribing,1,1.84E-06,1,2.28E-06,0,0,3
scrambling,1,1.84E-06,1,2.28E-06,0,0,2
publishing,1,1.84E-06,1,2.28E-06,0,0,3
respirator,1,1.84E-06,1,2.28E-06,0,0,4
succeeding,1,1.84E-06,1,2.28E-06,0,0,3
defrauding,1,1.84E-06,1,2.28E-06,0,0,3
stationary,1,1.84E-06,1,2.28E-06,0,0,4
lawfulness,1,1.84E-06,1,2.28E-06,0,0,3
undisputed,1,1.84E-06,1,2.28E-06,0,0,3
systematic,1,1.84E-06,1,2.28E-06,0,0,4
rainforest,1,1.84E-06,1,2.28E-06,0,0,3
regulators,1,1.84E-06,1,2.28E-06,0,0,4
postponing,1,1.84E-06,1,2.28E-06,0,0,3
portrayals,1,1.84E-06,1,2.28E-06,0,0,3
heightened,1,1.84E-06,1,2.28E-06,0,0,2
russiansin,1,1.84E-06,1,2.28E-06,0,0,3
proclaimed,1,1.84E-06,1,2.28E-06,0,0,2
canterbury,1,1.84E-06,1,2.28E-06,0,0,4
insinuated,1,1.84E-06,1,2.28E-06,0,0,3
baltimores,1,1.84E-06,1,2.28E-06,0,0,3
congresses,1,1.84E-06,1,2.28E-06,0,0,2
injunction,1,1.84E-06,1,2.28E-06,0,0,3
guatemalan,1,1.84E-06,1,2.28E-06,0,0,4
reclaiming,1,1.84E-06,1,2.28E-06,0,0,3
manipulate,1,1.84E-06,1,2.28E-06,0,0,4
needlessly,1,1.84E-06,1,2.28E-06,0,0,3
leavetrump,1,1.84E-06,1,2.28E-06,0,0,3
amphibious,1,1.84E-06,1,2.28E-06,0,0,4
mastermind,1,1.84E-06,1,2.28E-06,0,0,3
horsewomen,1,1.84E-06,1,2.28E-06,0,0,4
apocalypse,1,1.84E-06,1,2.28E-06,0,0,4
antiquated,1,1.84E-06,1,2.28E-06,0,0,3
graciously,1,1.84E-06,1,2.28E-06,0,0,4
dependable,1,1.84E-06,1,2.28E-06,0,0,4
disloyalty,1,1.84E-06,1,2.28E-06,0,0,4
hydromatic,1,1.84E-06,1,2.28E-06,0,0,4
detentions,1,1.84E-06,1,2.28E-06,0,0,3
persistent,1,1.84E-06,1,2.28E-06,0,0,3
sponsoring,1,1.84E-06,1,2.28E-06,0,0,3
escalating,1,1.84E-06,1,2.28E-06,0,0,4
advisement,1,1.84E-06,1,2.28E-06,0,0,4
ridiclious,1,1.84E-06,1,2.28E-06,0,0,4
shockingly,1,1.84E-06,1,2.28E-06,0,0,3
corrective,1,1.84E-06,1,2.28E-06,0,0,3
plagiarism,1,1.84E-06,1,2.28E-06,0,0,3
simplistic,1,1.84E-06,1,2.28E-06,0,0,3
disclaimer,1,1.84E-06,1,2.28E-06,0,0,3
boardtoday,1,1.84E-06,1,2.28E-06,0,0,3
irrelevant,1,1.84E-06,1,2.28E-06,0,0,4
transplant,1,1.84E-06,1,2.28E-06,0,0,2
comeyesque,1,1.84E-06,1,2.28E-06,0,0,4
overriding,1,1.84E-06,1,2.28E-06,0,0,4
instigated,1,1.84E-06,1,2.28E-06,0,0,3
assaulting,1,1.84E-06,1,2.28E-06,0,0,3
kidnappers,1,1.84E-06,1,2.28E-06,0,0,3
capturesat,1,1.84E-06,1,2.28E-06,0,0,4
redeployed,1,1.84E-06,1,2.28E-06,0,0,3
defamation,1,1.84E-06,1,2.28E-06,0,0,4
executions,1,1.84E-06,1,2.28E-06,0,0,4
publishers,1,1.84E-06,1,2.28E-06,0,0,3
vietnamese,1,1.84E-06,1,2.28E-06,0,0,3
recovering,1,1.84E-06,1,2.28E-06,0,0,4
shortening,1,1.84E-06,1,2.28E-06,0,0,3
tantamount,1,1.84E-06,1,2.28E-06,0,0,3
circumvent,1,1.84E-06,1,2.28E-06,0,0,3
parameters,1,1.84E-06,1,2.28E-06,0,0,4
birthplace,1,1.84E-06,1,2.28E-06,0,0,2
roadblocks,1,1.84E-06,1,2.28E-06,0,0,2
dimensions,1,1.84E-06,1,2.28E-06,0,0,3
rediscover,1,1.84E-06,1,2.28E-06,0,0,4
mysterious,1,1.84E-06,1,2.28E-06,0,0,4
inflicting,1,1.84E-06,1,2.28E-06,0,0,3
unresolved,1,1.84E-06,1,2.28E-06,0,0,3
assumption,1,1.84E-06,1,2.28E-06,0,0,3
reinforced,1,1.84E-06,1,2.28E-06,0,0,2
venezuelas,1,1.84E-06,1,2.28E-06,0,0,4
concession,1,1.84E-06,1,2.28E-06,0,0,3
captivated,1,1.84E-06,1,2.28E-06,0,0,3
judgements,1,1.84E-06,1,2.28E-06,0,0,3
hamburgers,1,1.84E-06,1,2.28E-06,0,0,3
hamberders,1,1.84E-06,1,2.28E-06,0,0,3
volkswagen,1,1.84E-06,1,2.28E-06,0,0,3
usurpation,1,1.84E-06,1,2.28E-06,0,0,4
normalized,1,1.84E-06,1,2.28E-06,0,0,3
undetected,1,1.84E-06,1,2.28E-06,0,0,3
assignment,1,1.84E-06,1,2.28E-06,0,0,3
ustaxpayer,1,1.84E-06,1,2.28E-06,0,0,4
walksupport,1,1.84E-06,0,0,9.47E-06,1,3
julymarking,1,1.84E-06,0,0,9.47E-06,1,4
perfectmile,1,1.84E-06,0,0,9.47E-06,1,4
sentencesor,1,1.84E-06,0,0,9.47E-06,1,4
incarcerate,1,1.84E-06,0,0,9.47E-06,1,4
underfunded,1,1.84E-06,0,0,9.47E-06,1,3
overcrowded,1,1.84E-06,0,0,9.47E-06,1,3
junemarking,1,1.84E-06,0,0,9.47E-06,1,4
rightsshare,1,1.84E-06,0,0,9.47E-06,1,2
optionsjust,1,1.84E-06,0,0,9.47E-06,1,3
protectedno,1,1.84E-06,0,0,9.47E-06,1,4
entertained,1,1.84E-06,0,0,9.47E-06,1,3
changestick,1,1.84E-06,0,0,9.47E-06,1,3
compensated,1,1.84E-06,0,0,9.47E-06,1,3
growththats,1,1.84E-06,0,0,9.47E-06,1,2
leaderships,1,1.84E-06,0,0,9.47E-06,1,3
frustrating,1,1.84E-06,0,0,9.47E-06,1,3
discouraged,1,1.84E-06,0,0,9.47E-06,1,3
chancethats,1,1.84E-06,0,0,9.47E-06,1,3
responsibly,1,1.84E-06,0,0,9.47E-06,1,4
curriculums,1,1.84E-06,0,0,9.47E-06,1,4
abstraction,1,1.84E-06,0,0,9.47E-06,1,3
ideological,1,1.84E-06,0,0,9.47E-06,1,5
yesterdayno,1,1.84E-06,0,0,9.47E-06,1,4
concessions,1,1.84E-06,0,0,9.47E-06,1,3
dismantling,1,1.84E-06,0,0,9.47E-06,1,3
predictions,1,1.84E-06,0,0,9.47E-06,1,3
washingtons,1,1.84E-06,0,0,9.47E-06,1,3
cholesterol,1,1.84E-06,0,0,9.47E-06,1,4
democratswe,1,1.84E-06,0,0,9.47E-06,1,3
familiesnot,1,1.84E-06,0,0,9.47E-06,1,4
familiesgay,1,1.84E-06,0,0,9.47E-06,1,4
grandparent,1,1.84E-06,0,0,9.47E-06,1,3
ourselveswe,1,1.84E-06,0,0,9.47E-06,1,3
spontaneous,1,1.84E-06,0,0,9.47E-06,1,4
mourdockwho,1,1.84E-06,0,0,9.47E-06,1,3
pregnancies,1,1.84E-06,0,0,9.47E-06,1,3
bankruptyou,1,1.84E-06,0,0,9.47E-06,1,4
sweatshirts,1,1.84E-06,0,0,9.47E-06,1,2
requirement,1,1.84E-06,0,0,9.47E-06,1,4
shootaround,1,1.84E-06,0,0,9.47E-06,1,3
birthdayget,1,1.84E-06,0,0,9.47E-06,1,3
sharingmake,1,1.84E-06,0,0,9.47E-06,1,3
ratessaving,1,1.84E-06,0,0,9.47E-06,1,4
youfighting,1,1.84E-06,0,0,9.47E-06,1,3
shouldering,1,1.84E-06,0,0,9.47E-06,1,3
strategists,1,1.84E-06,0,0,9.47E-06,1,3
debtforcing,1,1.84E-06,0,0,9.47E-06,1,3
steelworker,1,1.84E-06,0,0,9.47E-06,1,3
familyuntil,1,1.84E-06,0,0,9.47E-06,1,4
senatormake,1,1.84E-06,0,0,9.47E-06,1,4
electionbut,1,1.84E-06,0,0,9.47E-06,1,4
stickerjust,1,1.84E-06,0,0,9.47E-06,1,3
enthusiasts,1,1.84E-06,0,0,9.47E-06,1,3
approximate,1,1.84E-06,0,0,9.47E-06,1,4
growingfive,1,1.84E-06,0,0,9.47E-06,1,3
democracies,1,1.84E-06,0,0,9.47E-06,1,4
jobsthrough,1,1.84E-06,0,0,9.47E-06,1,2
application,1,1.84E-06,0,0,9.47E-06,1,4
veteranslet,1,1.84E-06,0,0,9.47E-06,1,4
secretaryan,1,1.84E-06,0,0,9.47E-06,1,4
caffeinated,1,1.84E-06,0,0,9.47E-06,1,3
unmentioned,1,1.84E-06,0,0,9.47E-06,1,3
voterstweet,1,1.84E-06,0,0,9.47E-06,1,3
appearances,1,1.84E-06,0,0,9.47E-06,1,3
trailblazer,1,1.84E-06,0,0,9.47E-06,1,3
childbecome,1,1.84E-06,0,0,9.47E-06,1,3
electionswe,1,1.84E-06,0,0,9.47E-06,1,3
believethat,1,1.84E-06,0,0,9.47E-06,1,4
overwhelmed,1,1.84E-06,0,0,9.47E-06,1,3
studyhealth,1,1.84E-06,0,0,9.47E-06,1,3
homosexuals,1,1.84E-06,0,0,9.47E-06,1,4
personalize,1,1.84E-06,0,0,9.47E-06,1,4
seriousness,1,1.84E-06,0,0,9.47E-06,1,4
calculation,1,1.84E-06,0,0,9.47E-06,1,4
schoolwatch,1,1.84E-06,0,0,9.47E-06,1,2
discoveries,1,1.84E-06,1,2.28E-06,0,0,4
strongholds,1,1.84E-06,1,2.28E-06,0,0,2
tabulations,1,1.84E-06,1,2.28E-06,0,0,4
coordinates,1,1.84E-06,1,2.28E-06,0,0,3
azerbaijani,1,1.84E-06,1,2.28E-06,0,0,5
martinsburg,1,1.84E-06,1,2.28E-06,0,0,3
statehouses,1,1.84E-06,1,2.28E-06,0,0,3
coldcasejoe,1,1.84E-06,1,2.28E-06,0,0,4
ferociously,1,1.84E-06,1,2.28E-06,0,0,5
wisconsinif,1,1.84E-06,1,2.28E-06,0,0,4
blockbuster,1,1.84E-06,1,2.28E-06,0,0,3
desecration,1,1.84E-06,1,2.28E-06,0,0,4
distasteful,1,1.84E-06,1,2.28E-06,0,0,4
percentages,1,1.84E-06,1,2.28E-06,0,0,3
dishonoring,1,1.84E-06,1,2.28E-06,0,0,4
purportedly,1,1.84E-06,1,2.28E-06,0,0,4
haphazardly,1,1.84E-06,1,2.28E-06,0,0,4
discovering,1,1.84E-06,1,2.28E-06,0,0,4
distributed,1,1.84E-06,1,2.28E-06,0,0,3
invalidates,1,1.84E-06,1,2.28E-06,0,0,4
containment,1,1.84E-06,1,2.28E-06,0,0,3
revelations,1,1.84E-06,1,2.28E-06,0,0,4
objectively,1,1.84E-06,1,2.28E-06,0,0,5
impulsively,1,1.84E-06,1,2.28E-06,0,0,5
neighboring,1,1.84E-06,1,2.28E-06,0,0,3
outmastered,1,1.84E-06,1,2.28E-06,0,0,3
disapproval,1,1.84E-06,1,2.28E-06,0,0,4
coincidence,1,1.84E-06,1,2.28E-06,0,0,3
courthouses,1,1.84E-06,1,2.28E-06,0,0,2
signatories,1,1.84E-06,1,2.28E-06,0,0,4
outnumbered,1,1.84E-06,1,2.28E-06,0,0,3
businessmen,1,1.84E-06,1,2.28E-06,0,0,4
paramountly,1,1.84E-06,1,2.28E-06,0,0,4
survailence,1,1.84E-06,1,2.28E-06,0,0,3
intolerable,1,1.84E-06,1,2.28E-06,0,0,5
nonbeliever,1,1.84E-06,1,2.28E-06,0,0,4
scrutinized,1,1.84E-06,1,2.28E-06,0,0,3
quarantined,1,1.84E-06,1,2.28E-06,0,0,3
congregants,1,1.84E-06,1,2.28E-06,0,0,3
technicians,1,1.84E-06,1,2.28E-06,0,0,3
vacationing,1,1.84E-06,1,2.28E-06,0,0,4
reluctantly,1,1.84E-06,1,2.28E-06,0,0,4
disrespects,1,1.84E-06,1,2.28E-06,0,0,3
lighthizers,1,1.84E-06,1,2.28E-06,0,0,3
harrassment,1,1.84E-06,1,2.28E-06,0,0,3
denigrating,1,1.84E-06,1,2.28E-06,0,0,4
publication,1,1.84E-06,1,2.28E-06,0,0,4
undermining,1,1.84E-06,1,2.28E-06,0,0,4
speculative,1,1.84E-06,1,2.28E-06,0,0,4
compatriots,1,1.84E-06,1,2.28E-06,0,0,3
interestsig,1,1.84E-06,1,2.28E-06,0,0,4
warrantless,1,1.84E-06,1,2.28E-06,0,0,3
clandestine,1,1.84E-06,1,2.28E-06,0,0,3
fortenberry,1,1.84E-06,1,2.28E-06,0,0,4
replaceable,1,1.84E-06,1,2.28E-06,0,0,4
respiratory,1,1.84E-06,1,2.28E-06,0,0,5
pressplease,1,1.84E-06,1,2.28E-06,0,0,2
advancement,1,1.84E-06,1,2.28E-06,0,0,4
impractical,1,1.84E-06,1,2.28E-06,0,0,4
deployments,1,1.84E-06,1,2.28E-06,0,0,3
federations,1,1.84E-06,1,2.28E-06,0,0,4
pocketbooks,1,1.84E-06,1,2.28E-06,0,0,3
persuasions,1,1.84E-06,1,2.28E-06,0,0,3
cooperating,1,1.84E-06,1,2.28E-06,0,0,4
individulal,1,1.84E-06,1,2.28E-06,0,0,5
myersnaples,1,1.84E-06,1,2.28E-06,0,0,3
harshbarger,1,1.84E-06,1,2.28E-06,0,0,3
aspirations,1,1.84E-06,1,2.28E-06,0,0,4
caronavirus,1,1.84E-06,1,2.28E-06,0,0,5
enhancement,1,1.84E-06,1,2.28E-06,0,0,4
proclaiming,1,1.84E-06,1,2.28E-06,0,0,3
advisorshow,1,1.84E-06,1,2.28E-06,0,0,4
counterpart,1,1.84E-06,1,2.28E-06,0,0,3
provocateur,1,1.84E-06,1,2.28E-06,0,0,4
reawakening,1,1.84E-06,1,2.28E-06,0,0,4
luetkemeyer,1,1.84E-06,1,2.28E-06,0,0,4
observation,1,1.84E-06,1,2.28E-06,0,0,4
squandering,1,1.84E-06,1,2.28E-06,0,0,3
russiatrump,1,1.84E-06,1,2.28E-06,0,0,3
influential,1,1.84E-06,1,2.28E-06,0,0,3
retractions,1,1.84E-06,1,2.28E-06,0,0,3
sanctuaries,1,1.84E-06,1,2.28E-06,0,0,3
shepherding,1,1.84E-06,1,2.28E-06,0,0,3
speculating,1,1.84E-06,1,2.28E-06,0,0,4
defenseless,1,1.84E-06,1,2.28E-06,0,0,4
unaccepting,1,1.84E-06,1,2.28E-06,0,0,4
friendships,1,1.84E-06,1,2.28E-06,0,0,2
destination,1,1.84E-06,1,2.28E-06,0,0,4
happenedhow,1,1.84E-06,1,2.28E-06,0,0,4
fortunedems,1,1.84E-06,1,2.28E-06,0,0,4
hardagainst,1,1.84E-06,1,2.28E-06,0,0,3
teamstephen,1,1.84E-06,1,2.28E-06,0,0,3
palestinian,1,1.84E-06,1,2.28E-06,0,0,4
appeasement,1,1.84E-06,1,2.28E-06,0,0,4
intensifies,1,1.84E-06,1,2.28E-06,0,0,4
equivalency,1,1.84E-06,1,2.28E-06,0,0,5
educational,1,1.84E-06,1,2.28E-06,0,0,5
placelocked,1,1.84E-06,1,2.28E-06,0,0,3
achievednot,1,1.84E-06,1,2.28E-06,0,0,4
accelerated,1,1.84E-06,1,2.28E-06,0,0,4
plantplants,1,1.84E-06,1,2.28E-06,0,0,2
beleaguered,1,1.84E-06,1,2.28E-06,0,0,3
ratingthats,1,1.84E-06,1,2.28E-06,0,0,3
substandard,1,1.84E-06,1,2.28E-06,0,0,3
disparaging,1,1.84E-06,1,2.28E-06,0,0,4
practicesto,1,1.84E-06,1,2.28E-06,0,0,4
possiblefar,1,1.84E-06,1,2.28E-06,0,0,4
australians,1,1.84E-06,1,2.28E-06,0,0,3
spiralaetna,1,1.84E-06,1,2.28E-06,0,0,4
identifying,1,1.84E-06,1,2.28E-06,0,0,4
manipulator,1,1.84E-06,1,2.28E-06,0,0,5
empowerment,1,1.84E-06,1,2.28E-06,0,0,4
voluntarily,1,1.84E-06,1,2.28E-06,0,0,5
overplaying,1,1.84E-06,1,2.28E-06,0,0,4
intentional,1,1.84E-06,1,2.28E-06,0,0,4
marginalize,1,1.84E-06,1,2.28E-06,0,0,4
placesspent,1,1.84E-06,1,2.28E-06,0,0,3
priveledged,1,1.84E-06,1,2.28E-06,0,0,3
reputations,1,1.84E-06,1,2.28E-06,0,0,4
sensational,1,1.84E-06,1,2.28E-06,0,0,4
unjustified,1,1.84E-06,1,2.28E-06,0,0,4
spokeswoman,1,1.84E-06,1,2.28E-06,0,0,4
prosecuting,1,1.84E-06,1,2.28E-06,0,0,4
weaponizing,1,1.84E-06,1,2.28E-06,0,0,4
criminalize,1,1.84E-06,1,2.28E-06,0,0,4
decorations,1,1.84E-06,1,2.28E-06,0,0,4
beneficiary,1,1.84E-06,1,2.28E-06,0,0,5
originating,1,1.84E-06,1,2.28E-06,0,0,5
nationalist,1,1.84E-06,1,2.28E-06,0,0,4
libertarian,1,1.84E-06,1,2.28E-06,0,0,4
harvardyale,1,1.84E-06,1,2.28E-06,0,0,4
foundations,1,1.84E-06,1,2.28E-06,0,0,3
economyread,1,1.84E-06,1,2.28E-06,0,0,5
precautions,1,1.84E-06,1,2.28E-06,0,0,3
purposelyso,1,1.84E-06,1,2.28E-06,0,0,5
assemblyman,1,1.84E-06,1,2.28E-06,0,0,4
celebratory,1,1.84E-06,1,2.28E-06,0,0,5
originators,1,1.84E-06,1,2.28E-06,0,0,5
stefanowski,1,1.84E-06,1,2.28E-06,0,0,4
contentious,1,1.84E-06,1,2.28E-06,0,0,4
unpatriotic,1,1.84E-06,1,2.28E-06,0,0,4
problemsbut,1,1.84E-06,1,2.28E-06,0,0,3
treacherous,1,1.84E-06,1,2.28E-06,0,0,3
eradicating,1,1.84E-06,1,2.28E-06,0,0,5
endrosement,1,1.84E-06,1,2.28E-06,0,0,4
rosensteins,1,1.84E-06,1,2.28E-06,0,0,3
promulgated,1,1.84E-06,1,2.28E-06,0,0,3
rescissions,1,1.84E-06,1,2.28E-06,0,0,3
infiltrated,1,1.84E-06,1,2.28E-06,0,0,3
reachedjust,1,1.84E-06,1,2.28E-06,0,0,3
blankenship,1,1.84E-06,1,2.28E-06,0,0,3
heavyweight,1,1.84E-06,1,2.28E-06,0,0,3
interagency,1,1.84E-06,1,2.28E-06,0,0,5
disciplined,1,1.84E-06,1,2.28E-06,0,0,3
governmenta,1,1.84E-06,1,2.28E-06,0,0,4
implausible,1,1.84E-06,1,2.28E-06,0,0,4
newscasters,1,1.84E-06,1,2.28E-06,0,0,3
goldmanvice,1,1.84E-06,1,2.28E-06,0,0,3
participant,1,1.84E-06,1,2.28E-06,0,0,4
mishandling,1,1.84E-06,1,2.28E-06,0,0,3
preliminary,1,1.84E-06,1,2.28E-06,0,0,5
simplifying,1,1.84E-06,1,2.28E-06,0,0,3
underhanded,1,1.84E-06,1,2.28E-06,0,0,3
worshippers,1,1.84E-06,1,2.28E-06,0,0,3
deliverance,1,1.84E-06,1,2.28E-06,0,0,4
inpeachment,1,1.84E-06,1,2.28E-06,0,0,3
establishes,1,1.84E-06,1,2.28E-06,0,0,3
designation,1,1.84E-06,1,2.28E-06,0,0,4
contracting,1,1.84E-06,1,2.28E-06,0,0,3
unfavorably,1,1.84E-06,1,2.28E-06,0,0,5
tantalizing,1,1.84E-06,1,2.28E-06,0,0,4
nationalism,1,1.84E-06,1,2.28E-06,0,0,4
eradication,1,1.84E-06,1,2.28E-06,0,0,5
renaissance,1,1.84E-06,1,2.28E-06,0,0,3
selectively,1,1.84E-06,1,2.28E-06,0,0,5
rupublicans,1,1.84E-06,1,2.28E-06,0,0,4
turkeykurds,1,1.84E-06,1,2.28E-06,0,0,3
respirators,1,1.84E-06,1,2.28E-06,0,0,4
turkeysyria,1,1.84E-06,1,2.28E-06,0,0,4
recoverable,1,1.84E-06,1,2.28E-06,0,0,5
frightening,1,1.84E-06,1,2.28E-06,0,0,3
perpetuated,1,1.84E-06,1,2.28E-06,0,0,3
pelosichuck,1,1.84E-06,1,2.28E-06,0,0,4
misdemeanor,1,1.84E-06,1,2.28E-06,0,0,4
perspective,1,1.84E-06,1,2.28E-06,0,0,3
unbeknownst,1,1.84E-06,1,2.28E-06,0,0,3
joblessness,1,1.84E-06,1,2.28E-06,0,0,3
enforceable,1,1.84E-06,1,2.28E-06,0,0,4
determining,1,1.84E-06,1,2.28E-06,0,0,4
descendants,1,1.84E-06,1,2.28E-06,0,0,3
obnoxiously,1,1.84E-06,1,2.28E-06,0,0,5
enlightened,1,1.84E-06,1,2.28E-06,0,0,3
humiliation,1,1.84E-06,1,2.28E-06,0,0,4
resemblance,1,1.84E-06,1,2.28E-06,0,0,3
londonistan,1,1.84E-06,1,2.28E-06,0,0,4
irrevocably,1,1.84E-06,1,2.28E-06,0,0,5
dilapidated,1,1.84E-06,1,2.28E-06,0,0,4
adversaries,1,1.84E-06,1,2.28E-06,0,0,4
unregulated,1,1.84E-06,1,2.28E-06,0,0,4
prestigious,1,1.84E-06,1,2.28E-06,0,0,4
earthquakes,1,1.84E-06,1,2.28E-06,0,0,2
reclamation,1,1.84E-06,1,2.28E-06,0,0,4
bludgeoning,1,1.84E-06,1,2.28E-06,0,0,3
permissable,1,1.84E-06,1,2.28E-06,0,0,4
subscribing,1,1.84E-06,1,2.28E-06,0,0,3
venezuelans,1,1.84E-06,1,2.28E-06,0,0,4
testimonies,1,1.84E-06,1,2.28E-06,0,0,4
priceslower,1,1.84E-06,1,2.28E-06,0,0,4
incessantly,1,1.84E-06,1,2.28E-06,0,0,4
indignation,1,1.84E-06,1,2.28E-06,0,0,4
reciprocate,1,1.84E-06,1,2.28E-06,0,0,4
exculpatory,1,1.84E-06,1,2.28E-06,0,0,5
contingency,1,1.84E-06,1,2.28E-06,0,0,4
legislating,1,1.84E-06,1,2.28E-06,0,0,4
susceptible,1,1.84E-06,1,2.28E-06,0,0,4
punctuation,1,1.84E-06,1,2.28E-06,0,0,3
substantive,1,1.84E-06,1,2.28E-06,0,0,3
visionaries,1,1.84E-06,1,2.28E-06,0,0,4
backgrounds,1,1.84E-06,1,2.28E-06,0,0,2
emergencies,1,1.84E-06,1,2.28E-06,0,0,4
dereliction,1,1.84E-06,1,2.28E-06,0,0,4
stoltenberg,1,1.84E-06,1,2.28E-06,0,0,3
prerogative,1,1.84E-06,1,2.28E-06,0,0,4
highlighted,1,1.84E-06,1,2.28E-06,0,0,2
deregulated,1,1.84E-06,1,2.28E-06,0,0,4
imaginative,1,1.84E-06,1,2.28E-06,0,0,5
changethanks,1,1.84E-06,0,0,9.47E-06,1,3
coveredthats,1,1.84E-06,0,0,9.47E-06,1,4
economywhile,1,1.84E-06,0,0,9.47E-06,1,6
highlighting,1,1.84E-06,0,0,9.47E-06,1,3
birthdaysign,1,1.84E-06,0,0,9.47E-06,1,3
clearclimate,1,1.84E-06,0,0,9.47E-06,1,3
shutdownyour,1,1.84E-06,0,0,9.47E-06,1,4
everywherewe,1,1.84E-06,0,0,9.47E-06,1,5
wantamericas,1,1.84E-06,0,0,9.47E-06,1,5
pastamerican,1,1.84E-06,0,0,9.47E-06,1,5
birthdaymake,1,1.84E-06,0,0,9.47E-06,1,3
canonization,1,1.84E-06,0,0,9.47E-06,1,5
insurancebut,1,1.84E-06,0,0,9.47E-06,1,5
grandparents,1,1.84E-06,0,0,9.47E-06,1,3
guaranteeing,1,1.84E-06,0,0,9.47E-06,1,4
reproductive,1,1.84E-06,0,0,9.47E-06,1,4
directionbut,1,1.84E-06,0,0,9.47E-06,1,4
inspirations,1,1.84E-06,0,0,9.47E-06,1,4
americansbut,1,1.84E-06,0,0,9.47E-06,1,5
discriminate,1,1.84E-06,0,0,9.47E-06,1,4
vaccinations,1,1.84E-06,0,0,9.47E-06,1,4
sportscenter,1,1.84E-06,0,0,9.47E-06,1,3
backamerican,1,1.84E-06,0,0,9.47E-06,1,5
marketplaces,1,1.84E-06,0,0,9.47E-06,1,3
establishing,1,1.84E-06,0,0,9.47E-06,1,4
entrepreneur,1,1.84E-06,0,0,9.47E-06,1,4
streamlining,1,1.84E-06,0,0,9.47E-06,1,3
violencemore,1,1.84E-06,0,0,9.47E-06,1,4
workerswhich,1,1.84E-06,0,0,9.47E-06,1,3
hourdirectly,1,1.84E-06,0,0,9.47E-06,1,4
emancipation,1,1.84E-06,0,0,9.47E-06,1,5
campaignwhat,1,1.84E-06,0,0,9.47E-06,1,3
geneticsthis,1,1.84E-06,0,0,9.47E-06,1,4
mourdockwhod,1,1.84E-06,0,0,9.47E-06,1,3
worrysomeone,1,1.84E-06,0,0,9.47E-06,1,4
everyonefrom,1,1.84E-06,0,0,9.47E-06,1,5
donationyour,1,1.84E-06,0,0,9.47E-06,1,5
outraisedbut,1,1.84E-06,0,0,9.47E-06,1,4
birthdaymade,1,1.84E-06,0,0,9.47E-06,1,3
tomorrowdont,1,1.84E-06,0,0,9.47E-06,1,4
explanations,1,1.84E-06,0,0,9.47E-06,1,4
congressweve,1,1.84E-06,0,0,9.47E-06,1,3
yesterdaybut,1,1.84E-06,0,0,9.47E-06,1,4
preventative,1,1.84E-06,0,0,9.47E-06,1,4
michiganders,1,1.84E-06,0,0,9.47E-06,1,4
tomorrowfind,1,1.84E-06,0,0,9.47E-06,1,4
congressdont,1,1.84E-06,0,0,9.47E-06,1,3
filibustered,1,1.84E-06,0,0,9.47E-06,1,4
dayincluding,1,1.84E-06,0,0,9.47E-06,1,4
yardworkeven,1,1.84E-06,0,0,9.47E-06,1,4
votingstates,1,1.84E-06,0,0,9.47E-06,1,3
ratification,1,1.84E-06,0,0,9.47E-06,1,5
perseverance,1,1.84E-06,0,0,9.47E-06,1,4
tomorrowsign,1,1.84E-06,0,0,9.47E-06,1,4
overnightbut,1,1.84E-06,0,0,9.47E-06,1,4
growingwhere,1,1.84E-06,0,0,9.47E-06,1,3
possiblethis,1,1.84E-06,0,0,9.47E-06,1,4
photographer,1,1.84E-06,0,0,9.47E-06,1,4
libertarians,1,1.84E-06,1,2.28E-06,0,0,4
slaughtering,1,1.84E-06,1,2.28E-06,0,0,3
incompetents,1,1.84E-06,1,2.28E-06,0,0,4
industrythat,1,1.84E-06,1,2.28E-06,0,0,4
heartwarming,1,1.84E-06,1,2.28E-06,0,0,3
statistician,1,1.84E-06,1,2.28E-06,0,0,4
spearheading,1,1.84E-06,1,2.28E-06,0,0,3
underwaylets,1,1.84E-06,1,2.28E-06,0,0,4
safeguarding,1,1.84E-06,1,2.28E-06,0,0,4
statelocking,1,1.84E-06,1,2.28E-06,0,0,4
convincingly,1,1.84E-06,1,2.28E-06,0,0,4
outrageously,1,1.84E-06,1,2.28E-06,0,0,5
mysteriously,1,1.84E-06,1,2.28E-06,0,0,5
decertifying,1,1.84E-06,1,2.28E-06,0,0,4
helpstimulus,1,1.84E-06,1,2.28E-06,0,0,4
distributing,1,1.84E-06,1,2.28E-06,0,0,4
straightened,1,1.84E-06,1,2.28E-06,0,0,2
interactions,1,1.84E-06,1,2.28E-06,0,0,4
outperformed,1,1.84E-06,1,2.28E-06,0,0,3
manufactures,1,1.84E-06,1,2.28E-06,0,0,4
presumptions,1,1.84E-06,1,2.28E-06,0,0,3
terroristist,1,1.84E-06,1,2.28E-06,0,0,4
campaigninin,1,1.84E-06,1,2.28E-06,0,0,4
entertaiment,1,1.84E-06,1,2.28E-06,0,0,4
philosophies,1,1.84E-06,1,2.28E-06,0,0,4
purification,1,1.84E-06,1,2.28E-06,0,0,5
disintegrate,1,1.84E-06,1,2.28E-06,0,0,4
insurrection,1,1.84E-06,1,2.28E-06,0,0,4
mortifyingly,1,1.84E-06,1,2.28E-06,0,0,4
afterthought,1,1.84E-06,1,2.28E-06,0,0,3
inexplicable,1,1.84E-06,1,2.28E-06,0,0,5
disregarding,1,1.84E-06,1,2.28E-06,0,0,4
alwaysalways,1,1.84E-06,1,2.28E-06,0,0,4
invigorating,1,1.84E-06,1,2.28E-06,0,0,5
notification,1,1.84E-06,1,2.28E-06,0,0,5
scarboroughs,1,1.84E-06,1,2.28E-06,0,0,3
shortcomings,1,1.84E-06,1,2.28E-06,0,0,3
protectively,1,1.84E-06,1,2.28E-06,0,0,5
contributors,1,1.84E-06,1,2.28E-06,0,0,4
stenographer,1,1.84E-06,1,2.28E-06,0,0,4
floridaearly,1,1.84E-06,1,2.28E-06,0,0,5
shipbuilding,1,1.84E-06,1,2.28E-06,0,0,3
supertuesday,1,1.84E-06,1,2.28E-06,0,0,4
unimaginably,1,1.84E-06,1,2.28E-06,0,0,6
quarterbacks,1,1.84E-06,1,2.28E-06,0,0,3
declarations,1,1.84E-06,1,2.28E-06,0,0,4
economystock,1,1.84E-06,1,2.28E-06,0,0,5
horrendously,1,1.84E-06,1,2.28E-06,0,0,4
russiarussia,1,1.84E-06,1,2.28E-06,0,0,4
frankenstien,1,1.84E-06,1,2.28E-06,0,0,3
apprehension,1,1.84E-06,1,2.28E-06,0,0,4
coincidental,1,1.84E-06,1,2.28E-06,0,0,4
cancelations,1,1.84E-06,1,2.28E-06,0,0,4
terminations,1,1.84E-06,1,2.28E-06,0,0,4
misrepresent,1,1.84E-06,1,2.28E-06,0,0,4
supremacists,1,1.84E-06,1,2.28E-06,0,0,4
loadedshould,1,1.84E-06,1,2.28E-06,0,0,3
clintonlynch,1,1.84E-06,1,2.28E-06,0,0,3
preparedness,1,1.84E-06,1,2.28E-06,0,0,4
instrumental,1,1.84E-06,1,2.28E-06,0,0,4
ourselvesnot,1,1.84E-06,1,2.28E-06,0,0,4
storyopinion,1,1.84E-06,1,2.28E-06,0,0,4
purposesgave,1,1.84E-06,1,2.28E-06,0,0,4
jeopardizing,1,1.84E-06,1,2.28E-06,0,0,4
congressioal,1,1.84E-06,1,2.28E-06,0,0,4
skyrocketing,1,1.84E-06,1,2.28E-06,0,0,4
unaffordable,1,1.84E-06,1,2.28E-06,0,0,5
trumponomics,1,1.84E-06,1,2.28E-06,0,0,4
ingloriously,1,1.84E-06,1,2.28E-06,0,0,5
questionably,1,1.84E-06,1,2.28E-06,0,0,4
demonstrates,1,1.84E-06,1,2.28E-06,0,0,3
sidewhatever,1,1.84E-06,1,2.28E-06,0,0,5
breckenridge,1,1.84E-06,1,2.28E-06,0,0,3
truthfulness,1,1.84E-06,1,2.28E-06,0,0,3
intermediary,1,1.84E-06,1,2.28E-06,0,0,5
resignations,1,1.84E-06,1,2.28E-06,0,0,4
machinations,1,1.84E-06,1,2.28E-06,0,0,4
introduction,1,1.84E-06,1,2.28E-06,0,0,4
associations,1,1.84E-06,1,2.28E-06,0,0,4
counterparts,1,1.84E-06,1,2.28E-06,0,0,3
conciliation,1,1.84E-06,1,2.28E-06,0,0,4
infiltration,1,1.84E-06,1,2.28E-06,0,0,4
extortionist,1,1.84E-06,1,2.28E-06,0,0,4
outrageousas,1,1.84E-06,1,2.28E-06,0,0,5
tribulations,1,1.84E-06,1,2.28E-06,0,0,4
missilesalso,1,1.84E-06,1,2.28E-06,0,0,5
inconsistent,1,1.84E-06,1,2.28E-06,0,0,4
fundamentals,1,1.84E-06,1,2.28E-06,0,0,4
misleadingly,1,1.84E-06,1,2.28E-06,0,0,4
againschumer,1,1.84E-06,1,2.28E-06,0,0,4
cavedgambled,1,1.84E-06,1,2.28E-06,0,0,3
congregation,1,1.84E-06,1,2.28E-06,0,0,4
parishioners,1,1.84E-06,1,2.28E-06,0,0,4
complicating,1,1.84E-06,1,2.28E-06,0,0,4
disciplinary,1,1.84E-06,1,2.28E-06,0,0,5
speakerphone,1,1.84E-06,1,2.28E-06,0,0,3
investigared,1,1.84E-06,1,2.28E-06,0,0,4
governorship,1,1.84E-06,1,2.28E-06,0,0,4
destinations,1,1.84E-06,1,2.28E-06,0,0,4
implications,1,1.84E-06,1,2.28E-06,0,0,4
blockbusters,1,1.84E-06,1,2.28E-06,0,0,3
transactions,1,1.84E-06,1,2.28E-06,0,0,3
democratadam,1,1.84E-06,1,2.28E-06,0,0,5
reverberated,1,1.84E-06,1,2.28E-06,0,0,4
depreciating,1,1.84E-06,1,2.28E-06,0,0,4
inflationfed,1,1.84E-06,1,2.28E-06,0,0,3
inexplicably,1,1.84E-06,1,2.28E-06,0,0,5
frederiksens,1,1.84E-06,1,2.28E-06,0,0,4
grandstanded,1,1.84E-06,1,2.28E-06,0,0,2
entertainers,1,1.84E-06,1,2.28E-06,0,0,4
reciprocated,1,1.84E-06,1,2.28E-06,0,0,4
uninterested,1,1.84E-06,1,2.28E-06,0,0,4
devaluations,1,1.84E-06,1,2.28E-06,0,0,4
troublemaker,1,1.84E-06,1,2.28E-06,0,0,4
circumstance,1,1.84E-06,1,2.28E-06,0,0,3
progressives,1,1.84E-06,1,2.28E-06,0,0,3
deportations,1,1.84E-06,1,2.28E-06,0,0,4
borderswhich,1,1.84E-06,1,2.28E-06,0,0,3
deutschebank,1,1.84E-06,1,2.28E-06,0,0,3
unexpectedly,1,1.84E-06,1,2.28E-06,0,0,5
createdtrump,1,1.84E-06,1,2.28E-06,0,0,3
supplemental,1,1.84E-06,1,2.28E-06,0,0,4
papadopoulos,1,1.84E-06,1,2.28E-06,0,0,5
congesswoman,1,1.84E-06,1,2.28E-06,0,0,4
perpetrators,1,1.84E-06,1,2.28E-06,0,0,4
magnificence,1,1.84E-06,1,2.28E-06,0,0,4
significance,1,1.84E-06,1,2.28E-06,0,0,4
overthinking,1,1.84E-06,1,2.28E-06,0,0,4
substantiate,1,1.84E-06,1,2.28E-06,0,0,3
unregistered,1,1.84E-06,1,2.28E-06,0,0,4
mistreatment,1,1.84E-06,1,2.28E-06,0,0,3
dictatorship,1,1.84E-06,1,2.28E-06,0,0,4
snowmanwoman,1,1.84E-06,1,2.28E-06,0,0,4
unforgivable,1,1.84E-06,1,2.28E-06,0,0,5
maristnprpbs,1,1.84E-06,1,2.28E-06,0,0,2
unmistakably,1,1.84E-06,1,2.28E-06,0,0,5
sportsmanship,1,1.84E-06,0,0,9.47E-06,1,3
technological,1,1.84E-06,0,0,9.47E-06,1,5
contradictory,1,1.84E-06,0,0,9.47E-06,1,5
colonoscopies,1,1.84E-06,0,0,9.47E-06,1,5
discretionary,1,1.84E-06,0,0,9.47E-06,1,5
encouragement,1,1.84E-06,0,0,9.47E-06,1,5
brainstorming,1,1.84E-06,0,0,9.47E-06,1,3
prescriptions,1,1.84E-06,0,0,9.47E-06,1,3
improprieties,1,1.84E-06,1,2.28E-06,0,0,4
championships,1,1.84E-06,1,2.28E-06,0,0,3
preliminarily,1,1.84E-06,1,2.28E-06,0,0,6
strangulation,1,1.84E-06,1,2.28E-06,0,0,4
verifications,1,1.84E-06,1,2.28E-06,0,0,5
determinative,1,1.84E-06,1,2.28E-06,0,0,5
magnificently,1,1.84E-06,1,2.28E-06,0,0,5
weaponization,1,1.84E-06,1,2.28E-06,0,0,5
sterilization,1,1.84E-06,1,2.28E-06,0,0,5
physiological,1,1.84E-06,1,2.28E-06,0,0,5
knowledgeable,1,1.84E-06,1,2.28E-06,0,0,4
condescending,1,1.84E-06,1,2.28E-06,0,0,4
insignificant,1,1.84E-06,1,2.28E-06,0,0,5
corroborating,1,1.84E-06,1,2.28E-06,0,0,5
disseminating,1,1.84E-06,1,2.28E-06,0,0,5
interestingly,1,1.84E-06,1,2.28E-06,0,0,5
antimicrobial,1,1.84E-06,1,2.28E-06,0,0,5
retrospective,1,1.84E-06,1,2.28E-06,0,0,4
vandalization,1,1.84E-06,1,2.28E-06,0,0,5
spectacularly,1,1.84E-06,1,2.28E-06,0,0,5
demonstration,1,1.84E-06,1,2.28E-06,0,0,4
undisciplined,1,1.84E-06,1,2.28E-06,0,0,4
irresponsibly,1,1.84E-06,1,2.28E-06,0,0,5
inspirational,1,1.84E-06,1,2.28E-06,0,0,5
demonstrators,1,1.84E-06,1,2.28E-06,0,0,4
proclamations,1,1.84E-06,1,2.28E-06,0,0,4
interrogation,1,1.84E-06,1,2.28E-06,0,0,5
repercussions,1,1.84E-06,1,2.28E-06,0,0,4
justification,1,1.84E-06,1,2.28E-06,0,0,5
misrepresents,1,1.84E-06,1,2.28E-06,0,0,4
thanksgivings,1,1.84E-06,1,2.28E-06,0,0,3
mismanagement,1,1.84E-06,1,2.28E-06,0,0,5
unaccompanied,1,1.84E-06,1,2.28E-06,0,0,5
unappreciated,1,1.84E-06,1,2.28E-06,0,0,4
documentation,1,1.84E-06,1,2.28E-06,0,0,5
extinguishers,1,1.84E-06,1,2.28E-06,0,0,4
deliberations,1,1.84E-06,1,2.28E-06,0,0,5
indispensable,1,1.84E-06,1,2.28E-06,0,0,5
disfunctional,1,1.84E-06,1,2.28E-06,0,0,4
reciprocating,1,1.84E-06,1,2.28E-06,0,0,5
straightening,1,1.84E-06,1,2.28E-06,0,0,3
humiliatingly,1,1.84E-06,1,2.28E-06,0,0,5
choicemission,1,1.84E-06,1,2.28E-06,0,0,4
contingencies,1,1.84E-06,1,2.28E-06,0,0,4
sanctimonious,1,1.84E-06,1,2.28E-06,0,0,5
confederation,1,1.84E-06,1,2.28E-06,0,0,5
orchestrating,1,1.84E-06,1,2.28E-06,0,0,4
unpredictable,1,1.84E-06,1,2.28E-06,0,0,5
disinvestment,1,1.84E-06,1,2.28E-06,0,0,4
uncomfortable,1,1.84E-06,1,2.28E-06,0,0,5
recognizeable,1,1.84E-06,1,2.28E-06,0,0,5
inexperienced,1,1.84E-06,1,2.28E-06,0,0,4
conspicuously,1,1.84E-06,1,2.28E-06,0,0,5
proportionate,1,1.84E-06,1,2.28E-06,0,0,4
reprehensible,1,1.84E-06,1,2.28E-06,0,0,5
decriminalize,1,1.84E-06,1,2.28E-06,0,0,5
apprehensions,1,1.84E-06,1,2.28E-06,0,0,4
breakthroughs,1,1.84E-06,1,2.28E-06,0,0,2
legislatively,1,1.84E-06,1,2.28E-06,0,0,6
advertisement,1,1.84E-06,1,2.28E-06,0,0,5
disparagingly,1,1.84E-06,1,2.28E-06,0,0,5
contemplating,1,1.84E-06,1,2.28E-06,0,0,4
unsustainable,1,1.84E-06,1,2.28E-06,0,0,5
unappreciative,1,1.84E-06,1,2.28E-06,0,0,5
singlehandedly,1,1.84E-06,1,2.28E-06,0,0,5
establishments,1,1.84E-06,1,2.28E-06,0,0,4
worldincluding,1,1.84E-06,1,2.28E-06,0,0,4
classification,1,1.84E-06,1,2.28E-06,0,0,5
unenthusiastic,1,1.84E-06,1,2.28E-06,0,0,5
misinformation,1,1.84E-06,1,2.28E-06,0,0,5
regulationcuts,1,1.84E-06,1,2.28E-06,0,0,5
partnersduring,1,1.84E-06,1,2.28E-06,0,0,4
miscalculation,1,1.84E-06,1,2.28E-06,0,0,5
satisfiedtruly,1,1.84E-06,1,2.28E-06,0,0,5
constructively,1,1.84E-06,1,2.28E-06,0,0,5
cubamemorandum,1,1.84E-06,1,2.28E-06,0,0,6
prognosticator,1,1.84E-06,1,2.28E-06,0,0,5
wholeheartedly,1,1.84E-06,1,2.28E-06,0,0,5
uncorroborated,1,1.84E-06,1,2.28E-06,0,0,5
unquestionably,1,1.84E-06,1,2.28E-06,0,0,5
unconventional,1,1.84E-06,1,2.28E-06,0,0,5
underestimated,1,1.84E-06,1,2.28E-06,0,0,5
specifications,1,1.84E-06,1,2.28E-06,0,0,5
congratulatory,1,1.84E-06,1,2.28E-06,0,0,6
appropriations,1,1.84E-06,1,2.28E-06,0,0,4
unprofessional,1,1.84E-06,1,2.28E-06,0,0,5
contradictions,1,1.84E-06,1,2.28E-06,0,0,4
compassionately,1,1.84E-06,0,0,9.47E-06,1,6
pharmaceuticals,1,1.84E-06,0,0,9.47E-06,1,5
unceremoniously,1,1.84E-06,1,2.28E-06,0,0,7
disenfranchised,1,1.84E-06,1,2.28E-06,0,0,4
indemnification,1,1.84E-06,1,2.28E-06,0,0,6
sanctimoniously,1,1.84E-06,1,2.28E-06,0,0,6
underperforming,1,1.84E-06,1,2.28E-06,0,0,5
instantaneously,1,1.84E-06,1,2.28E-06,0,0,6
rationalization,1,1.84E-06,1,2.28E-06,0,0,6
misrepresenting,1,1.84E-06,1,2.28E-06,0,0,5
criminalization,1,1.84E-06,1,2.28E-06,0,0,6
intercontinental,1,1.84E-06,1,2.28E-06,0,0,6
unrepresentative,1,1.84E-06,1,2.28E-06,0,0,6
cryptocurrencies,1,1.84E-06,1,2.28E-06,0,0,5
mischaracterized,1,1.84E-06,1,2.28E-06,0,0,5
intergovernmental,1,1.84E-06,1,2.28E-06,0,0,6